Road,Home,Road_score,Home_score,Home_w,margin,Date
Hillsdale,Abilene Christian,61,101,1,-40,2014-11-14
UMBC,Akron,57,74,1,-17,2014-11-14
Towson,Alabama,54,82,1,-28,2014-11-14
Auburn Montgomery,Alabama State,64,105,1,-41,2014-11-14
Mount St. Mary's,Arizona,55,78,1,-23,2014-11-14
Chicago State,Arizona State,50,86,1,-36,2014-11-14
Air Force,Army,78,84,1,-6,2014-11-14
Milwaukee,Auburn,73,83,1,-10,2014-11-14
McNeese State,Baylor,39,80,1,-41,2014-11-14
San Diego,Boise State,75,81,1,-6,2014-11-14
New Hampshire,Boston College,50,58,1,-8,2014-11-14
Texas-Arlington,Bradley,86,75,0,11,2014-11-14
Long Beach State,BYU,90,95,1,-5,2014-11-14
St. Peter's,Brown,58,70,1,-12,2014-11-14
Marist,Bucknell,72,75,1,-3,2014-11-14
South Dakota State,Buffalo,67,69,1,-2,2014-11-14
High Point,Cal State Bakersfield,100,99,0,1,2014-11-14
Alcorn State,California,57,91,1,-34,2014-11-14
Chapman,UC-Irvine,36,87,1,-51,2014-11-14
Barber-Scotia,Campbell,58,97,1,-39,2014-11-14
Fairfield,Central Connecticut,71,63,0,8,2014-11-14
Alma,Central Michigan,64,106,1,-42,2014-11-14
Hiwassee,Chattanooga,53,110,1,-57,2014-11-14
Saint Francis (PA),Cincinnati,37,52,1,-15,2014-11-14
VMI,Citadel,66,65,0,1,2014-11-14
Florida A&M,Clemson,41,86,1,-45,2014-11-14
Trinity Baptist,Coastal Carolina,36,79,1,-43,2014-11-14
Drexel,Colorado,48,65,1,-17,2014-11-14
Bryant,UConn,53,66,1,-13,2014-11-14
Central Arkansas,Creighton,77,104,1,-27,2014-11-14
Alabama A&M,Dayton,52,76,1,-24,2014-11-14
UIC,DePaul,71,72,1,-1,2014-11-14
Rochester (MI),Detroit,54,77,1,-23,2014-11-14
Presbyterian,Duke,44,113,1,-69,2014-11-14
North Carolina Wesleyan,East Carolina,81,99,1,-18,2014-11-14
Savannah State,Eastern Kentucky,53,76,1,-23,2014-11-14
St. Francis (IL),Eastern Michigan,52,64,1,-12,2014-11-14
Texas Southern,Eastern Washington,62,86,1,-24,2014-11-14
Florida Atlantic,Elon,58,64,1,-6,2014-11-14
William & Mary,Florida,45,68,1,-23,2014-11-14
Florida College,Florida International,42,64,1,-22,2014-11-14
NYIT,Fordham,77,94,1,-17,2014-11-14
College of Charleston,Furman,75,40,0,35,2014-11-14
Cornell,George Mason,68,60,0,8,2014-11-14
Grambling,George Washington,40,92,1,-52,2014-11-14
Tennessee Temple,Georgia State,55,115,1,-60,2014-11-14
Georgia,Georgia Tech,73,80,1,-7,2014-11-14
Sacramento State,Gonzaga,58,104,1,-46,2014-11-14
Sacred Heart,Hartford,71,53,0,18,2014-11-14
MIT,Harvard,52,73,1,-21,2014-11-14
Arkansas-Pine Bluff,Hawaii,57,85,1,-28,2014-11-14
Jacksonville,Hofstra,61,94,1,-33,2014-11-14
Eastern Oregon,Idaho,65,77,1,-12,2014-11-14
Georgia Southern,Illinois,71,80,1,-9,2014-11-14
Texas-Tyler,Incarnate Word,49,89,1,-40,2014-11-14
Mississippi Valley State,Indiana,65,116,1,-51,2014-11-14
Cleveland State,Iona,73,78,1,-5,2014-11-14
Hampton,Iowa,56,90,1,-34,2014-11-14
Oakland,Iowa State,82,93,1,-11,2014-11-14
Manchester,Purdue-Fort Wayne,50,74,1,-24,2014-11-14
Indiana State,IUPUI,79,66,0,13,2014-11-14
Virginia,James Madison,79,51,0,28,2014-11-14
UCSB,Kansas,59,69,1,-10,2014-11-14
Southern Utah,Kansas State,68,98,1,-30,2014-11-14
Grand Canyon,Kentucky,45,85,1,-40,2014-11-14
Villanova,Lehigh,77,66,0,11,2014-11-14
Randolph,Liberty,45,69,1,-24,2014-11-14
Berry,Lipscomb,70,91,1,-21,2014-11-14
Averett,Longwood,53,79,1,-26,2014-11-14
Louisiana College,Louisiana,57,85,1,-28,2014-11-14
Minnesota,Louisville,68,81,1,-13,2014-11-14
Rockhurst,Loyola (IL),58,71,1,-13,2014-11-14
Southeast Missouri State,Loyola Marymount,66,76,1,-10,2014-11-14
UT-Martin,Marquette,63,79,1,-16,2014-11-14
Jacksonville State,Marshall,55,74,1,-19,2014-11-14
Wagner,Maryland,48,82,1,-34,2014-11-14
Siena,UMass,87,95,1,-8,2014-11-14
Piedmont,Mercer,48,88,1,-40,2014-11-14
Howard,Miami (FL),49,84,1,-35,2014-11-14
Ohio Valley,Middle Tennessee,60,77,1,-17,2014-11-14
Charleston Southern,Ole Miss,66,65,0,1,2014-11-14
Western Carolina,Mississippi State,56,66,1,-10,2014-11-14
UMKC,Missouri,69,61,0,8,2014-11-14
Eastern Illinois,Missouri State,53,64,1,-11,2014-11-14
Houston,Murray State,77,74,0,3,2014-11-14
Michigan State,Navy,64,59,0,5,2014-11-14
Morehead State,UNLV,59,60,1,-1,2014-11-14
Idaho State,New Mexico,55,79,1,-24,2014-11-14
Pfeiffer,Norfolk State,43,81,1,-38,2014-11-14
North Carolina Central,UNC,60,76,1,-16,2014-11-14
Greensboro,North Carolina A&T,61,91,1,-30,2014-11-14
Chowan,UNC Greensboro,62,76,1,-14,2014-11-14
Jackson State,NC State,58,93,1,-35,2014-11-14
Arkansas-Monticello,North Texas,62,84,1,-22,2014-11-14
Black Hills State,Northern Colorado,62,83,1,-21,2014-11-14
Houston Baptist,Northwestern,58,65,1,-7,2014-11-14
Binghamton,Notre Dame,39,82,1,-43,2014-11-14
UMass-Lowell,Ohio State,55,92,1,-37,2014-11-14
Southeastern Louisiana,Oklahoma State,55,83,1,-28,2014-11-14
Coppin State,Oregon,65,107,1,-42,2014-11-14
Rice,Oregon State,54,67,1,-13,2014-11-14
Morgan State,Penn State,48,61,1,-13,2014-11-14
Fresno State,Pepperdine,74,89,1,-15,2014-11-14
Niagara,Pitt,45,78,1,-33,2014-11-14
Concordia (OR),Portland,59,87,1,-28,2014-11-14
Rider,Princeton,58,64,1,-6,2014-11-14
Samford,Purdue,40,80,1,-40,2014-11-14
Yale,Quinnipiac,85,88,1,-3,2014-11-14
Pace,Rhode Island,54,94,1,-40,2014-11-14
Radford,Richmond,46,64,1,-18,2014-11-14
Lafayette,Robert Morris,77,50,0,27,2014-11-14
Fairleigh Dickinson,St. Joseph's,58,57,0,1,2014-11-14
Cal State Los Angeles,Saint Mary's,67,77,1,-10,2014-11-14
Austin College,Sam Houston State,52,100,1,-48,2014-11-14
Cal State Northridge,San Diego State,58,79,1,-21,2014-11-14
Bethesda University (CA),San Jose State,44,67,1,-23,2014-11-14
Cal State Fullerton,Santa Clara,72,89,1,-17,2014-11-14
Texas State,Seattle,62,53,0,9,2014-11-14
Carroll (MT),South Alabama,64,83,1,-19,2014-11-14
North Florida,South Carolina,56,81,1,-25,2014-11-14
Flagler,South Florida,61,75,1,-14,2014-11-14
Louisiana Tech,Southern,85,76,0,9,2014-11-14
Harris-Stowe,SIU-Edwardsville,56,104,1,-48,2014-11-14
Lamar,SMU,54,93,1,-39,2014-11-14
William Carey,Southern Miss,63,86,1,-23,2014-11-14
NJIT,St. John's (NY),58,77,1,-19,2014-11-14
Wofford,Stanford,59,74,1,-15,2014-11-14
Mississippi College,Stephen F. Austin,49,75,1,-26,2014-11-14
Edward Waters,Stetson,61,75,1,-14,2014-11-14
Columbia,Stony Brook,56,57,1,-1,2014-11-14
Kennesaw State,Syracuse,42,89,1,-47,2014-11-14
American,Temple,37,40,1,-3,2014-11-14
VCU,Tennessee,85,69,0,16,2014-11-14
Reinhardt,Tennessee State,66,97,1,-31,2014-11-14
Piedmont,Tennessee Tech,29,83,1,-54,2014-11-14
North Dakota State,Texas,50,85,1,-35,2014-11-14
Northwestern State,Texas A&M,68,109,1,-41,2014-11-14
Our Lady of the Lake,Texas A&M-Corpus Christi,58,73,1,-15,2014-11-14
Prairie View,TCU,54,71,1,-17,2014-11-14
Washington State,UTEP,52,65,1,-13,2014-11-14
Wayland Baptist,Texas-Rio Grande Valley,80,88,1,-8,2014-11-14
Huston-Tillotson,UTSA,74,92,1,-18,2014-11-14
Loyola (MD),Texas Tech,59,71,1,-12,2014-11-14
Brewton-Parker,Troy,71,85,1,-14,2014-11-14
Montana State,UCLA,78,113,1,-35,2014-11-14
Ball State,Utah,72,90,1,-18,2014-11-14
Weber State,Utah State,61,72,1,-11,2014-11-14
South Dakota,Utah Valley,52,60,1,-8,2014-11-14
ETSU,Valparaiso,76,90,1,-14,2014-11-14
Maryland-Eastern Shore,Virginia Tech,46,71,1,-25,2014-11-14
UNC Asheville,Wake Forest,69,80,1,-11,2014-11-14
South Carolina State,Washington,59,77,1,-18,2014-11-14
Monmouth,West Virginia,54,64,1,-10,2014-11-14
Pacific,Western Illinois,73,71,0,2,2014-11-14
New Mexico State,Wichita State,54,71,1,-17,2014-11-14
Northern Kentucky,Wisconsin,31,62,1,-31,2014-11-14
Belmont,Wright State,70,73,1,-3,2014-11-14
Northern Arizona,Xavier,60,93,1,-33,2014-11-14
Citadel,Air Force,55,68,1,-13,2014-11-15
Louisiana-Monroe,Alabama-Birmingham,74,65,0,9,2014-11-15
High Point,Arkansas-Pine Bluff,74,62,0,12,2014-11-15
VMI,Army,86,92,1,-6,2014-11-15
Trinity (TX),Bethune-Cookman,69,91,1,-22,2014-11-15
Maine,Butler,57,99,1,-42,2014-11-15
UC-San Diego,UC-Riverside,52,75,1,-23,2014-11-15
Vermont,Canisius,60,64,1,-4,2014-11-15
Montana,Colorado State,66,83,1,-17,2014-11-15
Catholic,Davidson,66,102,1,-36,2014-11-15
Bowling Green State,Drake,77,58,0,19,2014-11-15
Fairfield,Duke,59,109,1,-50,2014-11-15
Bluefield State,Duquesne,51,91,1,-40,2014-11-15
Earlham (IN),Evansville,45,116,1,-71,2014-11-15
Nova Southeastern,Florida Gulf Coast,51,63,1,-12,2014-11-15
Manhattan,Florida State,66,81,1,-15,2014-11-15
St. Francis (NY),Georgetown,62,83,1,-21,2014-11-15
Illinois-Springfield,Green Bay,57,88,1,-31,2014-11-15
Cal State Bakersfield,Hawaii,65,72,1,-7,2014-11-15
Colgate,La Salle,52,57,1,-5,2014-11-15
San Francisco State,Long Beach State,64,74,1,-10,2014-11-15
Gardner-Webb,LSU,82,93,1,-11,2014-11-15
Boise State,Loyola Marymount,77,69,0,8,2014-11-15
Hillsdale,Michigan,68,92,1,-24,2014-11-15
Cal Poly,Nevada,49,65,1,-16,2014-11-15
Aurora,Northern Illinois,56,86,1,-30,2014-11-15
North Dakota,Northern Iowa,52,64,1,-12,2014-11-15
Appalachian State,Ohio,47,73,1,-26,2014-11-15
UNC Wilmington,Old Dominion,56,76,1,-20,2014-11-15
Tulsa,Oral Roberts,68,77,1,-9,2014-11-15
Delaware State,Penn,77,75,0,2,2014-11-15
Albany (NY),Providence,60,64,1,-4,2014-11-15
Southern Illinois,Saint Louis,59,62,1,-3,2014-11-15
Southeast Missouri State,San Diego,56,67,1,-11,2014-11-15
San Diego Christian,Santa Clara,58,70,1,-12,2014-11-15
Florida A&M,USC Upstate,65,78,1,-13,2014-11-15
Portland State,USC,76,68,0,8,2014-11-15
Dartmouth,St. Bonaventure,57,77,1,-20,2014-11-15
Austin Peay,Western Kentucky,70,77,1,-7,2014-11-15
Pfeiffer,Winthrop,59,82,1,-23,2014-11-15
Kent State,Youngstown State,69,61,0,8,2014-11-15
Cal State Northridge,Arizona,68,86,1,-18,2014-11-16
Alabama State,Arkansas,79,97,1,-18,2014-11-16
Arkansas-Monticello,Little Rock,64,77,1,-13,2014-11-16
Berea,Austin Peay,63,68,1,-5,2014-11-16
UMass,Boston College,71,62,0,9,2014-11-16
Northeastern,Boston University,71,65,0,6,2014-11-16
Kennesaw State,California,59,93,1,-34,2014-11-16
Holy Names,UC-Davis,42,57,1,-15,2014-11-16
Pacific,UC-Irvine,50,68,1,-18,2014-11-16
Stetson,UCF,55,64,1,-9,2014-11-16
Chicago State,Creighton,66,84,1,-18,2014-11-16
Idaho State,Denver,38,54,1,-16,2014-11-16
UNC Asheville,East Carolina,83,79,0,4,2014-11-16
Charlotte,Elon,73,60,0,13,2014-11-16
Princeton,George Mason,60,63,1,-3,2014-11-16
St. Peter's,Hartford,50,51,1,-1,2014-11-16
Holy Cross,Harvard,58,57,0,1,2014-11-16
Goucher,Howard,54,101,1,-47,2014-11-16
Coppin State,Illinois,56,114,1,-58,2014-11-16
Utah State,Illinois State,60,55,0,5,2014-11-16
Florida National University,Jacksonville,61,72,1,-11,2014-11-16
Buffalo,Kentucky,52,71,1,-19,2014-11-16
Louisiana State-Alexandria,Lamar,75,78,1,-3,2014-11-16
Cornell,Loyola (MD),71,76,1,-5,2014-11-16
Savannah State,Marshall,47,66,1,-19,2014-11-16
Southern Utah,Miami (OH),63,76,1,-13,2014-11-16
Valparaiso,Missouri,41,56,1,-15,2014-11-16
Northern Kentucky,Nebraska,61,80,1,-19,2014-11-16
Central Arkansas,Omaha,75,100,1,-25,2014-11-16
Sam Houston State,UNLV,57,59,1,-2,2014-11-16
Cal State Fullerton,New Mexico,59,67,1,-8,2014-11-16
Robert Morris,UNC,59,103,1,-44,2014-11-16
Navy,Notre Dame,53,92,1,-39,2014-11-16
Wright State,Ohio Dominican,76,64,0,12,2014-11-16
Southeastern Louisiana,Oklahoma,53,78,1,-25,2014-11-16
Prairie View,Oklahoma State,52,74,1,-22,2014-11-16
Fordham,Penn State,54,73,1,-19,2014-11-16
Samford,Pitt,56,63,1,-7,2014-11-16
IUPUI,Purdue,57,77,1,-20,2014-11-16
UMass-Lowell,Rhode Island,56,72,1,-16,2014-11-16
George Washington,Rutgers,70,53,0,17,2014-11-16
South Carolina State,San Francisco,52,91,1,-39,2014-11-16
Portland,San Jose State,73,68,0,5,2014-11-16
Mercer,Seton Hall,47,63,1,-16,2014-11-16
Jackson State,South Florida,64,73,1,-9,2014-11-16
South Dakota,Stanford,73,84,1,-11,2014-11-16
Hampton,Syracuse,47,65,1,-18,2014-11-16
Alcorn State,Texas,53,85,1,-32,2014-11-16
Northern Arizona,Toledo,58,71,1,-13,2014-11-16
Coastal Carolina,UCLA,71,84,1,-13,2014-11-16
Trevecca Nazarene,Vanderbilt,56,83,1,-27,2014-11-16
Norfolk State,Virginia,39,67,1,-28,2014-11-16
Lafayette,West Virginia,56,83,1,-27,2014-11-16
Aquinas,Western Michigan,57,87,1,-30,2014-11-16
Chattanooga,Wisconsin,45,89,1,-44,2014-11-16
Northern Colorado,Wyoming,70,78,1,-8,2014-11-16
Oberlin,Youngstown State,53,71,1,-18,2014-11-16
Western Carolina,Alabama,74,80,1,-6,2014-11-17
Young Harris,Alabama-Birmingham,81,94,1,-13,2014-11-17
Saint Francis (PA),American,46,49,1,-3,2014-11-17
Bethune-Cookman,Arizona State,39,49,1,-10,2014-11-17
Cal State Bakersfield,Arkansas-Pine Bluff,49,56,1,-7,2014-11-17
UT-Martin,Arkansas State,75,73,0,2,2014-11-17
Indiana-Kokomo,Ball State,62,101,1,-39,2014-11-17
Northwestern,Brown,69,56,0,13,2014-11-17
Sacramento State,UC-Riverside,70,69,0,1,2014-11-17
Erskine,Charleston Southern,50,92,1,-42,2014-11-17
Winthrop,Clemson,77,74,0,3,2014-11-17
Tiffin,Cleveland State,56,85,1,-29,2014-11-17
Gardner-Webb,College of Charleston,80,67,0,13,2014-11-17
Baptist Bible (PA),Delaware State,63,104,1,-41,2014-11-17
St. Joseph's,Drexel,52,49,0,3,2014-11-17
Eureka,Eastern Illinois,51,81,1,-30,2014-11-17
Oakland,Eastern Michigan,77,89,1,-12,2014-11-17
Utah Valley,Eastern Washington,50,75,1,-25,2014-11-17
Fairleigh Dickinson-Florham,Fairleigh Dickinson,61,102,1,-41,2014-11-17
Miami (FL),Florida,69,67,0,2,2014-11-17
Warner Southern,Florida Atlantic,49,74,1,-25,2014-11-17
UCSB,Florida Gulf Coast,75,81,1,-6,2014-11-17
Bristol University,Fresno State,55,93,1,-38,2014-11-17
SMU,Gonzaga,56,72,1,-16,2014-11-17
Montana State,Grand Canyon,45,61,1,-16,2014-11-17
Hillsdale,Houston Baptist,53,89,1,-36,2014-11-17
South Dakota State,Idaho,77,82,1,-5,2014-11-17
Western Illinois,UIC,64,67,1,-3,2014-11-17
Texas Southern,Indiana,64,83,1,-19,2014-11-17
North Dakota State,Iowa,56,87,1,-31,2014-11-17
Georgia State,Iowa State,58,81,1,-23,2014-11-17
Radford,James Madison,71,74,1,-3,2014-11-17
UMKC,Kansas State,73,83,1,-10,2014-11-17
Delaware,Liberty,55,61,1,-6,2014-11-17
Belmont,Lipscomb,87,62,0,25,2014-11-17
Champion Baptist,Louisiana-Monroe,39,106,1,-67,2014-11-17
Jacksonville State,Louisville,39,88,1,-49,2014-11-17
McKendree,Loyola (IL),68,78,1,-10,2014-11-17
Central Connecticut,Maryland,57,93,1,-36,2014-11-17
Bucknell,Michigan,53,77,1,-24,2014-11-17
Minnesota-Crookston,Milwaukee,54,75,1,-21,2014-11-17
Mississippi Valley State,Mississippi State,68,89,1,-21,2014-11-17
Cincinnati Christian,Morehead State,79,87,1,-8,2014-11-17
Towson,Morgan State,51,46,0,5,2014-11-17
Adams State,Nevada,64,69,1,-5,2014-11-17
Maine,NJIT,86,90,1,-4,2014-11-17
USC Upstate,North Carolina A&T,63,46,0,17,2014-11-17
Hofstra,NC State,64,76,1,-12,2014-11-17
Webber,North Florida,55,79,1,-24,2014-11-17
Nicholls State,North Texas,57,71,1,-14,2014-11-17
Lyon,Northwestern State,64,75,1,-11,2014-11-17
Detroit,Oregon,66,83,1,-17,2014-11-17
Cal Lutheran,Pepperdine,61,76,1,-15,2014-11-17
Binghamton,Providence,45,66,1,-21,2014-11-17
Vermont,Siena,84,76,0,8,2014-11-17
Louisiana State-Alexandria,Southern,65,76,1,-11,2014-11-17
Tennessee Tech,USC,58,70,1,-12,2014-11-17
Purdue-Fort Wayne,SIU-Edwardsville,74,71,0,3,2014-11-17
South Alabama,Southern Miss,59,68,1,-9,2014-11-17
Franklin Pierce,St. John's (NY),81,94,1,-13,2014-11-17
Louisiana Tech,Temple,75,82,1,-7,2014-11-17
Washington State,TCU,54,81,1,-27,2014-11-17
Texas-Rio Grande Valley,UTSA,63,62,0,1,2014-11-17
Ole Miss,Troy,74,64,0,10,2014-11-17
Wake Forest,Tulane,71,49,0,22,2014-11-17
Louisiana,Tulsa,53,64,1,-11,2014-11-17
Maryland-Eastern Shore,Villanova,44,81,1,-37,2014-11-17
Presentation College,Weber State,49,74,1,-25,2014-11-17
Newbury,Yale,51,97,1,-46,2014-11-17
Montana,Boise State,67,72,1,-5,2014-11-18
Little Rock,BYU,62,91,1,-29,2014-11-18
Chattanooga,Butler,48,70,1,-22,2014-11-18
San Francisco State,Cal Poly,44,65,1,-21,2014-11-18
Youngstown State,Central Michigan,63,75,1,-12,2014-11-18
Indiana-Northwest,Chicago State,51,102,1,-51,2014-11-18
Columbia International,Coastal Carolina,51,82,1,-31,2014-11-18
Auburn,Colorado,59,90,1,-31,2014-11-18
Wagner,Columbia,56,70,1,-14,2014-11-18
Colgate,Cornell,52,58,1,-6,2014-11-18
Campbell,Davidson,51,86,1,-35,2014-11-18
Drake,DePaul,62,80,1,-18,2014-11-18
Michigan State,Duke,71,81,1,-10,2014-11-18
Virginia Wise,ETSU,66,111,1,-45,2014-11-18
Kentucky Christian,Eastern Kentucky,35,115,1,-80,2014-11-18
Northeastern,Florida State,76,73,0,3,2014-11-18
Texas A&M-Corpus Christi,Georgetown,62,78,1,-16,2014-11-18
Stony Brook,Georgia,70,80,1,-10,2014-11-18
Trinity (CT),Georgia Southern,49,86,1,-37,2014-11-18
Alabama A&M,Georgia Tech,46,66,1,-20,2014-11-18
Lyon,Grambling,49,55,1,-6,2014-11-18
High Point,Hawaii,62,54,0,8,2014-11-18
Huston-Tillotson,Incarnate Word,63,94,1,-31,2014-11-18
Saint Louis,Indiana State,69,56,0,13,2014-11-18
Jackson State,Jacksonville,66,57,0,9,2014-11-18
Kentucky,Kansas,72,40,0,32,2014-11-18
Malone,Kent State,52,62,1,-10,2014-11-18
Canisius,Lehigh,63,51,0,12,2014-11-18
Texas Tech,LSU,64,69,1,-5,2014-11-18
West Virginia Tech,Marshall,65,87,1,-22,2014-11-18
Manhattan,UMass,68,77,1,-9,2014-11-18
Louisiana College,McNeese State,63,90,1,-27,2014-11-18
Wichita State,Memphis,71,56,0,15,2014-11-18
Murray State,Middle Tennessee,68,49,0,19,2014-11-18
Western Kentucky,Minnesota,54,76,1,-22,2014-11-18
Central Arkansas,Nebraska,56,82,1,-26,2014-11-18
Thomas (ME),New Hampshire,36,84,1,-48,2014-11-18
Cairn,New Orleans,61,88,1,-27,2014-11-18
College of Faith,North Carolina Central,65,123,1,-58,2014-11-18
UNC Wilmington,UNC Greensboro,84,72,0,12,2014-11-18
Mayville State,North Dakota,39,76,1,-37,2014-11-18
Marquette,Ohio State,63,74,1,-11,2014-11-18
Northwest Oklahoma State,Oklahoma State,45,91,1,-46,2014-11-18
Richmond,Old Dominion,57,63,1,-6,2014-11-18
Corban,Oregon State,62,86,1,-24,2014-11-18
Rider,Penn,73,57,0,16,2014-11-18
Willamette,Portland State,63,84,1,-21,2014-11-18
Piedmont,Presbyterian,72,82,1,-10,2014-11-18
La Salle,Quinnipiac,60,58,0,2,2014-11-18
New Mexico State,Saint Mary's,71,83,1,-12,2014-11-18
Utah,San Diego State,49,53,1,-4,2014-11-18
Baylor,South Carolina,69,65,0,4,2014-11-18
Hannibal-LaGrange,Southeast Missouri State,49,86,1,-37,2014-11-18
Northern Iowa,Stephen F. Austin,79,77,0,2,2014-11-18
Florida International,Stetson,53,52,0,1,2014-11-18
Southern Illinois,Tennessee State,84,67,0,17,2014-11-18
Buffalo,Texas-Arlington,74,68,0,6,2014-11-18
South Carolina State,Virginia,55,75,1,-20,2014-11-18
Toledo,VCU,78,87,1,-9,2014-11-18
Johnson University,VMI,42,124,1,-82,2014-11-18
Howard,William & Mary,49,56,1,-7,2014-11-18
Iona,Wofford,73,86,1,-13,2014-11-18
Western State,Wyoming,46,61,1,-15,2014-11-18
Long Beach State,Xavier,74,97,1,-23,2014-11-18
Colorado Christian,Air Force,47,70,1,-23,2014-11-19
NJIT,Albany (NY),48,65,1,-17,2014-11-19
UC-Irvine,Arizona,54,71,1,-17,2014-11-19
Wake Forest,Arkansas,53,83,1,-30,2014-11-19
Trevecca Nazarene,Belmont,76,96,1,-20,2014-11-19
Hartwick,Binghamton,51,82,1,-31,2014-11-19
Wright State,Bowling Green State,55,70,1,-15,2014-11-19
Robert Morris,Bradley,68,61,0,7,2014-11-19
Southern Virginia,BYU,48,101,1,-53,2014-11-19
Montana State,Cal State Northridge,65,72,1,-7,2014-11-19
Morehead State,Cincinnati,61,69,1,-8,2014-11-19
Toccoa Falls,Citadel,58,71,1,-13,2014-11-19
Jacksonville State,Cleveland State,46,60,1,-14,2014-11-19
Oklahoma,Creighton,63,65,1,-2,2014-11-19
Walla Walla,Eastern Washington,34,95,1,-61,2014-11-19
Ohio,Florida Gulf Coast,62,79,1,-17,2014-11-19
Appalachian State,Furman,65,84,1,-19,2014-11-19
St. Joseph's,Gonzaga,42,94,1,-52,2014-11-19
Dartmouth,Hartford,48,53,1,-5,2014-11-19
Hawaii-Hilo,Hawaii,71,89,1,-18,2014-11-19
Brown,Holy Cross,65,80,1,-15,2014-11-19
Longwood,James Madison,60,82,1,-22,2014-11-19
Princeton,Lafayette,66,83,1,-17,2014-11-19
UMBC,Loyola (MD),38,45,1,-7,2014-11-19
Kennesaw State,Mercer,66,74,1,-8,2014-11-19
Evansville,Miami (OH),69,50,0,19,2014-11-19
IUPUI,Milwaukee,70,68,0,2,2014-11-19
Oral Roberts,Missouri,64,78,1,-14,2014-11-19
Missouri S&T,UMKC,77,90,1,-13,2014-11-19
Avila,Missouri State,39,87,1,-48,2014-11-19
Maryland-Eastern Shore,Mount St. Mary's,53,41,0,12,2014-11-19
Northern Colorado,New Mexico State,65,86,1,-21,2014-11-19
Boston University,Norfolk State,71,63,0,8,2014-11-19
Johnson & Wales (NC),UNC Asheville,48,87,1,-39,2014-11-19
Delaware State,North Texas,55,62,1,-7,2014-11-19
North Carolina A&T,Northern Kentucky,55,68,1,-13,2014-11-19
Coppin State,Notre Dame,67,104,1,-37,2014-11-19
Western Michigan,Oakland,82,71,0,11,2014-11-19
Prairie View,Rice,64,68,1,-4,2014-11-19
Fairleigh Dickinson,Rutgers,44,61,1,-17,2014-11-19
Simpson,Sacramento State,42,74,1,-32,2014-11-19
Austin Peay,Samford,67,68,1,-1,2014-11-19
Florida A&M,San Diego,41,72,1,-31,2014-11-19
Notre Dame de Namur,San Francisco,46,86,1,-40,2014-11-19
Pepperdine,San Jose State,63,44,0,19,2014-11-19
Omaha,Seattle,74,98,1,-24,2014-11-19
Siena,St. Bonaventure,73,70,0,3,2014-11-19
Army,St. Francis (NY),74,71,0,3,2014-11-19
LIU-Brooklyn,St. John's (NY),53,66,1,-13,2014-11-19
Lamar,Texas State,55,65,1,-10,2014-11-19
Abilene Christian,Tulsa,39,65,1,-26,2014-11-19
Santa Clara,Utah State,54,60,1,-6,2014-11-19
Indiana-South Bend,Valparaiso,55,91,1,-36,2014-11-19
Southern Vermont,Vermont,41,86,1,-45,2014-11-19
Liberty,Virginia Tech,63,73,1,-10,2014-11-19
Green Bay,Wisconsin,60,84,1,-24,2014-11-19
USC,Akron,46,66,1,-20,2014-11-20
Southern Miss,Alabama,67,81,1,-14,2014-11-20
South Florida,Alabama-Birmingham,73,71,0,2,2014-11-20
Loyola Marymount,Arizona State,44,68,1,-24,2014-11-20
New Mexico,Boston College,65,69,1,-4,2014-11-20
New Hampshire,Bryant,63,72,1,-9,2014-11-20
Syracuse,California,59,73,1,-14,2014-11-20
Eckerd,UCF,59,76,1,-17,2014-11-20
Penn State,Charlotte,97,106,1,-9,2014-11-20
UConn,College of Charleston,65,57,0,8,2014-11-20
South Carolina,Cornell,69,45,0,24,2014-11-20
Texas A&M,Dayton,53,55,1,-2,2014-11-20
Miami (FL),Drexel,66,46,0,20,2014-11-20
Virginia-Lynchburg,East Carolina,51,92,1,-41,2014-11-20
UC-Davis,Eastern Illinois,63,61,0,2,2014-11-20
West Virginia,George Mason,91,65,0,26,2014-11-20
Texas-Arlington,Grand Canyon,66,64,0,2,2014-11-20
Florida Atlantic,Harvard,49,71,1,-22,2014-11-20
SMU,Indiana,68,74,1,-6,2014-11-20
Texas,Iowa,71,57,0,14,2014-11-20
Northwestern State,Louisiana State-Alexandria,89,79,0,10,2014-11-20
Fordham,Maryland,50,66,1,-16,2014-11-20
Detroit,Michigan,62,71,1,-9,2014-11-20
Franklin Pierce,Minnesota,57,109,1,-52,2014-11-20
Southern,Ole Miss,38,69,1,-31,2014-11-20
Brescia,Murray State,56,89,1,-33,2014-11-20
Jacksonville,NC State,43,79,1,-36,2014-11-20
Fresno State,Northern Arizona,52,73,1,-21,2014-11-20
Idaho,Northern Illinois,67,78,1,-11,2014-11-20
Morgan State,Northern Iowa,53,73,1,-20,2014-11-20
North Florida,Northwestern,67,69,1,-2,2014-11-20
Pacific Union,Pacific,56,81,1,-25,2014-11-20
Navy,Providence,51,88,1,-37,2014-11-20
Grambling,Purdue,30,82,1,-52,2014-11-20
Howard,Radford,52,61,1,-9,2014-11-20
UMass-Lowell,Sacred Heart,57,54,0,3,2014-11-20
Keystone,Saint Francis (PA),69,102,1,-33,2014-11-20
Denver,Saint Mary's,62,78,1,-16,2014-11-20
Niagara,St. Peter's,61,59,0,2,2014-11-20
Cal State Bakersfield,San Diego State,27,51,1,-24,2014-11-20
Winthrop,Savannah State,58,59,1,-1,2014-11-20
Bob Jones University,USC Upstate,41,107,1,-66,2014-11-20
Palm Beach Atlantic,Stetson,85,96,1,-11,2014-11-20
Texas Southern,Tennessee,58,70,1,-12,2014-11-20
Champion Baptist,UT-Martin,29,115,1,-86,2014-11-20
Fisk,Tennessee State,60,75,1,-15,2014-11-20
New Orleans,TCU,71,86,1,-15,2014-11-20
Mississippi Valley State,Tulane,61,100,1,-39,2014-11-20
Nicholls State,UCLA,74,107,1,-33,2014-11-20
Lipscomb,Vanderbilt,62,72,1,-10,2014-11-20
Bucknell,Villanova,65,72,1,-7,2014-11-20
Maryland-Eastern Shore,VCU,66,106,1,-40,2014-11-20
NYIT,Wagner,49,83,1,-34,2014-11-20
Bluefield (WV),William & Mary,57,100,1,-43,2014-11-20
Miami (FL),Akron,79,51,0,28,2014-11-21
Hampton,Alcorn State,82,69,0,13,2014-11-21
Presbyterian,American,38,63,1,-25,2014-11-21
Delaware State,Arkansas,71,99,1,-28,2014-11-21
Valparaiso,Arkansas-Pine Bluff,59,46,0,13,2014-11-21
Louisiana,Auburn,80,105,1,-25,2014-11-21
Prairie View,Baylor,45,60,1,-15,2014-11-21
West Virginia,Boston College,70,66,0,4,2014-11-21
Delaware,Cal Poly,60,78,1,-18,2014-11-21
Texas,California,71,55,0,16,2014-11-21
Towson,Central Connecticut,58,49,0,9,2014-11-21
Maine,Central Michigan,48,76,1,-28,2014-11-21
South Carolina,Charlotte,63,65,1,-2,2014-11-21
Gardner-Webb,Clemson,72,70,0,2,2014-11-21
Texas A&M,College of Charleston,59,50,0,9,2014-11-21
Georgia State,Colorado State,70,80,1,-10,2014-11-21
Dayton,UConn,64,75,1,-11,2014-11-21
Penn State,Cornell,72,71,0,1,2014-11-21
USC,Drexel,72,70,0,2,2014-11-21
Temple,Duke,54,74,1,-20,2014-11-21
Youngstown State,Eastern Michigan,62,71,1,-9,2014-11-21
Wofford,Fairfield,54,36,0,18,2014-11-21
Louisiana-Monroe,Florida,56,61,1,-5,2014-11-21
Florida Memorial,Florida International,48,74,1,-26,2014-11-21
New Mexico,George Mason,69,58,0,11,2014-11-21
Troy,Georgia,60,82,1,-22,2014-11-21
Purdue-Fort Wayne,Georgia Tech,69,78,1,-9,2014-11-21
Florida A&M,Grand Canyon,49,64,1,-15,2014-11-21
Pitt,Hawaii,70,74,1,-4,2014-11-21
Stony Brook,Hofstra,65,66,1,-1,2014-11-21
Austin Peay,Illinois,66,107,1,-41,2014-11-21
Yale,UIC,70,58,0,12,2014-11-21
Weber State,Illinois State,64,73,1,-9,2014-11-21
Syracuse,Iowa,66,63,0,3,2014-11-21
Southern Illinois,Kent State,51,74,1,-23,2014-11-21
Boston University,Kentucky,65,89,1,-24,2014-11-21
Kansas State,Long Beach State,60,69,1,-9,2014-11-21
UNC Greensboro,Longwood,79,81,1,-2,2014-11-21
Old Dominion,LSU,70,61,0,9,2014-11-21
Morehead State,Louisiana Tech,64,73,1,-9,2014-11-21
Marshall,Louisville,67,85,1,-18,2014-11-21
Jarvis Christian,McNeese State,70,85,1,-15,2014-11-21
Loyola (IL),Michigan State,52,87,1,-35,2014-11-21
Bethune-Cookman,Monmouth,50,73,1,-23,2014-11-21
Seton Hall,Nevada,68,60,0,8,2014-11-21
Stanford,UNLV,89,60,0,29,2014-11-21
Kennesaw State,North Dakota State,55,68,1,-13,2014-11-21
Milwaukee,Oklahoma State,68,82,1,-14,2014-11-21
Toledo,Oregon,68,78,1,-10,2014-11-21
Oral Roberts,Oregon State,42,55,1,-13,2014-11-21
Lehigh,Rider,74,78,1,-4,2014-11-21
South Dakota,Sam Houston State,85,93,1,-8,2014-11-21
Washington,Seattle,63,48,0,15,2014-11-21
North Dakota,South Dakota State,72,74,1,-2,2014-11-21
UC-Riverside,Utah,42,88,1,-46,2014-11-21
George Washington,Virginia,42,59,1,-17,2014-11-21
Iona,Wake Forest,85,81,0,4,2014-11-21
Idaho State,Washington State,68,80,1,-12,2014-11-21
Hiwassee,Western Carolina,53,72,1,-19,2014-11-21
Stephen F. Austin,Xavier,63,81,1,-18,2014-11-21
Duquesne,Abilene Christian,102,81,0,21,2014-11-22
Western State,Air Force,60,90,1,-30,2014-11-22
Oakwood,Alabama A&M,61,81,1,-20,2014-11-22
Quinnipiac,Albany (NY),76,73,0,3,2014-11-22
Kennesaw State,Alcorn State,83,80,0,3,2014-11-22
UMKC,Little Rock,68,73,1,-5,2014-11-22
Towson,Bethune-Cookman,63,42,0,21,2014-11-22
Manhattan,Binghamton,78,63,0,15,2014-11-22
Mount St. Mary's,Bucknell,73,69,0,4,2014-11-22
Loyola (MD),Butler,39,80,1,-41,2014-11-22
San Jose State,Cal State Fullerton,66,70,1,-4,2014-11-22
Samford,Cal State Northridge,72,79,1,-7,2014-11-22
Master's,UCSB,45,91,1,-46,2014-11-22
Colgate,Campbell,54,48,0,6,2014-11-22
Southeast Missouri State,Central Arkansas,74,68,0,6,2014-11-22
Wright State,Charleston Southern,86,79,0,7,2014-11-22
Trinity Christian,Chicago State,52,75,1,-23,2014-11-22
Bob Jones University,Citadel,50,81,1,-31,2014-11-22
Nevada,Clemson,50,59,1,-9,2014-11-22
Piedmont,Coastal Carolina,33,76,1,-43,2014-11-22
UNC,Davidson,90,72,0,18,2014-11-22
South Alabama,Detroit,53,66,1,-13,2014-11-22
Stanford,Duke,59,70,1,-11,2014-11-22
UNC Asheville,ETSU,87,98,1,-11,2014-11-22
Cincinnati-Clermont,Eastern Kentucky,50,115,1,-65,2014-11-22
UNC Greensboro,Eastern Michigan,62,70,1,-8,2014-11-22
Sam Houston State,Fairfield,74,60,0,14,2014-11-22
Providence,Florida State,80,54,0,26,2014-11-22
UC-Davis,Furman,58,55,0,3,2014-11-22
Robert Morris,Georgetown,66,80,1,-14,2014-11-22
Florida Christian,Georgia Southern,41,97,1,-56,2014-11-22
St. Thomas Aquinas,Gonzaga,55,109,1,-54,2014-11-22
Morgan State,Houston,57,72,1,-15,2014-11-22
Kent State,UIC,78,60,0,18,2014-11-22
Lamar,Indiana,72,85,1,-13,2014-11-22
Brown,Indiana State,66,78,1,-12,2014-11-22
Ball State,IUPUI,69,71,1,-2,2014-11-22
Miles,Jacksonville State,71,88,1,-17,2014-11-22
St. Peter's,La Salle,50,59,1,-9,2014-11-22
Transylvania,Lipscomb,63,74,1,-11,2014-11-22
Youngstown State,Longwood,82,72,0,10,2014-11-22
Weber State,LSU,58,72,1,-14,2014-11-22
American,Louisiana Tech,44,63,1,-19,2014-11-22
Army,Marist,76,62,0,14,2014-11-22
Omaha,Marquette,97,89,0,8,2014-11-22
Notre Dame,UMass,81,68,0,13,2014-11-22
Liberty,Miami (OH),52,63,1,-11,2014-11-22
Southern,Middle Tennessee,48,66,1,-18,2014-11-22
UMBC,Minnesota,51,69,1,-18,2014-11-22
Utah State,Mississippi State,63,71,1,-8,2014-11-22
Central Connecticut,Monmouth,50,65,1,-15,2014-11-22
Presbyterian,Morehead State,49,69,1,-20,2014-11-22
Northeastern,Navy,68,44,0,24,2014-11-22
Temple,UNLV,50,57,1,-7,2014-11-22
Hartford,Niagara,65,62,0,3,2014-11-22
UMass-Lowell,NJIT,63,61,0,2,2014-11-22
Texas Southern,Norfolk State,66,76,1,-10,2014-11-22
Hampton,North Dakota State,66,74,1,-8,2014-11-22
North Florida,Northern Iowa,49,66,1,-17,2014-11-22
Ohio Mid-Western,Northern Kentucky,48,98,1,-50,2014-11-22
Elon,Northwestern,67,68,1,-1,2014-11-22
Lafayette,Penn,83,77,0,6,2014-11-22
SIU-Edwardsville,Portland,53,75,1,-22,2014-11-22
Incarnate Word,Princeton,79,68,0,11,2014-11-22
Nebraska,Rhode Island,62,66,1,-4,2014-11-22
William & Mary,Rice,69,65,0,4,2014-11-22
High Point,Richmond,56,80,1,-24,2014-11-22
Maryland-Eastern Shore,Saint Francis (PA),53,57,1,-4,2014-11-22
Vermont,St. Joseph's,60,68,1,-8,2014-11-22
Cleveland State,Savannah State,83,87,1,-4,2014-11-22
Wofford,South Dakota,72,68,0,4,2014-11-22
Yale,Southern Illinois,53,46,0,7,2014-11-22
Eastern Washington,SMU,68,77,1,-9,2014-11-22
Utah Valley,Southern Utah,85,75,0,10,2014-11-22
Canisius,St. Bonaventure,53,59,1,-6,2014-11-22
Chattanooga,Tennessee Tech,67,69,1,-2,2014-11-22
Houston Baptist,Texas-Arlington,69,87,1,-18,2014-11-22
New Mexico State,UTEP,76,77,1,-1,2014-11-22
Texas A&M-Kingsville,Texas-Rio Grande Valley,77,82,1,-5,2014-11-22
Texas State,UTSA,67,80,1,-13,2014-11-22
Missouri State,Texas Tech,68,80,1,-12,2014-11-22
Southern-New Orleans,Tulane,45,89,1,-44,2014-11-22
UNC Wilmington,VMI,110,93,0,17,2014-11-22
Appalachian State,Virginia Tech,65,63,0,2,2014-11-22
Southeastern Louisiana,Western Illinois,57,60,1,-3,2014-11-22
Belmont,Western Kentucky,64,63,0,1,2014-11-22
Drake,Western Michigan,75,91,1,-16,2014-11-22
Boise State,Wisconsin,54,78,1,-24,2014-11-22
Colorado,Wyoming,33,56,1,-23,2014-11-22
South Carolina,Akron,63,68,1,-5,2014-11-23
Jackson State,Alabama-Birmingham,50,58,1,-8,2014-11-23
Morehead State,American,46,51,1,-5,2014-11-23
Cal State Northridge,Little Rock,88,94,1,-6,2014-11-23
Central Connecticut,Bethune-Cookman,60,65,1,-5,2014-11-23
Navy,Binghamton,70,68,0,2,2014-11-23
Dayton,Boston College,65,53,0,12,2014-11-23
North Carolina A&T,Bradley,50,58,1,-8,2014-11-23
Delaware,Cal State Bakersfield,52,70,1,-18,2014-11-23
St. Katherine,UC-Riverside,49,102,1,-53,2014-11-23
USC Upstate,UCF,69,76,1,-7,2014-11-23
Arkansas-Pine Bluff,Central Michigan,43,75,1,-32,2014-11-23
Miami (FL),Charlotte,77,58,0,19,2014-11-23
Eastern Illinois,Cincinnati,49,54,1,-5,2014-11-23
George Mason,College of Charleston,60,61,1,-1,2014-11-23
Mercer,Colorado State,62,75,1,-13,2014-11-23
West Virginia,UConn,78,68,0,10,2014-11-23
Drexel,Cornell,61,59,0,2,2014-11-23
North Carolina Central,Creighton,45,65,1,-20,2014-11-23
Coppin State,Denver,54,80,1,-26,2014-11-23
Longwood,Eastern Michigan,48,79,1,-31,2014-11-23
South Dakota,Fairfield,72,80,1,-8,2014-11-23
UMass,Florida State,75,69,0,6,2014-11-23
UMass-Lowell,Fordham,64,57,0,7,2014-11-23
Seton Hall,Gardner-Webb,85,67,0,18,2014-11-23
Florida Atlantic,Georgia,61,74,1,-13,2014-11-23
Wagner,Hofstra,71,93,1,-22,2014-11-23
Nichols,Holy Cross,70,101,1,-31,2014-11-23
Hood,Howard,51,78,1,-27,2014-11-23
Southern Illinois,UIC,67,60,0,7,2014-11-23
Old Dominion,Illinois State,45,64,1,-19,2014-11-23
Yale,Kent State,66,59,0,7,2014-11-23
Montana State,Kentucky,28,86,1,-58,2014-11-23
Columbia,Lehigh,54,44,0,10,2014-11-23
Presbyterian,Louisiana Tech,48,76,1,-28,2014-11-23
San Diego Christian,Loyola Marymount,60,82,1,-22,2014-11-23
Valparaiso,Maine,93,70,0,23,2014-11-23
Northeastern,Manhattan,65,51,0,14,2014-11-23
Northern Arizona,Ole Miss,74,80,1,-6,2014-11-23
Samford,UMKC,64,55,0,9,2014-11-23
Towson,Monmouth,79,75,0,4,2014-11-23
Texas A&M,New Mexico,64,51,0,13,2014-11-23
Youngstown State,UNC Greensboro,76,67,0,9,2014-11-23
South Florida,NC State,65,68,1,-3,2014-11-23
Iona,North Texas,78,58,0,20,2014-11-23
Providence,Notre Dame,75,74,0,1,2014-11-23
Sacred Heart,Ohio State,48,106,1,-58,2014-11-23
Northwestern State,Oklahoma,68,90,1,-22,2014-11-23
Washington,Pacific,76,69,0,7,2014-11-23
USC,Penn State,61,63,1,-2,2014-11-23
Catawba,Radford,52,88,1,-36,2014-11-23
St. Francis (NY),Rutgers,73,76,1,-3,2014-11-23
Texas A&M-Corpus Christi,Saint Louis,62,56,0,6,2014-11-23
UC-Irvine,Saint Mary's,69,72,1,-3,2014-11-23
Wofford,Sam Houston State,64,53,0,11,2014-11-23
Montana,Seattle,66,62,0,4,2014-11-23
Merchant Marine,Stony Brook,54,89,1,-35,2014-11-23
Long Beach State,UCLA,63,77,1,-14,2014-11-23
Tennessee State,Vanderbilt,46,78,1,-32,2014-11-23
Newman,Wichita State,57,105,1,-48,2014-11-23
Iowa State,Alabama,84,74,0,10,2014-11-24
Dillard,Alcorn State,73,95,1,-22,2014-11-24
Hampton,Appalachian State,74,82,1,-8,2014-11-24
Missouri,Arizona,53,72,1,-19,2014-11-24
Maryland,Arizona State,78,73,0,5,2014-11-24
Tulsa,Auburn,53,35,0,18,2014-11-24
Grambling,Ball State,46,88,1,-42,2014-11-24
Stephen F. Austin,Baylor,51,67,1,-16,2014-11-24
Lipscomb,Belmont,77,82,1,-5,2014-11-24
San Diego State,BYU,92,87,0,5,2014-11-24
Pitt,Chaminade,81,68,0,13,2014-11-24
Georgia State,Chicago State,69,46,0,23,2014-11-24
LSU,Clemson,61,64,1,-3,2014-11-24
Maryland-Eastern Shore,Detroit,55,69,1,-14,2014-11-24
Green Bay,East Carolina,66,49,0,17,2014-11-24
Fresno State,Evansville,52,58,1,-6,2014-11-24
Marist,Florida Gulf Coast,43,58,1,-15,2014-11-24
Old Dominion,Gardner-Webb,58,46,0,12,2014-11-24
Florida International,Georgia Southern,72,78,1,-6,2014-11-24
San Francisco,Hawaii,88,73,0,15,2014-11-24
Brown,Illinois,68,89,1,-21,2014-11-24
Seton Hall,Illinois State,84,80,0,4,2014-11-24
Texas A&M-International,Incarnate Word,83,105,1,-22,2014-11-24
Eastern Washington,Indiana,88,86,0,2,2014-11-24
Austin Peay,Indiana State,57,61,1,-4,2014-11-24
Pepperdine,Iowa,61,72,1,-11,2014-11-24
Jacksonville,Purdue-Fort Wayne,71,89,1,-18,2014-11-24
Colgate,James Madison,71,77,1,-6,2014-11-24
Rider,Kansas,60,87,1,-27,2014-11-24
Purdue,Kansas State,79,88,1,-9,2014-11-24
Milwaukee,Louisiana,56,52,0,4,2014-11-24
Savannah State,Louisville,26,87,1,-61,2014-11-24
NJIT,Marquette,57,62,1,-5,2014-11-24
Prairie View,Memphis,49,77,1,-28,2014-11-24
Oregon,Michigan,63,70,1,-7,2014-11-24
Santa Clara,Michigan State,52,79,1,-27,2014-11-24
Clayton State,Mississippi State,46,59,1,-13,2014-11-24
Weber State,Nevada,59,56,0,3,2014-11-24
Stetson,New Mexico State,68,88,1,-20,2014-11-24
Colorado Christian,Northern Colorado,58,93,1,-35,2014-11-24
Western Carolina,Oakland,88,79,0,9,2014-11-24
Oregon State,Oklahoma State,53,66,1,-13,2014-11-24
SIU-Edwardsville,Portland State,87,90,1,-3,2014-11-24
Western Michigan,San Diego,70,77,1,-7,2014-11-24
Chadron State,South Dakota State,42,87,1,-45,2014-11-24
Southeastern Louisiana,Tennessee Tech,62,81,1,-19,2014-11-24
Mississippi Valley State,TCU,53,106,1,-53,2014-11-24
Bucknell,Toledo,65,92,1,-27,2014-11-24
VCU,Villanova,53,77,1,-24,2014-11-24
Nicholls State,Wake Forest,48,75,1,-27,2014-11-24
ETSU,Winthrop,69,64,0,5,2014-11-24
Florida A&M,Wyoming,45,66,1,-21,2014-11-24
Murray State,Xavier,62,89,1,-27,2014-11-24
Jarvis Christian,Abilene Christian,65,91,1,-26,2014-11-25
Arizona State,Alabama,71,76,1,-5,2014-11-25
Jacksonville State,Alabama A&M,67,61,0,6,2014-11-25
Kansas State,Arizona,68,72,1,-4,2014-11-25
Lamar,Arkansas State,63,58,0,5,2014-11-25
Binghamton,Army,54,80,1,-26,2014-11-25
UT-Martin,Bethune-Cookman,74,56,0,18,2014-11-25
Idaho,Boise State,75,86,1,-11,2014-11-25
Southeast Missouri State,Bowling Green State,54,62,1,-8,2014-11-25
Texas A&M-Corpus Christi,Bradley,38,52,1,-14,2014-11-25
Chaminade,BYU,85,121,1,-36,2014-11-25
Maryland-Eastern Shore,Bucknell,55,58,1,-3,2014-11-25
Central Arkansas,Charleston Southern,67,80,1,-13,2014-11-25
Miami (FL),Charlotte,77,74,0,3,2014-11-25
North Carolina Central,Cincinnati,50,59,1,-9,2014-11-25
Air Force,Colorado,53,68,1,-15,2014-11-25
Fairleigh Dickinson,Columbia,47,57,1,-10,2014-11-25
Eastern Illinois,Creighton,53,75,1,-22,2014-11-25
Toledo,Detroit,79,82,1,-3,2014-11-25
IUPUI,Drake,60,73,1,-13,2014-11-25
Fresno State,East Carolina,52,58,1,-6,2014-11-25
Morgan State,Elon,73,74,1,-1,2014-11-25
Green Bay,Evansville,64,62,0,2,2014-11-25
San Francisco,Florida Gulf Coast,47,62,1,-15,2014-11-25
Citadel,Florida State,55,66,1,-11,2014-11-25
Western Carolina,Georgia State,70,85,1,-15,2014-11-25
Buffalo,Grand Canyon,80,64,0,16,2014-11-25
Houston,Harvard,63,84,1,-21,2014-11-25
Marist,Hawaii,55,62,1,-7,2014-11-25
Peace,High Point,71,88,1,-17,2014-11-25
Saint Xavier (IL),UIC,76,87,1,-11,2014-11-25
Maryland,Iowa State,72,63,0,9,2014-11-25
Texas-Arlington,Kentucky,44,92,1,-48,2014-11-25
St. Francis (NY),La Salle,60,73,1,-13,2014-11-25
North Florida,Liberty,77,57,0,20,2014-11-25
Oral Roberts,Louisiana,52,76,1,-24,2014-11-25
Howard,UMBC,68,54,0,14,2014-11-25
Mount Ida,UMass-Lowell,57,102,1,-45,2014-11-25
Northwestern,Miami (OH),55,46,0,9,2014-11-25
Villanova,Michigan,60,55,0,5,2014-11-25
Northern Arizona,Middle Tennessee,53,65,1,-12,2014-11-25
Purdue,Missouri,82,61,0,21,2014-11-25
Omaha,Nebraska,67,80,1,-13,2014-11-25
Boston University,New Hampshire,68,75,1,-7,2014-11-25
Minnesota-Crookston,North Dakota State,63,64,1,-1,2014-11-25
Virginia Tech,Northern Iowa,54,73,1,-19,2014-11-25
Chicago State,Oakland,57,70,1,-13,2014-11-25
Arkansas-Pine Bluff,Ohio,60,69,1,-9,2014-11-25
VCU,Oregon,77,63,0,14,2014-11-25
Akron,Penn State,72,78,1,-6,2014-11-25
San Diego State,Pitt,74,57,0,17,2014-11-25
Toccoa Falls,Presbyterian,40,63,1,-23,2014-11-25
Hartford,Quinnipiac,54,50,0,4,2014-11-25
St. Peter's,Rutgers,68,50,0,18,2014-11-25
Bristol University,Sacramento State,63,97,1,-34,2014-11-25
LIU-Brooklyn,St. Joseph's,70,74,1,-4,2014-11-25
North Carolina A&T,Saint Louis,54,57,1,-3,2014-11-25
Columbia International,South Carolina State,55,92,1,-37,2014-11-25
Hofstra,South Florida,70,71,1,-1,2014-11-25
Cal State Fullerton,USC,49,53,1,-4,2014-11-25
Arkansas,SMU,78,72,0,6,2014-11-25
Troy,Southern Miss,70,72,1,-2,2014-11-25
Jackson State,St. Bonaventure,71,79,1,-8,2014-11-25
Delaware,Stanford,47,84,1,-37,2014-11-25
Western Kentucky,Stony Brook,61,71,1,-10,2014-11-25
Loyola (MD),Syracuse,37,70,1,-33,2014-11-25
Penn,Temple,67,76,1,-9,2014-11-25
Saint Francis (PA),Texas,46,78,1,-32,2014-11-25
Loyola (IL),UTSA,71,57,0,14,2014-11-25
Northwestern State,Texas Tech,64,75,1,-11,2014-11-25
Southern,Tulane,59,74,1,-15,2014-11-25
Norfolk State,Vanderbilt,53,63,1,-10,2014-11-25
Tennessee State,Virginia,36,79,1,-43,2014-11-25
Western Illinois,William & Mary,49,83,1,-34,2014-11-25
Ohio Valley,Wofford,54,82,1,-28,2014-11-25
Wisconsin,Alabama-Birmingham,72,43,0,29,2014-11-26
North Dakota,Alabama State,75,68,0,7,2014-11-26
Pacific,Alaska-Anchorage,71,62,0,9,2014-11-26
San Diego State,Arizona,59,61,1,-2,2014-11-26
Oregon State,Auburn,69,71,1,-2,2014-11-26
Denver,Belmont,57,78,1,-21,2014-11-26
Purdue,BYU,87,85,0,2,2014-11-26
UNC,Butler,66,74,1,-8,2014-11-26
Portland State,Cal State Northridge,63,55,0,8,2014-11-26
Cal Poly,California,52,72,1,-20,2014-11-26
Utah State,UC-Davis,70,77,1,-7,2014-11-26
Davidson,UCF,95,69,0,26,2014-11-26
Missouri,Chaminade,74,60,0,14,2014-11-26
Robert Morris,Chattanooga,46,61,1,-15,2014-11-26
Western Carolina,Chicago State,66,61,0,5,2014-11-26
Louisiana-Monroe,Coastal Carolina,48,61,1,-13,2014-11-26
Albany (NY),Colgate,75,71,0,4,2014-11-26
Canisius,Cornell,60,67,1,-7,2014-11-26
Lehigh,DePaul,86,74,0,12,2014-11-26
Furman,Duke,54,93,1,-39,2014-11-26
Hawaii,East Carolina,75,73,0,2,2014-11-26
Rochester (MI),Eastern Michigan,35,68,1,-33,2014-11-26
Northern Kentucky,Eastern Washington,60,81,1,-21,2014-11-26
North Florida,Elon,72,65,0,7,2014-11-26
San Francisco,Evansville,72,79,1,-7,2014-11-26
Georgetown,Florida,66,65,0,1,2014-11-26
Green Bay,Florida Gulf Coast,59,45,0,14,2014-11-26
Marist,Fresno State,68,64,0,4,2014-11-26
Longwood,George Washington,66,91,1,-25,2014-11-26
Gonzaga,Georgia,88,76,0,12,2014-11-26
American,Hampton,64,60,0,4,2014-11-26
Utah Valley,Idaho State,60,57,0,3,2014-11-26
Delaware State,Iona,76,126,1,-50,2014-11-26
Northern Illinois,Iowa,49,70,1,-21,2014-11-26
Trinity Baptist,Jacksonville,57,69,1,-12,2014-11-26
Sacred Heart,James Madison,72,79,1,-7,2014-11-26
Pitt,Kansas State,70,47,0,23,2014-11-26
Samford,Kennesaw State,71,84,1,-13,2014-11-26
Morgan State,Liberty,51,50,0,1,2014-11-26
Cleveland State,Louisville,33,45,1,-12,2014-11-26
UC-Riverside,Loyola Marymount,62,66,1,-4,2014-11-26
Morehead State,Marshall,77,68,0,9,2014-11-26
Northeastern,UMass,54,79,1,-25,2014-11-26
Virginia Tech,Miami (OH),78,63,0,15,2014-11-26
Oral Roberts,Milwaukee,69,66,0,3,2014-11-26
St. John's (NY),Minnesota,70,61,0,9,2014-11-26
Carroll (MT),Montana,52,75,1,-23,2014-11-26
Penn State-Harrisburg,Navy,42,67,1,-25,2014-11-26
Florida A&M,New Mexico State,33,78,1,-45,2014-11-26
Richmond,NC State,72,84,1,-12,2014-11-26
Mississippi Valley State,North Texas,52,67,1,-15,2014-11-26
Northwestern,Northern Iowa,42,61,1,-19,2014-11-26
Grambling,Notre Dame,54,81,1,-27,2014-11-26
Georgia State,Oakland,83,78,0,5,2014-11-26
Campbell,Ohio State,64,91,1,-27,2014-11-26
UCLA,Oklahoma,65,75,1,-10,2014-11-26
Tulsa,Oklahoma State,58,73,1,-15,2014-11-26
UNC Asheville,South Carolina,75,89,1,-14,2014-11-26
Wayne State (NE),South Dakota,69,86,1,-17,2014-11-26
Tennessee Tech,Southeastern Louisiana,68,86,1,-18,2014-11-26
Texas Southern,SMU,59,72,1,-13,2014-11-26
Eastern Kentucky,Southern Utah,73,64,0,9,2014-11-26
Radford,TCU,50,74,1,-24,2014-11-26
Goucher,Towson,43,97,1,-54,2014-11-26
Texas-Rio Grande Valley,Utah,48,85,1,-37,2014-11-26
Bryant,Vermont,47,73,1,-26,2014-11-26
West Virginia,VMI,103,72,0,31,2014-11-26
Mount St. Mary's,Wake Forest,49,83,1,-34,2014-11-26
Stetson,Wyoming,41,65,1,-24,2014-11-26
Lafayette,Yale,60,82,1,-22,2014-11-26
UMKC,Youngstown State,63,66,1,-3,2014-11-26
Florida,Alabama-Birmingham,56,47,0,9,2014-11-27
Brown,Austin Peay,58,79,1,-21,2014-11-27
Memphis,Baylor,47,71,1,-24,2014-11-27
Oklahoma,Butler,59,46,0,13,2014-11-27
Wright State,Cal State Fullerton,62,67,1,-5,2014-11-27
Washington State,UCSB,43,71,1,-28,2014-11-27
Coastal Carolina,Chattanooga,67,78,1,-11,2014-11-27
Missouri State,Colorado State,61,76,1,-15,2014-11-27
Wisconsin,Georgetown,68,65,0,3,2014-11-27
Marquette,Georgia Tech,72,70,0,2,2014-11-27
Indiana State,Illinois,62,88,1,-26,2014-11-27
Rhode Island,Kansas,60,76,1,-16,2014-11-27
Western Michigan,Long Beach State,55,73,1,-18,2014-11-27
Stony Brook,LIU-Brooklyn,73,54,0,19,2014-11-27
Robert Morris,Louisiana-Monroe,71,54,0,17,2014-11-27
Rice,Mercer,71,77,1,-6,2014-11-27
Rider,Michigan State,45,77,1,-32,2014-11-27
UCLA,UNC,56,78,1,-22,2014-11-27
Stephen F. Austin,Prairie View,73,61,0,12,2014-11-27
UTEP,Princeton,62,56,0,6,2014-11-27
Western Kentucky,St. Joseph's,62,59,0,3,2014-11-27
Xavier,San Diego,82,71,0,11,2014-11-27
Washington,San Jose State,78,56,0,22,2014-11-27
Tennessee,Santa Clara,64,57,0,7,2014-11-27
Florida International,USC Upstate,53,68,1,-15,2014-11-27
UCLA,Alabama-Birmingham,88,76,0,12,2014-11-28
Texas-Rio Grande Valley,Alabama State,79,91,1,-12,2014-11-28
Missouri State,Alaska-Anchorage,55,51,0,4,2014-11-28
North Texas,Arkansas,73,89,1,-16,2014-11-28
Stephen F. Austin,Austin Peay,83,62,0,21,2014-11-28
Illinois,Baylor,62,54,0,8,2014-11-28
TCU,Bradley,57,49,0,8,2014-11-28
Prairie View,Brown,71,81,1,-10,2014-11-28
Penn State,Bucknell,88,80,0,8,2014-11-28
Georgetown,Butler,58,64,1,-6,2014-11-28
USC Upstate,Cal State Fullerton,79,64,0,15,2014-11-28
Mercer,UCSB,60,65,1,-5,2014-11-28
Middle Tennessee,Cincinnati,51,69,1,-18,2014-11-28
High Point,Clemson,59,62,1,-3,2014-11-28
Pacific,Colorado State,64,75,1,-11,2014-11-28
Ole Miss,Creighton,75,68,0,7,2014-11-28
Purdue-Fort Wayne,Dartmouth,67,68,1,-1,2014-11-28
Valparaiso,Drake,66,46,0,20,2014-11-28
North Carolina Central,Eastern Illinois,65,40,0,25,2014-11-28
UNC,Florida,75,64,0,11,2014-11-28
Wright State,Florida International,59,61,1,-2,2014-11-28
Charleston Southern,Florida State,47,58,1,-11,2014-11-28
Minnesota,Georgia,66,62,0,4,2014-11-28
Rider,Georgia Tech,54,61,1,-7,2014-11-28
St. John's (NY),Gonzaga,66,73,1,-7,2014-11-28
Emerson,Hartford,50,83,1,-33,2014-11-28
UNC Greensboro,Indiana,79,87,1,-8,2014-11-28
Memphis,Indiana State,72,62,0,10,2014-11-28
Hofstra,Jackson State,86,56,0,30,2014-11-28
Savannah State,Jacksonville State,71,74,1,-3,2014-11-28
Tennessee,Kansas,67,82,1,-15,2014-11-28
Virginia,La Salle,64,56,0,8,2014-11-28
Washington,Long Beach State,80,70,0,10,2014-11-28
Samford,Louisiana Tech,64,77,1,-13,2014-11-28
Michigan State,Marquette,79,68,0,11,2014-11-28
Cleveland State,Marshall,68,59,0,9,2014-11-28
Monmouth,Maryland,56,61,1,-5,2014-11-28
South Alabama,Miami (FL),75,87,1,-12,2014-11-28
Saint Louis,Mississippi State,50,75,1,-25,2014-11-28
Texas A&M-Corpus Christi,Mississippi Valley State,75,66,0,9,2014-11-28
Texas-Arlington,Montana State,81,104,1,-23,2014-11-28
Portland,Murray State,64,61,0,3,2014-11-28
UT-Martin,Nebraska,64,75,1,-11,2014-11-28
St. Francis (NY),Norfolk State,70,72,1,-2,2014-11-28
Radford,North Carolina A&T,65,57,0,8,2014-11-28
Boise State,NC State,54,60,1,-6,2014-11-28
Southern,Northern Arizona,63,70,1,-7,2014-11-28
Stetson,Northern Colorado,62,82,1,-20,2014-11-28
James Madison,Ohio State,56,73,1,-17,2014-11-28
Wisconsin,Oklahoma,69,56,0,13,2014-11-28
San Diego,Princeton,75,65,0,10,2014-11-28
Yale,Providence,66,72,1,-6,2014-11-28
Santa Clara,Rhode Island,44,66,1,-22,2014-11-28
Washington State,Rice,76,74,0,2,2014-11-28
Vanderbilt,Rutgers,65,68,1,-3,2014-11-28
Tennessee State,St. Peter's,58,66,1,-8,2014-11-28
Western Michigan,San Jose State,79,60,0,19,2014-11-28
Holy Cross,Syracuse,48,72,1,-24,2014-11-28
New Orleans,Texas A&M,65,87,1,-22,2014-11-28
Xavier,UTEP,73,77,1,-4,2014-11-28
Lamar,Texas Southern,59,71,1,-12,2014-11-28
Southeastern Louisiana,Tulane,61,71,1,-10,2014-11-28
North Dakota,Utah,53,90,1,-37,2014-11-28
Delaware State,Wake Forest,72,65,0,7,2014-11-28
Rice,Alaska-Anchorage,54,65,1,-11,2014-11-29
Colgate,Arizona State,71,78,1,-7,2014-11-29
Central Arkansas,Little Rock,71,85,1,-14,2014-11-29
Cornell,Binghamton,68,54,0,14,2014-11-29
Saint Louis,Bradley,60,57,0,3,2014-11-29
Eastern Kentucky,BYU,76,90,1,-14,2014-11-29
Canisius,Buffalo,57,72,1,-15,2014-11-29
Florida International,Cal State Fullerton,61,64,1,-3,2014-11-29
Utah Valley,UC-Davis,43,64,1,-21,2014-11-29
Abilene Christian,UC-Riverside,56,76,1,-20,2014-11-29
Colorado State,UCSB,65,63,0,2,2014-11-29
Grand Canyon,Central Michigan,77,79,1,-2,2014-11-29
Ole Miss,Cincinnati,66,54,0,12,2014-11-29
Warren Wilson,Citadel,45,84,1,-39,2014-11-29
American,Columbia,43,52,1,-9,2014-11-29
Middle Tennessee,Creighton,47,57,1,-10,2014-11-29
UNC Wilmington,Davidson,49,72,1,-23,2014-11-29
UIC,Dayton,41,75,1,-34,2014-11-29
Portland,Drake,71,59,0,12,2014-11-29
NJIT,Duquesne,84,81,0,3,2014-11-29
Southern,Eastern Illinois,43,54,1,-11,2014-11-29
Stetson,Florida A&M,62,50,0,12,2014-11-29
Maryland-Eastern Shore,Fordham,72,66,0,6,2014-11-29
Brevard,Gardner-Webb,63,78,1,-15,2014-11-29
Manhattan,George Mason,63,64,1,-1,2014-11-29
South Carolina State,Georgia Southern,58,71,1,-13,2014-11-29
UMass,Harvard,73,75,1,-2,2014-11-29
Dallas Christian,Houston Baptist,44,88,1,-44,2014-11-29
Gwynedd-Mercy,Howard,83,96,1,-13,2014-11-29
Northern Kentucky,Idaho,79,74,0,5,2014-11-29
Youngstown State,Illinois State,73,85,1,-12,2014-11-29
Longwood,Iowa,44,77,1,-33,2014-11-29
Georgia State,IUPUI,66,63,0,3,2014-11-29
Chattanooga,Kennesaw State,69,77,1,-8,2014-11-29
Loyola (IL),Kent State,69,61,0,8,2014-11-29
Vanderbilt,La Salle,68,55,0,13,2014-11-29
McNeese State,LSU,72,83,1,-11,2014-11-29
UC-Irvine,Loyola Marymount,80,72,0,8,2014-11-29
Siena,Loyola (MD),81,71,0,10,2014-11-29
Towson,UMBC,77,66,0,11,2014-11-29
Pacific,Mercer,55,48,0,7,2014-11-29
Nicholls State,Michigan,62,91,1,-29,2014-11-29
Concordia-St. Paul,Milwaukee,59,64,1,-5,2014-11-29
TCU,Mississippi State,61,52,0,9,2014-11-29
North Carolina A&T,Mississippi Valley State,63,66,1,-3,2014-11-29
William Jewell,UMKC,44,84,1,-40,2014-11-29
Washington State,Missouri State,89,84,0,5,2014-11-29
Kentucky Christian,Morehead State,49,121,1,-72,2014-11-29
Valparaiso,Murray State,93,58,0,35,2014-11-29
Saint Francis (PA),Navy,85,68,0,17,2014-11-29
Nevada,Omaha,54,78,1,-24,2014-11-29
Albany (NY),UNLV,59,75,1,-16,2014-11-29
St. Bonaventure,Niagara,74,59,0,15,2014-11-29
St. Peter's,Norfolk State,58,60,1,-2,2014-11-29
Northern Arizona,North Carolina Central,36,40,1,-4,2014-11-29
Texas-Rio Grande Valley,North Dakota,78,60,0,18,2014-11-29
Fairfield,Northeastern,48,57,1,-9,2014-11-29
Missouri Valley,Northwestern State,76,87,1,-11,2014-11-29
Chicago State,Notre Dame,42,90,1,-48,2014-11-29
Toledo,Oakland,79,81,1,-2,2014-11-29
Belmont,Ohio,83,81,0,2,2014-11-29
VCU,Old Dominion,67,73,1,-6,2014-11-29
Bob Jones University,Presbyterian,39,88,1,-49,2014-11-29
Texas A&M-Corpus Christi,Radford,46,57,1,-11,2014-11-29
Virginia,Rutgers,45,26,0,19,2014-11-29
Cal Poly,Saint Mary's,56,82,1,-26,2014-11-29
University of the Southwest,Sam Houston State,51,111,1,-60,2014-11-29
Cal State Northridge,Seattle,58,70,1,-12,2014-11-29
George Washington,Seton Hall,54,58,1,-4,2014-11-29
Wright State,USC Upstate,56,51,0,5,2014-11-29
Jacksonville,South Florida,65,79,1,-14,2014-11-29
Alabama A&M,Southeast Missouri State,51,85,1,-34,2014-11-29
Olivet Nazarene,Southern Illinois,60,76,1,-16,2014-11-29
Tennessee State,St. Francis (NY),57,59,1,-2,2014-11-29
St. Thomas Aquinas,Stony Brook,49,70,1,-21,2014-11-29
Alabama State,Utah,62,93,1,-31,2014-11-29
Penn,Wagner,61,64,1,-3,2014-11-29
College of Charleston,West Virginia,57,86,1,-29,2014-11-29
Greenville,Western Illinois,56,91,1,-35,2014-11-29
Tulsa,Wichita State,55,75,1,-20,2014-11-29
Wofford,William & Mary,62,66,1,-4,2014-11-29
New Mexico State,Wyoming,75,78,1,-3,2014-11-29
Bryant,Akron,66,72,1,-6,2014-11-30
Iona,Arkansas,77,94,1,-17,2014-11-30
UMass-Lowell,Boston University,69,59,0,10,2014-11-30
Johnson & Wales (RI),Brown,65,75,1,-10,2014-11-30
South Dakota,Cal State Bakersfield,68,66,0,2,2014-11-30
Bethune-Cookman,UCF,67,75,1,-8,2014-11-30
Lipscomb,Colorado,75,84,1,-9,2014-11-30
Texas,UConn,55,54,0,1,2014-11-30
New Hampshire,Dartmouth,65,63,0,2,2014-11-30
Villanova,Delaware,78,47,0,31,2014-11-30
New Orleans,Denver,60,79,1,-19,2014-11-30
Stanford,DePaul,72,87,1,-15,2014-11-30
Bowling Green State,Detroit,64,63,0,1,2014-11-30
Murray State,Drake,68,59,0,9,2014-11-30
Southern Miss,Drexel,36,59,1,-23,2014-11-30
Army,Duke,73,93,1,-20,2014-11-30
Central Connecticut,East Carolina,59,74,1,-15,2014-11-30
Eastern Oregon,Eastern Washington,87,104,1,-17,2014-11-30
Lafayette,Fairleigh Dickinson,82,61,0,21,2014-11-30
Ave Maria,Florida Atlantic,43,54,1,-11,2014-11-30
South Dakota State,Florida Gulf Coast,58,71,1,-13,2014-11-30
California,Fresno State,64,57,0,7,2014-11-30
Rhode Island,Georgia Tech,61,64,1,-3,2014-11-30
Fort Valley State,Jacksonville State,49,81,1,-32,2014-11-30
Michigan State,Kansas,56,61,1,-5,2014-11-30
Providence,Kentucky,38,58,1,-20,2014-11-30
Penn State-Mont Alto,Lehigh,74,100,1,-26,2014-11-30
Xavier,Long Beach State,70,73,1,-3,2014-11-30
Tennessee,Marquette,59,67,1,-8,2014-11-30
VMI,Maryland,77,95,1,-18,2014-11-30
Elon,Miami (OH),70,68,0,2,2014-11-30
North Dakota State,Montana State,72,51,0,21,2014-11-30
USC,New Mexico,66,54,0,12,2014-11-30
Charlotte,UNC Asheville,66,63,0,3,2014-11-30
Florida A&M,Northern Colorado,56,95,1,-39,2014-11-30
Maine,Northern Illinois,56,61,1,-5,2014-11-30
Richmond,Northern Iowa,50,55,1,-5,2014-11-30
Portland State,Oregon,59,81,1,-22,2014-11-30
Valparaiso,Portland,70,55,0,15,2014-11-30
San Jose State,Princeton,54,69,1,-15,2014-11-30
Vermont,Quinnipiac,73,89,1,-16,2014-11-30
Santa Clara,Rider,68,60,0,8,2014-11-30
Campbell,Sacred Heart,62,71,1,-9,2014-11-30
Western Michigan,San Diego,68,66,0,2,2014-11-30
Montana,San Francisco,57,76,1,-19,2014-11-30
Langston,Southeastern Louisiana,80,92,1,-12,2014-11-30
Monmouth,SMU,51,63,1,-12,2014-11-30
LIU-Brooklyn,Temple,56,70,1,-14,2014-11-30
Washington,UTEP,68,65,0,3,2014-11-30
Southern Utah,UTSA,93,92,0,1,2014-11-30
Howard Payne,Texas State,39,68,1,-29,2014-11-30
Air Force,Texas Tech,62,63,1,-1,2014-11-30
Tennessee Tech,Tulane,68,73,1,-5,2014-11-30
Morgan State,Virginia Tech,63,83,1,-20,2014-11-30
Hartford,Yale,57,69,1,-12,2014-11-30
Texas Southern,Baylor,49,75,1,-26,2014-12-01
Marist,Boston College,61,79,1,-18,2014-12-01
Arkansas State,Central Arkansas,67,49,0,18,2014-12-01
Western Carolina,Charleston Southern,66,72,1,-6,2014-12-01
Rutgers,Clemson,69,64,0,5,2014-12-01
Goldey-Beacom,Coppin State,50,103,1,-53,2014-12-01
Aquinas,Detroit,59,109,1,-50,2014-12-01
Marygrove,Eastern Michigan,52,83,1,-31,2014-12-01
Bucknell,Fairfield,72,66,0,6,2014-12-01
Nebraska,Florida State,70,65,0,5,2014-12-01
Siena,Fordham,67,69,1,-2,2014-12-01
Minnesota-Duluth,Green Bay,52,78,1,-26,2014-12-01
Furman,Liberty,52,66,1,-14,2014-12-01
South Carolina,Marshall,77,59,0,18,2014-12-01
ETSU,Morehead State,63,59,0,4,2014-12-01
High Point,UNC Greensboro,76,68,0,8,2014-12-01
Edward Waters,North Florida,65,97,1,-32,2014-12-01
Seattle,Pacific Lutheran,72,33,0,39,2014-12-01
Utah Valley,Sacramento State,56,65,1,-9,2014-12-01
Jacksonville,Samford,70,76,1,-6,2014-12-01
Barber-Scotia,USC Upstate,43,105,1,-62,2014-12-01
Oral Roberts,Weber State,61,62,1,-1,2014-12-01
Savannah State,Winthrop,47,68,1,-21,2014-12-01
Arkansas-Pine Bluff,Akron,60,81,1,-21,2014-12-02
South Florida,Alabama,71,82,1,-11,2014-12-02
Gardner-Webb,Arizona,65,91,1,-26,2014-12-02
Middle Tennessee,Belmont,59,63,1,-4,2014-12-02
Central Michigan,Bradley,73,84,1,-11,2014-12-02
UC-Riverside,Cal State Bakersfield,59,58,0,1,2014-12-02
South Dakota,Cal State Northridge,68,65,0,3,2014-12-02
Georgia Southern,UCF,59,61,1,-2,2014-12-02
Georgia,Chattanooga,86,55,0,31,2014-12-02
Stony Brook,Cincinnati,52,78,1,-26,2014-12-02
South Carolina State,Coastal Carolina,52,66,1,-14,2014-12-02
Citadel,College of Charleston,55,59,1,-4,2014-12-02
Loyola (MD),Columbia,64,62,0,2,2014-12-02
Northern Illinois,DePaul,67,78,1,-11,2014-12-02
Howard,Duquesne,63,81,1,-18,2014-12-02
Virginia-Lynchburg,Elon,55,111,1,-56,2014-12-02
Wright State,Evansville,78,86,1,-8,2014-12-02
Kennesaw State,Florida International,38,59,1,-21,2014-12-02
Southeastern Louisiana,Gonzaga,57,76,1,-19,2014-12-02
Delaware State,Hawaii,60,75,1,-15,2014-12-02
Norfolk State,Hofstra,74,88,1,-14,2014-12-02
Montana Western,Idaho State,66,86,1,-20,2014-12-02
Grand Canyon,UIC,66,61,0,5,2014-12-02
VCU,Illinois State,66,62,0,4,2014-12-02
Pitt,Indiana,69,81,1,-12,2014-12-02
Lamar,Iowa State,59,96,1,-37,2014-12-02
Campbell,James Madison,61,63,1,-2,2014-12-02
Omaha,Kansas State,66,84,1,-18,2014-12-02
UMass,LSU,60,82,1,-22,2014-12-02
Ohio State,Louisville,55,64,1,-9,2014-12-02
Wagner,Maine,81,82,1,-1,2014-12-02
UMBC,Maryland-Eastern Shore,52,65,1,-13,2014-12-02
Stephen F. Austin,Memphis,64,52,0,12,2014-12-02
St. Andrews,Mercer,33,62,1,-29,2014-12-02
Illinois,Miami (FL),61,70,1,-9,2014-12-02
Syracuse,Michigan,65,68,1,-3,2014-12-02
Southeast Missouri State,Missouri,61,65,1,-4,2014-12-02
Johnson & Wales (NC),North Carolina Central,38,101,1,-63,2014-12-02
Louisiana Tech,Northwestern State,99,88,0,11,2014-12-02
NC State,Purdue,61,66,1,-5,2014-12-02
Youngstown State,Robert Morris,89,81,0,8,2014-12-02
Rockhurst,Saint Louis,48,80,1,-32,2014-12-02
Mount St. Mary's,Seton Hall,55,78,1,-23,2014-12-02
Spring Hill,South Alabama,54,71,1,-17,2014-12-02
Niagara,St. John's (NY),57,70,1,-13,2014-12-02
Hampton,Tennessee State,62,54,0,8,2014-12-02
Texas-Arlington,Texas,53,63,1,-10,2014-12-02
Alcorn State,Troy,51,72,1,-21,2014-12-02
BYU,Utah State,91,81,0,10,2014-12-02
Mid-Atlantic Christian,VMI,62,133,1,-71,2014-12-02
Minnesota,Wake Forest,84,69,0,15,2014-12-02
Denver,Wyoming,42,68,1,-26,2014-12-02
Grambling,Air Force,34,59,1,-25,2014-12-03
Holy Cross,Albany (NY),74,57,0,17,2014-12-03
UNLV,Arizona State,55,77,1,-22,2014-12-03
North Florida,Bethune-Cookman,63,56,0,7,2014-12-03
Binghamton,Boston University,65,77,1,-12,2014-12-03
American,Brown,66,49,0,17,2014-12-03
Yale,Bryant,67,60,0,7,2014-12-03
Montana,California,76,78,1,-2,2014-12-03
San Jose State,UC-Davis,56,70,1,-14,2014-12-03
Toledo,Cleveland State,59,54,0,5,2014-12-03
Sacred Heart,Colgate,71,70,0,1,2014-12-03
San Francisco,Colorado,55,72,1,-17,2014-12-03
UTEP,Colorado State,62,65,1,-3,2014-12-03
Charlotte,Davidson,86,92,1,-6,2014-12-03
Army,Delaware,73,69,0,4,2014-12-03
Western Carolina,ETSU,89,96,1,-7,2014-12-03
Ball State,Eastern Illinois,54,61,1,-7,2014-12-03
Valparaiso,Eastern Kentucky,72,66,0,6,2014-12-03
Princeton,Fairleigh Dickinson,85,89,1,-4,2014-12-03
East Carolina,Florida Atlantic,63,72,1,-9,2014-12-03
Florida Tech,Florida Gulf Coast,58,77,1,-19,2014-12-03
UC-Irvine,Fresno State,63,72,1,-9,2014-12-03
Old Dominion,George Mason,75,69,0,6,2014-12-03
Northeastern,Harvard,46,60,1,-14,2014-12-03
Butler,Indiana State,77,54,0,23,2014-12-03
Winthrop,Jacksonville State,76,79,1,-3,2014-12-03
Villanova,La Salle,84,70,0,14,2014-12-03
Saint Francis (PA),Lehigh,59,61,1,-2,2014-12-03
Nevada,Long Beach State,57,68,1,-11,2014-12-03
New Hampshire,LIU-Brooklyn,72,56,0,16,2014-12-03
Dartmouth,Longwood,73,74,1,-1,2014-12-03
Jackson State,Louisiana,53,76,1,-23,2014-12-03
Tulane,Loyola (IL),83,70,0,13,2014-12-03
Virginia,Maryland,76,65,0,11,2014-12-03
NJIT,UMass-Lowell,67,71,1,-4,2014-12-03
Southern-New Orleans,McNeese State,63,74,1,-11,2014-12-03
Dayton,Miami (OH),66,62,0,4,2014-12-03
UMKC,Milwaukee,56,65,1,-9,2014-12-03
South Dakota School of Mines,Montana State,41,79,1,-38,2014-12-03
Bethel (TN),Murray State,66,102,1,-36,2014-12-03
Penn,Navy,57,46,0,11,2014-12-03
New Mexico State,New Mexico,47,62,1,-15,2014-12-03
Iowa,UNC,60,55,0,5,2014-12-03
St. Andrews,UNC Wilmington,47,105,1,-58,2014-12-03
UTSA,Northern Arizona,88,83,0,5,2014-12-03
UT-Martin,Northern Kentucky,71,56,0,15,2014-12-03
Georgia Tech,Northwestern,66,58,0,8,2014-12-03
Michigan State,Notre Dame,78,79,1,-1,2014-12-03
Rochester (MI),Oakland,52,84,1,-32,2014-12-03
North Texas,Oklahoma State,61,87,1,-26,2014-12-03
Concordia (OR),Oregon,63,94,1,-31,2014-12-03
Mississippi Valley State,Oregon State,50,74,1,-24,2014-12-03
Cal State East Bay,Pacific,51,80,1,-29,2014-12-03
Virginia Tech,Penn State,58,61,1,-3,2014-12-03
Portland State,Portland,71,83,1,-12,2014-12-03
Schreiner,Prairie View,48,64,1,-16,2014-12-03
Houston Baptist,Rice,58,55,0,3,2014-12-03
William & Mary,Richmond,67,68,1,-1,2014-12-03
Central Connecticut,Rider,56,69,1,-13,2014-12-03
Temple,St. Joseph's,56,58,1,-2,2014-12-03
Canisius,St. Peter's,60,57,0,3,2014-12-03
Wayne State (NE),South Dakota State,55,89,1,-34,2014-12-03
Loyola Marymount,USC,61,77,1,-16,2014-12-03
Southern Illinois,SIU-Edwardsville,79,67,0,12,2014-12-03
North Dakota State,Southern Miss,65,78,1,-13,2014-12-03
Buffalo,St. Bonaventure,63,72,1,-9,2014-12-03
Purdue-Fort Wayne,Stetson,87,76,0,11,2014-12-03
Lipscomb,Tennessee Tech,79,84,1,-5,2014-12-03
Sam Houston State,Texas A&M,63,66,1,-3,2014-12-03
Texas Lutheran,Texas State,31,72,1,-41,2014-12-03
Auburn,Texas Tech,44,46,1,-2,2014-12-03
Coppin State,Towson,76,84,1,-8,2014-12-03
Creighton,Tulsa,64,77,1,-13,2014-12-03
Cal State Fullerton,UCLA,45,73,1,-28,2014-12-03
Wichita State,Utah,68,69,1,-1,2014-12-03
Hartford,Vermont,69,81,1,-12,2014-12-03
Idaho,Washington State,77,71,0,6,2014-12-03
Bowling Green State,Western Kentucky,52,62,1,-10,2014-12-03
Duke,Wisconsin,80,70,0,10,2014-12-03
Presbyterian,Wofford,45,66,1,-21,2014-12-03
Sacramento State,Abilene Christian,61,72,1,-11,2014-12-04
Western Illinois,Akron,49,73,1,-24,2014-12-04
Morehead State,Alabama-Birmingham,48,58,1,-10,2014-12-04
Seattle,UCSB,46,87,1,-41,2014-12-04
Columbia International,Charleston Southern,55,105,1,-50,2014-12-04
DePaul,Chicago State,84,60,0,24,2014-12-04
University of the Sciences (Pa.),Drexel,54,52,0,2,2014-12-04
UMBC,George Washington,60,83,1,-23,2014-12-04
Green Bay,Georgia State,48,72,1,-24,2014-12-04
Texas-Rio Grande Valley,Houston,58,72,1,-14,2014-12-04
St. Edward's,Incarnate Word,68,85,1,-17,2014-12-04
Arkansas,Iowa State,77,95,1,-18,2014-12-04
Appalachian State,Jacksonville,67,56,0,11,2014-12-04
Monmouth,Marist,57,50,0,7,2014-12-04
TCU,Ole Miss,66,54,0,12,2014-12-04
Little Rock,Missouri State,68,73,1,-5,2014-12-04
Cal State Northridge,Pepperdine,56,66,1,-10,2014-12-04
VMI,Samford,88,66,0,22,2014-12-04
San Diego,San Diego State,48,57,1,-9,2014-12-04
Middle Georgia State,Savannah State,62,75,1,-13,2014-12-04
North Carolina A&T,USC Upstate,54,65,1,-11,2014-12-04
Baylor,Vanderbilt,66,63,0,3,2014-12-04
LSU,West Virginia,74,73,0,1,2014-12-04
Coastal Carolina,Auburn,58,54,0,4,2014-12-05
Providence,Boston College,60,69,1,-9,2014-12-05
Yale,UConn,45,44,0,1,2014-12-05
Pitt,Duquesne,76,62,0,14,2014-12-05
Manhattan,Fairfield,54,67,1,-13,2014-12-05
Toccoa Falls,Gardner-Webb,61,100,1,-39,2014-12-05
Florida,Kansas,65,71,1,-6,2014-12-05
Texas,Kentucky,51,63,1,-12,2014-12-05
Florida International,Louisville,57,82,1,-25,2014-12-05
North Carolina Central,Maryland-Eastern Shore,68,63,0,5,2014-12-05
Western Carolina,Minnesota,64,84,1,-20,2014-12-05
St. Katherine,UNLV,53,113,1,-60,2014-12-05
Missouri,Oklahoma,63,82,1,-19,2014-12-05
Quinnipiac,Siena,67,88,1,-21,2014-12-05
Youngstown State,South Dakota,87,79,0,8,2014-12-05
Dillard,Southern,55,68,1,-13,2014-12-05
Wyoming,SMU,53,66,1,-13,2014-12-05
Long Beach State,Stephen F. Austin,45,74,1,-29,2014-12-05
Jacksonville State,Alabama State,55,80,1,-25,2014-12-06
Gonzaga,Arizona,63,66,1,-3,2014-12-06
Belhaven (MS),Arkansas State,68,95,1,-27,2014-12-06
Indiana State,Ball State,63,70,1,-7,2014-12-06
Jacksonville,Bethune-Cookman,47,52,1,-5,2014-12-06
Penn,Binghamton,79,70,0,9,2014-12-06
St. Peter's,Boston University,70,59,0,11,2014-12-06
Alabama A&M,Bowling Green State,47,64,1,-17,2014-12-06
Hawaii,BYU,70,90,1,-20,2014-12-06
Bryant,Brown,62,69,1,-7,2014-12-06
Northwestern,Butler,56,65,1,-9,2014-12-06
Menlo,Cal Poly,35,72,1,-37,2014-12-06
Fresno State,Cal State Bakersfield,63,61,0,2,2014-12-06
Pepperdine,Cal State Fullerton,74,62,0,12,2014-12-06
Vanguard,Cal State Northridge,58,70,1,-12,2014-12-06
Sacramento State,UC-Irvine,62,74,1,-12,2014-12-06
Portland State,UC-Riverside,62,88,1,-26,2014-12-06
SIU-Edwardsville,Central Michigan,61,94,1,-33,2014-12-06
Navy,Citadel,60,67,1,-7,2014-12-06
Bucknell,Columbia,39,62,1,-23,2014-12-06
UMass-Lowell,Cornell,60,71,1,-11,2014-12-06
Maine,Dartmouth,51,74,1,-23,2014-12-06
Stetson,Davidson,59,90,1,-31,2014-12-06
Eastern Michigan,Dayton,64,73,1,-9,2014-12-06
South Florida,Detroit,57,67,1,-10,2014-12-06
North Dakota,Drake,63,62,0,1,2014-12-06
IUPUI,Evansville,62,89,1,-27,2014-12-06
UCF,Florida State,73,96,1,-23,2014-12-06
Samford,Furman,64,74,1,-10,2014-12-06
Thomas University,Gardner-Webb,66,82,1,-16,2014-12-06
USC Upstate,Georgia Tech,59,54,0,5,2014-12-06
Selma University,Grambling,64,74,1,-10,2014-12-06
Great Falls,Grand Canyon,61,80,1,-19,2014-12-06
Coppin State,Hampton,52,71,1,-19,2014-12-06
Central Connecticut,Hartford,56,47,0,9,2014-12-06
William & Mary,High Point,63,66,1,-3,2014-12-06
Abilene Christian,Houston,59,71,1,-12,2014-12-06
North Carolina A&T,Howard,47,54,1,-7,2014-12-06
UC-Davis,Idaho,71,79,1,-8,2014-12-06
Pacific,Idaho State,68,62,0,6,2014-12-06
American,Illinois,55,70,1,-15,2014-12-06
Loyola (IL),UIC,77,67,0,10,2014-12-06
Savannah State,Indiana,49,95,1,-46,2014-12-06
UMBC,Iowa,47,77,1,-30,2014-12-06
Miami (OH),Purdue-Fort Wayne,78,86,1,-8,2014-12-06
Kent State,Kennesaw State,58,46,0,12,2014-12-06
Temple,La Salle,58,57,0,1,2014-12-06
Wagner,Lafayette,84,97,1,-13,2014-12-06
St. Francis (NY),Liberty,65,54,0,11,2014-12-06
Tennessee State,Lipscomb,68,77,1,-9,2014-12-06
Lehigh,LIU-Brooklyn,80,76,0,4,2014-12-06
UT-Martin,Longwood,77,67,0,10,2014-12-06
Louisiana College,Louisiana-Monroe,55,83,1,-28,2014-12-06
Jackson State,Louisiana Tech,52,65,1,-13,2014-12-06
Mount St. Mary's,Loyola (MD),74,65,0,9,2014-12-06
Wisconsin,Marquette,49,38,0,11,2014-12-06
Penn State,Marshall,73,69,0,4,2014-12-06
Winthrop,Maryland,62,82,1,-20,2014-12-06
Louisiana,McNeese State,70,80,1,-10,2014-12-06
Bradley,Memphis,45,73,1,-28,2014-12-06
VMI,Mercer,81,90,1,-9,2014-12-06
Green Bay,Miami (FL),68,55,0,13,2014-12-06
NJIT,Michigan,72,70,0,2,2014-12-06
Arkansas-Pine Bluff,Michigan State,52,85,1,-33,2014-12-06
Utah Valley,Montana State,60,68,1,-8,2014-12-06
Oakland,Morehead State,70,68,0,2,2014-12-06
Western Kentucky,Murray State,81,93,1,-12,2014-12-06
Wheelock,New Hampshire,45,96,1,-51,2014-12-06
UTEP,New Mexico State,64,71,1,-7,2014-12-06
Crowley's Ridge,New Orleans,85,100,1,-15,2014-12-06
Canisius,Niagara,77,64,0,13,2014-12-06
Loyola (LA),Nicholls State,60,89,1,-29,2014-12-06
Morgan State,Norfolk State,65,85,1,-20,2014-12-06
Wake Forest,NC State,65,78,1,-13,2014-12-06
Western Michigan,Northeastern,69,81,1,-12,2014-12-06
George Mason,Northern Iowa,65,71,1,-6,2014-12-06
Fairleigh Dickinson,Notre Dame,57,75,1,-18,2014-12-06
St. Bonaventure,Ohio,80,70,0,10,2014-12-06
Colgate,Ohio State,50,70,1,-20,2014-12-06
Oregon State,Portland,65,58,0,7,2014-12-06
UNC Greensboro,Presbyterian,55,53,0,2,2014-12-06
Stony Brook,Princeton,64,77,1,-13,2014-12-06
North Florida,Purdue,73,70,0,3,2014-12-06
St. Edward's,Rice,49,54,1,-5,2014-12-06
Holy Cross,Sacred Heart,68,81,1,-13,2014-12-06
Albany (NY),Saint Francis (PA),59,69,1,-10,2014-12-06
Boise State,Saint Mary's,82,71,0,11,2014-12-06
Texas-Rio Grande Valley,Sam Houston State,59,78,1,-19,2014-12-06
Santa Clara,San Jose State,61,50,0,11,2014-12-06
Eastern Washington,Seattle,87,75,0,12,2014-12-06
Rutgers,Seton Hall,54,81,1,-27,2014-12-06
Middle Tennessee,South Alabama,68,67,0,1,2014-12-06
Oklahoma State,South Carolina,49,75,1,-26,2014-12-06
Florida A&M,South Carolina State,61,70,1,-9,2014-12-06
UMKC,South Dakota State,61,81,1,-20,2014-12-06
Southeastern Louisiana,Southeast Missouri State,59,63,1,-4,2014-12-06
Austin Peay,Southern Illinois,49,71,1,-22,2014-12-06
Rhode Island,Southern Miss,75,43,0,32,2014-12-06
St. Katherine,Southern Utah,45,92,1,-47,2014-12-06
St. John's (NY),Syracuse,69,57,0,12,2014-12-06
Kansas State,Tennessee,64,65,1,-1,2014-12-06
Arizona State,Texas A&M,71,72,1,-1,2014-12-06
Denver,Texas A&M-Corpus Christi,64,48,0,16,2014-12-06
Weber State,Texas-Arlington,56,63,1,-7,2014-12-06
Prairie View,Texas State,65,81,1,-16,2014-12-06
Chicago State,Toledo,59,87,1,-28,2014-12-06
Central Arkansas,Troy,73,85,1,-12,2014-12-06
Mississippi State,Tulane,54,59,1,-5,2014-12-06
New Mexico,Valparaiso,63,46,0,17,2014-12-06
Harvard,Vermont,64,52,0,12,2014-12-06
St. Joseph's,Villanova,46,74,1,-28,2014-12-06
Virginia,VCU,74,57,0,17,2014-12-06
UTSA,Washington State,71,91,1,-20,2014-12-06
Saint Louis,Wichita State,52,81,1,-29,2014-12-06
Florida National University,Wofford,57,88,1,-31,2014-12-06
Alabama,Xavier,84,97,1,-13,2014-12-06
Illinois State,Alabama-Birmingham,78,74,0,4,2014-12-07
Hofstra,Appalachian State,68,51,0,17,2014-12-07
Tulsa,Little Rock,78,73,0,5,2014-12-07
George Washington,Charlotte,78,70,0,8,2014-12-07
Arkansas,Clemson,65,68,1,-3,2014-12-07
Western Illinois,Cleveland State,54,76,1,-22,2014-12-07
Northern Colorado,Colorado State,58,66,1,-8,2014-12-07
Delaware State,Delaware,66,53,0,13,2014-12-07
Milwaukee,DePaul,61,83,1,-22,2014-12-07
Central Pennsylvania College,Elon,73,117,1,-44,2014-12-07
Towson,Georgetown,46,78,1,-32,2014-12-07
Colorado,Georgia,57,64,1,-7,2014-12-07
North Carolina Central,Howard,61,39,0,22,2014-12-07
Richmond,James Madison,46,51,1,-5,2014-12-07
Eastern Kentucky,Kentucky,49,82,1,-33,2014-12-07
Marist,Manhattan,38,60,1,-22,2014-12-07
Florida Gulf Coast,UMass,84,75,0,9,2014-12-07
Iona,Monmouth,89,92,1,-3,2014-12-07
North Dakota State,Montana,57,69,1,-12,2014-12-07
Creighton,Nebraska,65,55,0,10,2014-12-07
California,Nevada,63,56,0,7,2014-12-07
East Carolina,UNC,64,108,1,-44,2014-12-07
Limestone,UNC Asheville,66,91,1,-25,2014-12-07
West Virginia,Northern Kentucky,67,42,0,25,2014-12-07
Ole Miss,Oregon,79,73,0,6,2014-12-07
Fairfield,Quinnipiac,56,52,0,4,2014-12-07
Siena,Rider,68,80,1,-12,2014-12-07
Buffalo,Robert Morris,74,59,0,15,2014-12-07
Houston Baptist,San Francisco,54,85,1,-31,2014-12-07
Utah State,USC,84,89,1,-5,2014-12-07
Ouachita,Stephen F. Austin,60,84,1,-24,2014-12-07
Hiwassee,Tennessee Tech,48,87,1,-39,2014-12-07
San Diego,UCLA,68,75,1,-7,2014-12-07
Radford,Virginia Tech,68,66,0,2,2014-12-07
San Diego State,Washington,36,49,1,-13,2014-12-07
Urbana,Wright State,58,81,1,-23,2014-12-07
Regis,Wyoming,35,70,1,-35,2014-12-07
Thiel,Youngstown State,45,70,1,-25,2014-12-07
Omaha,Air Force,61,77,1,-16,2014-12-08
Caldwell,Binghamton,63,52,0,11,2014-12-08
Albany (NY),Bucknell,58,61,1,-3,2014-12-08
Kennesaw State,Butler,51,93,1,-42,2014-12-08
Johnson & Wales (NC),Campbell,38,63,1,-25,2014-12-08
Montreat,Chattanooga,50,104,1,-54,2014-12-08
Yale,Florida,47,85,1,-38,2014-12-08
Morgan State,Hampton,58,62,1,-4,2014-12-08
Boston University,Harvard,56,70,1,-14,2014-12-08
Sacred Heart,Lafayette,81,82,1,-1,2014-12-08
North Carolina A&T,Maryland-Eastern Shore,58,69,1,-11,2014-12-08
Savannah State,Miami (FL),39,70,1,-31,2014-12-08
North Dakota,Minnesota,56,92,1,-36,2014-12-08
Coppin State,Norfolk State,69,88,1,-19,2014-12-08
Brown,Providence,77,67,0,10,2014-12-08
Purdue-Fort Wayne,Purdue,43,63,1,-20,2014-12-08
Bethune-Cookman,South Carolina State,66,71,1,-5,2014-12-08
UCSB,SMU,73,80,1,-7,2014-12-08
Incarnate Word,UTEP,65,81,1,-16,2014-12-08
Utah Valley,Arizona,56,87,1,-31,2014-12-09
Bryant,Army,80,73,0,7,2014-12-09
Texas A&M,Baylor,63,77,1,-14,2014-12-09
Evansville,Belmont,65,62,0,3,2014-12-09
Adams State,Boise State,49,78,1,-29,2014-12-09
Eastern Illinois,UC-Davis,70,80,1,-10,2014-12-09
Morrisville State,Colgate,52,88,1,-36,2014-12-09
South Dakota,Creighton,88,91,1,-3,2014-12-09
Bowling Green State,Dayton,52,56,1,-4,2014-12-09
Idaho State,Grand Canyon,67,51,0,16,2014-12-09
Hartford,Holy Cross,79,61,0,18,2014-12-09
Villanova,Illinois,73,59,0,14,2014-12-09
Louisville,Indiana,94,74,0,20,2014-12-09
Alcorn State,Iowa,44,67,1,-23,2014-12-09
UMKC,Iowa State,56,73,1,-17,2014-12-09
Bradley,Kansas State,47,50,1,-3,2014-12-09
Northwestern State,Louisiana-Monroe,74,82,1,-8,2014-12-09
LIU-Brooklyn,Maine,83,70,0,13,2014-12-09
Eastern Michigan,Michigan,45,42,0,3,2014-12-09
VMI,Navy,66,84,1,-18,2014-12-09
St. Francis (NY),NJIT,66,68,1,-2,2014-12-09
Mount St. Mary's,Notre Dame,67,93,1,-26,2014-12-09
Marist,Penn,42,59,1,-17,2014-12-09
New Hampshire,Rutgers,56,60,1,-4,2014-12-09
Loyola (MD),St. Joseph's,42,68,1,-26,2014-12-09
South Dakota State,Saint Louis,62,55,0,7,2014-12-09
St. Katherine,San Jose State,63,74,1,-11,2014-12-09
Furman,TCU,69,80,1,-11,2014-12-09
Seton Hall,Wichita State,68,77,1,-9,2014-12-09
Mars Hill,Winthrop,51,96,1,-45,2014-12-09
IUPUI,Xavier,43,66,1,-23,2014-12-09
Utah,BYU,65,61,0,4,2014-12-10
Wyoming,California,42,45,1,-3,2014-12-10
UMBC,Central Connecticut,53,65,1,-12,2014-12-10
Colorado State,Colorado,62,60,0,2,2014-12-10
Hofstra,Coppin State,105,64,0,41,2014-12-10
Campbell,Delaware State,70,55,0,15,2014-12-10
Northern Iowa,Denver,65,55,0,10,2014-12-10
Monmouth,Fordham,58,68,1,-10,2014-12-10
Kansas,Georgetown,75,70,0,5,2014-12-10
Washington State,Gonzaga,66,81,1,-15,2014-12-10
Rider,Iona,64,77,1,-13,2014-12-10
Columbia,Kentucky,46,56,1,-10,2014-12-10
Louisiana Tech,Louisiana,86,94,1,-8,2014-12-10
North Carolina Central,Maryland,56,67,1,-11,2014-12-10
Dartmouth,UMass-Lowell,69,48,0,21,2014-12-10
Wisconsin,Milwaukee,93,54,0,39,2014-12-10
Southern,Minnesota,57,85,1,-28,2014-12-10
Davidson,Montana,110,99,0,11,2014-12-10
Incarnate Word,Nebraska,74,73,0,1,2014-12-10
Iowa Wesleyan,Omaha,67,94,1,-27,2014-12-10
Greensboro,UNC Greensboro,78,82,1,-4,2014-12-10
High Point,Ohio State,43,97,1,-54,2014-12-10
Duquesne,Penn State,62,64,1,-2,2014-12-10
Rhode Island,Providence,60,68,1,-8,2014-12-10
Arkansas State,Purdue,46,87,1,-41,2014-12-10
Princeton,St. Peter's,46,60,1,-14,2014-12-10
Long Beach State,San Diego State,59,60,1,-1,2014-12-10
Southern Illinois,Southeast Missouri State,54,55,1,-1,2014-12-10
Fairleigh Dickinson,St. John's (NY),52,74,1,-22,2014-12-10
Towson,Temple,64,76,1,-12,2014-12-10
Fresno State,Texas Tech,56,73,1,-17,2014-12-10
SE Oklahoma St.,Tulsa,69,66,0,3,2014-12-10
UC-Riverside,UCLA,66,77,1,-11,2014-12-10
Trinity International (IL),Valparaiso,54,79,1,-25,2014-12-10
Wright State,Belmont,79,71,0,8,2014-12-11
Northwest Nazarene,Boise State,51,91,1,-40,2014-12-11
Maine,Boston College,74,85,1,-11,2014-12-11
San Diego,UCSB,79,65,0,14,2014-12-11
Chattanooga,Citadel,67,48,0,19,2014-12-11
Warren Wilson,Coastal Carolina,40,85,1,-45,2014-12-11
Binghamton,Colgate,44,65,1,-21,2014-12-11
South Carolina State,College of Charleston,47,50,1,-3,2014-12-11
Troy,Fort Valley State,80,63,0,17,2014-12-11
DePaul,George Washington,68,81,1,-13,2014-12-11
UCF,UIC,60,71,1,-11,2014-12-11
Michigan-Dearborn,Purdue-Fort Wayne,67,91,1,-24,2014-12-11
Elon,Missouri,73,78,1,-5,2014-12-11
Tusculum,UNC Asheville,40,78,1,-38,2014-12-11
Cal State Fullerton,Sacramento State,59,73,1,-14,2014-12-11
Eastern Washington,San Francisco,81,76,0,5,2014-12-11
Idaho,Western Illinois,75,78,1,-3,2014-12-11
Texas Southern,Florida,50,75,1,-25,2014-12-12
NJIT,Holy Cross,66,76,1,-10,2014-12-12
Iowa State,Iowa,90,75,0,15,2014-12-12
Charleston Southern,NC State,50,86,1,-36,2014-12-12
Northern New Mexico,Abilene Christian,48,76,1,-28,2014-12-13
Arkansas-Pine Bluff,Air Force,47,80,1,-33,2014-12-13
Middle Tennessee,Akron,62,61,0,1,2014-12-13
Tennessee Tech,Alabama,53,65,1,-12,2014-12-13
Michigan,Arizona,53,80,1,-27,2014-12-13
Pepperdine,Arizona State,74,81,1,-7,2014-12-13
Dayton,Arkansas,55,69,1,-14,2014-12-13
Lipscomb,Austin Peay,68,59,0,9,2014-12-13
Cleveland State,Bowling Green State,57,67,1,-10,2014-12-13
Princeton,California,57,67,1,-10,2014-12-13
Texas-Arlington,UC-Irvine,70,62,0,8,2014-12-13
Florida Atlantic,UCF,54,41,0,13,2014-12-13
Northern Colorado,Colorado,68,93,1,-25,2014-12-13
Arkansas-Fort Smith,Colorado State,60,88,1,-28,2014-12-13
Saint Mary's,Creighton,71,67,0,4,2014-12-13
Niagara,Davidson,58,78,1,-20,2014-12-13
Wichita State,Detroit,77,68,0,9,2014-12-13
La Salle,Drexel,65,55,0,10,2014-12-13
James Madison,East Carolina,58,70,1,-12,2014-12-13
UNC Greensboro,ETSU,80,79,0,1,2014-12-13
Northern Illinois,Eastern Illinois,55,59,1,-4,2014-12-13
Murray State,Evansville,81,79,0,2,2014-12-13
Cal Poly,Fresno State,57,63,1,-6,2014-12-13
Furman,Gardner-Webb,68,74,1,-6,2014-12-13
Radford,Georgetown,49,76,1,-27,2014-12-13
Drake,Green Bay,48,64,1,-16,2014-12-13
Rider,Hartford,63,61,0,2,2014-12-13
Arlington Baptist,Houston Baptist,84,99,1,-15,2014-12-13
Northwest Nazarene,Idaho State,57,69,1,-12,2014-12-13
Oregon,Illinois,77,70,0,7,2014-12-13
Grand Canyon,Indiana,66,94,1,-28,2014-12-13
Indiana State,Iona,84,91,1,-7,2014-12-13
Eastern Kentucky,IUPUI,73,64,0,9,2014-12-13
Utah,Kansas,60,63,1,-3,2014-12-13
UNC,Kentucky,70,84,1,-14,2014-12-13
Bluefield (WV),Liberty,61,79,1,-18,2014-12-13
Centenary (LA),Louisiana,59,115,1,-56,2014-12-13
Sam Houston State,LSU,67,76,1,-9,2014-12-13
Jackson State,Loyola (IL),46,58,1,-12,2014-12-13
USC Upstate,Maryland,57,67,1,-10,2014-12-13
Navy,Maryland-Eastern Shore,46,53,1,-7,2014-12-13
Canisius,UMass,58,75,1,-17,2014-12-13
Oklahoma State,Memphis,73,55,0,18,2014-12-13
Western Kentucky,Ole Miss,81,74,0,7,2014-12-13
Xavier,Missouri,74,58,0,16,2014-12-13
Omaha,UMKC,72,79,1,-7,2014-12-13
Norfolk State,Mount St. Mary's,64,67,1,-3,2014-12-13
Cincinnati,Nebraska,55,56,1,-1,2014-12-13
Cal State Fullerton,Nevada,65,55,0,10,2014-12-13
Louisiana-Monroe,New Mexico,46,54,1,-8,2014-12-13
North Dakota,North Dakota State,42,71,1,-29,2014-12-13
Loyola Marymount,Northern Arizona,69,71,1,-2,2014-12-13
Florida State,Notre Dame,63,83,1,-20,2014-12-13
Alcorn State,Ohio,55,66,1,-11,2014-12-13
Morehead State,Ohio State,71,87,1,-16,2014-12-13
New Mexico State,Oral Roberts,83,86,1,-3,2014-12-13
Mississippi State,Oregon State,49,59,1,-10,2014-12-13
St. Bonaventure,Pitt,54,58,1,-4,2014-12-13
Cal State Bakersfield,Portland State,59,65,1,-6,2014-12-13
Montreat,Presbyterian,68,79,1,-11,2014-12-13
Stony Brook,Providence,61,79,1,-18,2014-12-13
Delaware State,Rhode Island,44,83,1,-39,2014-12-13
Howard,Richmond,41,54,1,-13,2014-12-13
Duquesne,Robert Morris,59,75,1,-16,2014-12-13
SIU-Edwardsville,Saint Louis,61,67,1,-6,2014-12-13
New Orleans,San Diego,60,85,1,-25,2014-12-13
Seattle,San Jose State,54,38,0,16,2014-12-13
Washington State,Santa Clara,67,76,1,-9,2014-12-13
Albany (NY),Siena,77,68,0,9,2014-12-13
UNLV,South Dakota,75,61,0,14,2014-12-13
Idaho,South Dakota State,85,87,1,-2,2014-12-13
Missouri State,Southeast Missouri State,73,61,0,12,2014-12-13
Army,USC,85,77,0,8,2014-12-13
Spring Hill,Southern Miss,56,66,1,-10,2014-12-13
Mount Saint Vincent,St. Francis (NY),72,90,1,-18,2014-12-13
Denver,Stanford,43,49,1,-6,2014-12-13
Texas State,Texas,27,59,1,-32,2014-12-13
Youngstown State,Texas A&M,63,81,1,-18,2014-12-13
McNeese State,TCU,50,68,1,-18,2014-12-13
Lamar,Texas-Rio Grande Valley,60,66,1,-6,2014-12-13
Arkansas State,Toledo,65,73,1,-8,2014-12-13
Oklahoma,Tulsa,87,68,0,19,2014-12-13
Gonzaga,UCLA,87,74,0,13,2014-12-13
Utah State,Utah Valley,50,47,0,3,2014-12-13
Ball State,Valparaiso,62,65,1,-3,2014-12-13
Purdue,Vanderbilt,71,81,1,-10,2014-12-13
Northern Iowa,VCU,87,93,1,-6,2014-12-13
Marist,VMI,77,92,1,-15,2014-12-13
BYU,Weber State,76,60,0,16,2014-12-13
Alabama State,Western Illinois,68,78,1,-10,2014-12-13
Nicholls State,Wisconsin,43,86,1,-43,2014-12-13
UNC Asheville,Alabama-Birmingham,71,79,1,-8,2014-12-14
Kent State,Little Rock,60,55,0,5,2014-12-14
Southern Utah,Boise State,60,79,1,-19,2014-12-14
Binghamton,Boston College,49,63,1,-14,2014-12-14
Quinnipiac,Boston University,68,71,1,-3,2014-12-14
Auburn,Clemson,61,72,1,-11,2014-12-14
Campbell,College of Charleston,47,58,1,-11,2014-12-14
Coppin State,UConn,85,106,1,-21,2014-12-14
Illinois State,DePaul,78,72,0,6,2014-12-14
Jacksonville,Florida,34,79,1,-45,2014-12-14
Florida International,Florida Gulf Coast,69,63,0,6,2014-12-14
Southern,Iowa State,78,88,1,-10,2014-12-14
Dartmouth,Jacksonville State,67,79,1,-12,2014-12-14
Savannah State,Kansas State,53,73,1,-20,2014-12-14
NJIT,LIU-Brooklyn,49,65,1,-16,2014-12-14
UNC Wilmington,Louisville,57,68,1,-11,2014-12-14
Rutgers,Manhattan,63,55,0,8,2014-12-14
West Virginia,Marshall,69,66,0,3,2014-12-14
Longwood,UMBC,53,58,1,-5,2014-12-14
Oakland,Michigan State,61,87,1,-26,2014-12-14
Montana,Milwaukee,58,73,1,-15,2014-12-14
Colgate,New Hampshire,57,63,1,-6,2014-12-14
Wofford,NC State,55,54,0,1,2014-12-14
Cincinnati-Clermont,Northern Kentucky,53,107,1,-54,2014-12-14
Mississippi Valley State,Northwestern,49,101,1,-52,2014-12-14
North Carolina A&T,Old Dominion,48,85,1,-37,2014-12-14
Western Michigan,Pacific,80,72,0,8,2014-12-14
George Washington,Penn State,51,64,1,-13,2014-12-14
Portland,Sacramento State,80,75,0,5,2014-12-14
Mitchell,Sacred Heart,68,104,1,-36,2014-12-14
St. Peter's,Seton Hall,52,67,1,-15,2014-12-14
Coastal Carolina,South Carolina State,57,43,0,14,2014-12-14
Chicago State,Southern Illinois,50,65,1,-15,2014-12-14
Fordham,St. John's (NY),53,74,1,-21,2014-12-14
North Texas,Stephen F. Austin,48,59,1,-11,2014-12-14
Louisiana Tech,Syracuse,69,71,1,-2,2014-12-14
Butler,Tennessee,55,67,1,-12,2014-12-14
Prairie View,Texas Tech,51,79,1,-28,2014-12-14
Wagner,Vermont,47,61,1,-14,2014-12-14
Temple,Villanova,62,85,1,-23,2014-12-14
Alabama A&M,Virginia Tech,55,65,1,-10,2014-12-14
Samford,Wake Forest,68,86,1,-18,2014-12-14
Eastern Washington,Washington,77,81,1,-4,2014-12-14
Miami (OH),Wright State,59,68,1,-9,2014-12-14
Montana State,Wyoming,61,70,1,-9,2014-12-14
Troy,Austin Peay,70,73,1,-3,2014-12-15
Mount Vernon Nazarene,Cleveland State,40,86,1,-46,2014-12-15
Jackson State,Drake,66,76,1,-10,2014-12-15
Elon,Duke,62,75,1,-13,2014-12-15
Appalachian State,Georgia Tech,57,70,1,-13,2014-12-15
Texas Southern,Gonzaga,54,94,1,-40,2014-12-15
Bethune-Cookman,Grand Canyon,50,60,1,-10,2014-12-15
IUPUI,Howard,47,57,1,-10,2014-12-15
UT-Martin,UIC,81,78,0,3,2014-12-15
Champion Baptist,Lamar,54,128,1,-74,2014-12-15
North Carolina Central,Memphis,47,81,1,-34,2014-12-15
Virginia Wise,Norfolk State,49,88,1,-39,2014-12-15
Tennessee Tech,North Florida,82,80,0,2,2014-12-15
Missouri State,Oral Roberts,61,80,1,-19,2014-12-15
Grambling,Oregon State,43,71,1,-28,2014-12-15
South Alabama,Pepperdine,68,78,1,-10,2014-12-15
Cal Poly,San Francisco,78,71,0,7,2014-12-15
Northwest University,Seattle,58,84,1,-26,2014-12-15
Georgia Southern,South Florida,68,63,0,5,2014-12-15
UTSA,Texas A&M-Corpus Christi,73,60,0,13,2014-12-15
Oakland,Arizona,64,101,1,-37,2014-12-16
Drexel,Buffalo,70,80,1,-10,2014-12-16
College of Charleston,Charlotte,85,90,1,-5,2014-12-16
Northern Kentucky,Chattanooga,81,93,1,-12,2014-12-16
ETSU,Eastern Kentucky,63,60,0,3,2014-12-16
Stetson,Florida Atlantic,69,79,1,-10,2014-12-16
Houston Baptist,Houston,76,83,1,-7,2014-12-16
Truman State,Indiana State,68,78,1,-10,2014-12-16
UNC Asheville,Jacksonville State,55,64,1,-9,2014-12-16
American,La Salle,68,66,0,2,2014-12-16
Susquehanna,Lafayette,66,91,1,-25,2014-12-16
Central Baptist,Louisiana-Monroe,53,78,1,-25,2014-12-16
Arizona State,Marquette,71,78,1,-7,2014-12-16
King (TN),Marshall,76,90,1,-14,2014-12-16
Louisiana State-Alexandria,McNeese State,68,84,1,-16,2014-12-16
Dartmouth,Mercer,67,51,0,16,2014-12-16
UC-Irvine,Morgan State,62,63,1,-1,2014-12-16
Arkansas-Monticello,Nicholls State,75,81,1,-6,2014-12-16
UNC,UNC Greensboro,79,56,0,23,2014-12-16
Akron,North Dakota State,46,55,1,-9,2014-12-16
Mississippi Valley State,Northern Illinois,64,71,1,-7,2014-12-16
Oral Roberts,Oklahoma,53,85,1,-32,2014-12-16
Middle Tennessee,Oklahoma State,44,68,1,-24,2014-12-16
Samford,Presbyterian,81,71,0,10,2014-12-16
Johnson & Wales (NC),Radford,54,92,1,-38,2014-12-16
Northern Arizona,Saint Mary's,73,71,0,2,2014-12-16
Eastern Washington,Sam Houston State,52,76,1,-24,2014-12-16
Champion Baptist,Southern,50,114,1,-64,2014-12-16
Tennessee State,Southern Illinois,58,65,1,-7,2014-12-16
Lipscomb,Texas,61,106,1,-45,2014-12-16
Southeastern Louisiana,UTEP,62,80,1,-18,2014-12-16
Savannah State,Tulane,67,75,1,-8,2014-12-16
Western Carolina,Vanderbilt,79,99,1,-20,2014-12-16
Belmont,VCU,51,78,1,-27,2014-12-16
Alabama,Wichita State,52,53,1,-1,2014-12-16
Winthrop,Auburn,62,80,1,-18,2014-12-17
James Madison,Ball State,72,52,0,20,2014-12-17
New Mexico State,Baylor,55,66,1,-11,2014-12-17
Northeastern,Cal Poly,58,60,1,-2,2014-12-17
SIU-Edwardsville,Campbell,65,70,1,-5,2014-12-17
Detroit,UCF,70,75,1,-5,2014-12-17
San Diego State,Cincinnati,62,71,1,-9,2014-12-17
Texas A&M-Corpus Christi,Denver,73,83,1,-10,2014-12-17
Saint Francis (PA),Duquesne,67,52,0,15,2014-12-17
North Florida,Florida State,77,93,1,-16,2014-12-17
Catawba,George Mason,69,99,1,-30,2014-12-17
Incarnate Word,Grand Canyon,82,80,0,2,2014-12-17
Morehead State,Green Bay,50,66,1,-16,2014-12-17
Ferrum,High Point,48,106,1,-58,2014-12-17
Arkansas-Pine Bluff,Houston,61,56,0,5,2014-12-17
Hampton,Illinois,55,73,1,-18,2014-12-17
UT-Martin,Illinois State,54,64,1,-10,2014-12-17
Gardner-Webb,Jacksonville,65,68,1,-3,2014-12-17
Milligan,Louisiana,76,115,1,-39,2014-12-17
Abilene Christian,Loyola (IL),44,83,1,-39,2014-12-17
USC Upstate,Memphis,73,83,1,-10,2014-12-17
Longwood,Miami (OH),60,71,1,-11,2014-12-17
Eastern Michigan,Michigan State,46,66,1,-20,2014-12-17
Arkansas State,Mississippi State,69,55,0,14,2014-12-17
Alcorn State,Murray State,56,94,1,-38,2014-12-17
Northern Colorado,Omaha,82,92,1,-10,2014-12-17
Portland,UNLV,73,75,1,-2,2014-12-17
Central Arkansas,New Mexico,55,76,1,-21,2014-12-17
Barber-Scotia,North Carolina Central,52,108,1,-56,2014-12-17
Tennessee,NC State,72,83,1,-11,2014-12-17
Liberty,UNC Wilmington,70,73,1,-3,2014-12-17
Langston,North Texas,65,78,1,-13,2014-12-17
Central Michigan,Northwestern,80,67,0,13,2014-12-17
North Carolina A&T,Ohio State,55,97,1,-42,2014-12-17
Georgia State,Old Dominion,54,58,1,-4,2014-12-17
Cal State Northridge,Oregon,56,79,1,-23,2014-12-17
Howard,Pepperdine,45,53,1,-8,2014-12-17
Manhattan,Pitt,56,65,1,-9,2014-12-17
Texas-Rio Grande Valley,Saint Louis,69,75,1,-6,2014-12-17
UIC,SMU,46,67,1,-21,2014-12-17
Delaware State,St. Francis (NY),72,64,0,8,2014-12-17
Loyola Marymount,Stanford,58,67,1,-9,2014-12-17
Texas State,Stephen F. Austin,60,66,1,-6,2014-12-17
South Carolina State,Texas Tech,39,101,1,-62,2014-12-17
Robert Morris,Toledo,57,83,1,-26,2014-12-17
Missouri State,Tulsa,70,74,1,-4,2014-12-17
Grambling,Washington,38,86,1,-48,2014-12-17
Chicago State,Western Kentucky,60,75,1,-15,2014-12-17
Charleston Southern,Wofford,58,64,1,-6,2014-12-17
Kennesaw State,Youngstown State,90,84,0,6,2014-12-17
LSU,Alabama-Birmingham,79,70,0,9,2014-12-18
Oakland City,Austin Peay,52,76,1,-24,2014-12-18
Eureka,Bradley,38,80,1,-42,2014-12-18
Cal St Dominguez Hills,Cal State Fullerton,50,72,1,-22,2014-12-18
Stony Brook,Canisius,59,60,1,-1,2014-12-18
Appalachian State,Charlotte,65,75,1,-10,2014-12-18
Duke,UConn,66,56,0,10,2014-12-18
Temple,Delaware,82,62,0,20,2014-12-18
Ohio,Evansville,69,81,1,-12,2014-12-18
LIU-Brooklyn,Florida International,69,58,0,11,2014-12-18
Walla Walla,Idaho,39,86,1,-47,2014-12-18
South Dakota State,Idaho State,75,72,0,3,2014-12-18
Southern Miss,Jackson State,46,66,1,-20,2014-12-18
Nicholls State,Louisiana Tech,54,79,1,-25,2014-12-18
Coastal Carolina,Ole Miss,68,71,1,-3,2014-12-18
DePaul,Oregon State,59,90,1,-31,2014-12-18
Nevada,Pacific,65,69,1,-4,2014-12-18
Lehigh,Quinnipiac,65,80,1,-15,2014-12-18
St. Thomas (TX),Rice,61,72,1,-11,2014-12-18
South Alabama,Richmond,54,65,1,-11,2014-12-18
Morgan State,Rider,48,62,1,-14,2014-12-18
Portland State,San Francisco,40,77,1,-37,2014-12-18
Montana State,South Dakota,53,55,1,-2,2014-12-18
Seton Hall,South Florida,89,69,0,20,2014-12-18
Georgia Southern,Stetson,76,67,0,9,2014-12-18
Cal State Bakersfield,Utah State,56,57,1,-1,2014-12-18
Yale,Vermont,57,56,0,1,2014-12-18
Cleveland State,Virginia,54,70,1,-16,2014-12-18
Wright State,Western Carolina,69,56,0,13,2014-12-18
Stillman,Alabama,49,69,1,-20,2014-12-19
Case Western Reserve,Bucknell,65,88,1,-23,2014-12-19
Niagara,Buffalo,62,88,1,-26,2014-12-19
South Dakota State,Cal State Bakersfield,53,49,0,4,2014-12-19
Eastern Washington,California,67,78,1,-11,2014-12-19
San Diego Christian,UCSB,46,69,1,-23,2014-12-19
Concordia (MI),Central Michigan,60,97,1,-37,2014-12-19
Hawaii,Chaminade,94,63,0,31,2014-12-19
Texas-Rio Grande Valley,Creighton,60,75,1,-15,2014-12-19
Northern Illinois,Dartmouth,55,58,1,-3,2014-12-19
Colorado State,Denver,85,84,0,1,2014-12-19
North Florida,Florida A&M,83,65,0,18,2014-12-19
Furman,Florida Gulf Coast,78,83,1,-5,2014-12-19
Hiwassee,Gardner-Webb,71,91,1,-20,2014-12-19
Tennessee State,Hampton,54,66,1,-12,2014-12-19
North Carolina A&T,Kent State,57,71,1,-14,2014-12-19
Milligan,Lamar,53,80,1,-27,2014-12-19
Central Pennsylvania College,Liberty,65,94,1,-29,2014-12-19
Louisiana State-Alexandria,Louisiana-Monroe,71,76,1,-5,2014-12-19
Southern Utah,Loyola (IL),57,73,1,-16,2014-12-19
Alabama A&M,Marquette,49,83,1,-34,2014-12-19
Bethune-Cookman,Mercer,46,67,1,-21,2014-12-19
Eastern Kentucky,Miami (FL),72,44,0,28,2014-12-19
Chattanooga,Middle Tennessee,58,68,1,-10,2014-12-19
Seattle,Minnesota,57,92,1,-35,2014-12-19
Northern Kentucky,Morehead State,83,60,0,23,2014-12-19
Northern Arizona,Norfolk State,62,81,1,-19,2014-12-19
Dickinson State (ND),North Dakota,48,78,1,-30,2014-12-19
Maryland-Eastern Shore,Old Dominion,43,60,1,-17,2014-12-19
Lipscomb,Princeton,55,77,1,-22,2014-12-19
Siena,Radford,66,76,1,-10,2014-12-19
Clemson,South Carolina,45,68,1,-23,2014-12-19
Winthrop,Southeastern Louisiana,71,81,1,-10,2014-12-19
New Orleans,Southern Illinois,56,52,0,4,2014-12-19
Saint Mary's,St. John's (NY),47,53,1,-6,2014-12-19
Tennessee Tech,Tennessee,58,61,1,-3,2014-12-19
Arizona,UTEP,60,55,0,5,2014-12-19
Arkansas-Pine Bluff,Texas Tech,51,72,1,-21,2014-12-19
Jackson State,Tulane,49,56,1,-7,2014-12-19
Idaho State,Utah State,56,69,1,-13,2014-12-19
Washington College,William & Mary,46,86,1,-40,2014-12-19
Wilberforce,Youngstown State,71,92,1,-21,2014-12-19
UC-Davis,Air Force,81,75,0,6,2014-12-20
Bluffton,Akron,53,92,1,-39,2014-12-20
Mount St. Mary's,American,45,46,1,-1,2014-12-20
Lehigh,Arizona State,84,81,0,3,2014-12-20
Southeast Missouri State,Arkansas,67,84,1,-17,2014-12-20
Marshall,Arkansas State,58,67,1,-9,2014-12-20
Xavier,Auburn,88,89,1,-1,2014-12-20
St. Bonaventure,Binghamton,69,51,0,18,2014-12-20
Abilene Christian,Boise State,33,77,1,-44,2014-12-20
Stanford,BYU,77,79,1,-2,2014-12-20
Indiana,Butler,82,73,0,9,2014-12-20
Gonzaga,Cal Poly,63,50,0,13,2014-12-20
Idaho State,Cal State Bakersfield,50,59,1,-9,2014-12-20
Texas A&M-Corpus Christi,Cal State Northridge,75,68,0,7,2014-12-20
Houston Baptist,UC-Riverside,67,78,1,-11,2014-12-20
Montreat,Campbell,64,90,1,-26,2014-12-20
NJIT,Central Connecticut,84,76,0,8,2014-12-20
Saint Joseph's (IN),Chicago State,54,76,1,-22,2014-12-20
VCU,Cincinnati,68,47,0,21,2014-12-20
Davidson,College of Charleston,80,68,0,12,2014-12-20
Hofstra,Columbia,77,82,1,-5,2014-12-20
Boston University,Dayton,62,78,1,-16,2014-12-20
Iowa State,Drake,83,54,0,29,2014-12-20
Penn State,Drexel,73,68,0,5,2014-12-20
UMass-Lowell,Duquesne,63,79,1,-16,2014-12-20
Belmont,Fairfield,73,61,0,12,2014-12-20
Delaware,Fairleigh Dickinson,74,76,1,-2,2014-12-20
Wake Forest,Florida,50,63,1,-13,2014-12-20
South Florida,Florida State,62,75,1,-13,2014-12-20
Iona,George Mason,81,86,1,-5,2014-12-20
Charlotte,Georgetown,78,81,1,-3,2014-12-20
Vanderbilt,Georgia Tech,60,65,1,-5,2014-12-20
St. Edward's,Grand Canyon,55,81,1,-26,2014-12-20
South Carolina State,Houston,71,63,0,8,2014-12-20
Missouri,Illinois,59,62,1,-3,2014-12-20
Eastern Illinois,Indiana State,60,56,0,4,2014-12-20
Valparaiso,Purdue-Fort Wayne,75,72,0,3,2014-12-20
South Alabama,IUPUI,65,71,1,-6,2014-12-20
Truett-McConnell,Jacksonville,55,84,1,-29,2014-12-20
High Point,James Madison,80,71,0,9,2014-12-20
Lafayette,Kansas,69,96,1,-27,2014-12-20
Texas A&M,Kansas State,64,71,1,-7,2014-12-20
UMBC,Kennesaw State,66,53,0,13,2014-12-20
UCLA,Kentucky,44,83,1,-39,2014-12-20
Penn State-Beaver,Longwood,74,106,1,-32,2014-12-20
Morgan State,Manhattan,69,73,1,-4,2014-12-20
St. Joseph's,Marist,75,58,0,17,2014-12-20
Toledo,McNeese State,83,69,0,14,2014-12-20
Oral Roberts,Memphis,63,78,1,-15,2014-12-20
SMU,Michigan,62,51,0,11,2014-12-20
Texas Southern,Michigan State,71,64,0,7,2014-12-20
USC Upstate,Mississippi State,53,51,0,2,2014-12-20
North Carolina Central,Mississippi Valley State,94,60,0,34,2014-12-20
Incarnate Word,UMKC,110,104,0,6,2014-12-20
Eastern Michigan,Missouri State,77,65,0,12,2014-12-20
Illinois State,Murray State,77,89,1,-12,2014-12-20
Utah,UNLV,59,46,0,13,2014-12-20
New Mexico,New Mexico State,69,67,0,2,2014-12-20
Ohio State,UNC,74,82,1,-8,2014-12-20
Elon,UNC Greensboro,71,64,0,7,2014-12-20
West Virginia,NC State,83,69,0,14,2014-12-20
East Carolina,UNC Wilmington,54,66,1,-12,2014-12-20
Jacksonville State,Northern Colorado,60,69,1,-9,2014-12-20
Iowa,Northern Iowa,44,56,1,-12,2014-12-20
Western Michigan,Northwestern,61,67,1,-6,2014-12-20
Louisiana,Northwestern State,85,89,1,-4,2014-12-20
Purdue,Notre Dame,63,94,1,-31,2014-12-20
Washington,Oklahoma,69,67,0,2,2014-12-20
Delaware State,Oregon,70,83,1,-13,2014-12-20
Fresno State,Pacific,68,71,1,-3,2014-12-20
Richmond,Pepperdine,65,63,0,2,2014-12-20
Oakland,Pitt,77,81,1,-4,2014-12-20
Montana State,Portland,60,87,1,-27,2014-12-20
UMass,Providence,65,85,1,-20,2014-12-20
Detroit,Rhode Island,55,69,1,-14,2014-12-20
Saint Francis (PA),Rutgers,73,68,0,5,2014-12-20
New Hampshire,Sacred Heart,60,73,1,-13,2014-12-20
Prairie View,Sam Houston State,44,61,1,-17,2014-12-20
Ball State,San Diego State,57,70,1,-13,2014-12-20
Northeastern,Santa Clara,78,72,0,6,2014-12-20
Milwaukee,SIU-Edwardsville,56,61,1,-5,2014-12-20
Florida Atlantic,St. Francis (NY),56,61,1,-5,2014-12-20
Arkansas Tech,Stephen F. Austin,57,94,1,-37,2014-12-20
Presbyterian,UT-Martin,60,77,1,-17,2014-12-20
Long Beach State,Texas,68,78,1,-10,2014-12-20
Howard Payne,Texas-Arlington,50,89,1,-39,2014-12-20
UTSA,TCU,57,88,1,-31,2014-12-20
Huston-Tillotson,Texas State,56,90,1,-34,2014-12-20
La Salle,Towson,67,53,0,14,2014-12-20
South Dakota State,Utah State,68,65,0,3,2014-12-20
Syracuse,Villanova,77,82,1,-5,2014-12-20
Citadel,Virginia Tech,61,64,1,-3,2014-12-20
Monmouth,Wagner,74,66,0,8,2014-12-20
Utah Valley,Weber State,61,73,1,-12,2014-12-20
Louisville,Western Kentucky,76,67,0,9,2014-12-20
Southern,Wyoming,39,57,1,-18,2014-12-20
Albany (NY),Yale,64,60,0,4,2014-12-20
Appalachian State,Alabama,59,60,1,-1,2014-12-21
Green Bay,Little Rock,66,46,0,20,2014-12-21
Maine,Army,69,72,1,-3,2014-12-21
USC,Boston College,75,71,0,4,2014-12-21
Ferris State,Bowling Green State,82,68,0,14,2014-12-21
UC-Irvine,Bradley,55,47,0,8,2014-12-21
Holy Cross,Canisius,48,67,1,-19,2014-12-21
Coastal Carolina,Central Arkansas,72,55,0,17,2014-12-21
San Francisco,Cleveland State,65,69,1,-4,2014-12-21
Bryant,Denver,48,46,0,2,2014-12-21
Alabama State,Evansville,63,81,1,-18,2014-12-21
Seton Hall,Georgia,47,65,1,-18,2014-12-21
Southern Miss,Georgia State,55,68,1,-13,2014-12-21
Northern Arizona,Hampton,66,75,1,-9,2014-12-21
Florida International,Hartford,69,82,1,-13,2014-12-21
North Dakota State,Kent State,52,53,1,-1,2014-12-21
Austin Peay,Lipscomb,63,69,1,-6,2014-12-21
Tennessee State,Middle Tennessee,47,65,1,-18,2014-12-21
South Dakota,Montana,67,62,0,5,2014-12-21
Texas-Rio Grande Valley,Omaha,72,77,1,-5,2014-12-21
Troy,Nicholls State,65,64,0,1,2014-12-21
Western Carolina,UNC Asheville,66,62,0,4,2014-12-21
Creighton,North Texas,58,62,1,-4,2014-12-21
Maryland,Oklahoma State,73,64,0,9,2014-12-21
Oregon State,Quinnipiac,52,60,1,-8,2014-12-21
Cornell,Radford,61,74,1,-13,2014-12-21
Vermont,Saint Louis,55,58,1,-3,2014-12-21
Louisiana-Monroe,Samford,50,64,1,-14,2014-12-21
San Diego Christian,San Diego,61,71,1,-10,2014-12-21
Sacramento State,Seattle,47,66,1,-19,2014-12-21
Coker,South Carolina,52,78,1,-26,2014-12-21
Loyola (MD),Stony Brook,52,67,1,-15,2014-12-21
Alcorn State,UTEP,45,78,1,-33,2014-12-21
Goshen,Valparaiso,55,82,1,-27,2014-12-21
Harvard,Virginia,27,76,1,-49,2014-12-21
San Jose State,Washington State,53,82,1,-29,2014-12-21
Reinhardt,Winthrop,72,100,1,-28,2014-12-21
South Carolina State,Abilene Christian,59,65,1,-6,2014-12-22
Jacksonville State,Air Force,65,66,1,-1,2014-12-22
Fairfield,Albany (NY),66,77,1,-11,2014-12-22
North Dakota State,Alcorn State,61,50,0,11,2014-12-22
Milwaukee,Arkansas,54,84,1,-30,2014-12-22
Bradley,Little Rock,54,64,1,-10,2014-12-22
Southern Utah,Arkansas-Pine Bluff,61,70,1,-9,2014-12-22
Southern,Baylor,66,70,1,-4,2014-12-22
Houston,Boise State,73,75,1,-2,2014-12-22
UT-Martin,Butler,37,64,1,-27,2014-12-22
Texas A&M-Corpus Christi,Cal State Fullerton,77,82,1,-5,2014-12-22
Wisconsin,California,68,56,0,12,2014-12-22
Green Bay,UC-Irvine,70,72,1,-2,2014-12-22
Brown,Central Connecticut,67,55,0,12,2014-12-22
Southeastern Louisiana,UCF,65,70,1,-5,2014-12-22
Alabama-Birmingham,Chattanooga,67,83,1,-16,2014-12-22
Oakland,Clemson,60,70,1,-10,2014-12-22
DePaul,Colorado,68,82,1,-14,2014-12-22
Charleston Southern,Colorado State,54,75,1,-21,2014-12-22
UConn,Columbia,80,65,0,15,2014-12-22
Simpson,Drake,62,84,1,-22,2014-12-22
Florida A&M,East Carolina,57,75,1,-18,2014-12-22
Lewis & Clark,Eastern Washington,81,87,1,-6,2014-12-22
Eastern Kentucky,Florida Atlantic,66,69,1,-3,2014-12-22
Stetson,Florida State,59,63,1,-4,2014-12-22
Manhattan,Fordham,71,57,0,14,2014-12-22
Ohio,George Washington,49,77,1,-28,2014-12-22
Truett-McConnell,Georgia Southern,57,90,1,-33,2014-12-22
Nebraska,Hawaii,58,66,1,-8,2014-12-22
Purdue-Fort Wayne,Illinois State,43,68,1,-25,2014-12-22
New Orleans,Indiana,59,79,1,-20,2014-12-22
North Florida,Iowa,70,80,1,-10,2014-12-22
North Carolina Central,Jackson State,67,64,0,3,2014-12-22
Norfolk State,James Madison,74,71,0,3,2014-12-22
Elon,Kennesaw State,67,65,0,2,2014-12-22
UTEP,Kent State,78,75,0,3,2014-12-22
Rice,Lamar,72,79,1,-7,2014-12-22
College of Charleston,LSU,47,71,1,-24,2014-12-22
Texas Tech,Loyola (IL),44,62,1,-18,2014-12-22
Wichita State,Loyola Marymount,80,53,0,27,2014-12-22
North Dakota,Marquette,54,67,1,-13,2014-12-22
Central Michigan,McNeese State,87,58,0,29,2014-12-22
Providence,Miami (FL),76,62,0,14,2014-12-22
Coppin State,Michigan,56,72,1,-16,2014-12-22
Citadel,Michigan State,56,82,1,-26,2014-12-22
Furman,Minnesota,76,86,1,-10,2014-12-22
Southeast Missouri State,Ole Miss,51,82,1,-31,2014-12-22
Tennessee Tech,UMKC,81,60,0,21,2014-12-22
Oral Roberts,Missouri State,45,52,1,-7,2014-12-22
Binghamton,Mount St. Mary's,68,69,1,-1,2014-12-22
Towson,Navy,56,61,1,-5,2014-12-22
Marshall,Nevada,55,83,1,-28,2014-12-22
LIU-Brooklyn,New Hampshire,73,72,0,1,2014-12-22
Northern New Mexico,New Mexico State,39,78,1,-39,2014-12-22
UC-Davis,Northern Colorado,73,63,0,10,2014-12-22
Idaho,Northern Kentucky,68,81,1,-13,2014-12-22
UIC,Northwestern,46,63,1,-17,2014-12-22
Northern Illinois,Notre Dame,66,91,1,-25,2014-12-22
Miami (OH),Ohio State,55,93,1,-38,2014-12-22
Weber State,Oklahoma,51,85,1,-34,2014-12-22
William & Mary,Old Dominion,62,69,1,-7,2014-12-22
UCSB,Oregon,78,82,1,-4,2014-12-22
Dartmouth,Penn State,49,69,1,-20,2014-12-22
Lewis & Clark,Portland,49,71,1,-22,2014-12-22
Walla Walla,Portland State,52,94,1,-42,2014-12-22
Liberty,Princeton,47,65,1,-18,2014-12-22
Gardner-Webb,Purdue,89,84,0,5,2014-12-22
Delaware,Robert Morris,81,84,1,-3,2014-12-22
Northeastern,Saint Mary's,68,72,1,-4,2014-12-22
UC-Riverside,San Diego State,33,61,1,-28,2014-12-22
Murray State,Southern Illinois,83,71,0,12,2014-12-22
Chicago State,SIU-Edwardsville,38,63,1,-25,2014-12-22
Maryland-Eastern Shore,St. Bonaventure,82,80,0,2,2014-12-22
Long Beach State,St. John's (NY),49,66,1,-17,2014-12-22
Colgate,Syracuse,43,78,1,-35,2014-12-22
Kansas,Temple,52,77,1,-25,2014-12-22
Mercer,Tennessee,54,64,1,-10,2014-12-22
Grambling,TCU,39,80,1,-41,2014-12-22
Incarnate Word,Tulsa,47,76,1,-29,2014-12-22
Penn,Vanderbilt,50,79,1,-29,2014-12-22
ETSU,VCU,60,84,1,-24,2014-12-22
VMI,Virginia Tech,74,87,1,-13,2014-12-22
Bucknell,Wake Forest,53,60,1,-7,2014-12-22
Tulane,Washington,57,66,1,-9,2014-12-22
Wofford,West Virginia,44,77,1,-33,2014-12-22
Alabama A&M,Western Michigan,62,71,1,-9,2014-12-22
Arkansas-Pine Bluff,Abilene Christian,61,69,1,-8,2014-12-23
Detroit,Arizona State,54,93,1,-39,2014-12-23
Texas Southern,Auburn,60,61,1,-1,2014-12-23
Loyola (IL),Boise State,48,45,0,3,2014-12-23
UMass,BYU,71,77,1,-6,2014-12-23
UNC Wilmington,Campbell,63,69,1,-6,2014-12-23
Wagner,Cincinnati,48,72,1,-24,2014-12-23
Eastern Illinois,Cleveland State,67,65,0,2,2014-12-23
George Washington,Colorado,53,50,0,3,2014-12-23
Georgia Tech,Dayton,61,75,1,-14,2014-12-23
Ohio,DePaul,99,78,0,21,2014-12-23
Coppin State,Eastern Michigan,64,87,1,-23,2014-12-23
New Mexico,Grand Canyon,65,68,1,-3,2014-12-23
Wichita State,Hawaii,80,79,0,1,2014-12-23
La Salle,Hofstra,83,74,0,9,2014-12-23
Texas Tech,Houston,69,82,1,-13,2014-12-23
Florida Gulf Coast,Iona,67,86,1,-19,2014-12-23
Cal State Northridge,Louisville,55,80,1,-25,2014-12-23
Nebraska,Loyola Marymount,50,42,0,8,2014-12-23
Western Illinois,Memphis,51,78,1,-27,2014-12-23
Jacksonville,Mississippi State,47,70,1,-23,2014-12-23
St. Francis (NY),Monmouth,71,46,0,25,2014-12-23
Wyoming,Montana State,61,51,0,10,2014-12-23
Arizona,UNLV,67,71,1,-4,2014-12-23
Arkansas State,Niagara,74,69,0,5,2014-12-23
Louisiana Tech,NC State,65,73,1,-8,2014-12-23
Prairie View,North Texas,70,67,0,3,2014-12-23
Holy Cross,Pitt,39,58,1,-19,2014-12-23
IUPUI,Richmond,53,57,1,-4,2014-12-23
Sacred Heart,Rutgers,54,79,1,-25,2014-12-23
Fairleigh Dickinson,St. Peter's,60,69,1,-9,2014-12-23
Cal Poly,Santa Clara,69,58,0,11,2014-12-23
Cornell,Siena,75,57,0,18,2014-12-23
Howard,South Alabama,73,60,0,13,2014-12-23
Southern Utah,South Carolina State,66,56,0,10,2014-12-23
Southeastern Louisiana,South Florida,63,78,1,-15,2014-12-23
American,Stony Brook,47,59,1,-12,2014-12-23
Stanford,Texas,74,71,0,3,2014-12-23
South Dakota State,Utah,66,80,1,-14,2014-12-23
Idaho State,Utah Valley,47,51,1,-4,2014-12-23
NJIT,Villanova,67,92,1,-25,2014-12-23
George Mason,Wright State,68,60,0,8,2014-12-23
Loyola Marymount,DePaul,72,69,0,3,2014-12-25
Wichita State,George Washington,54,60,1,-6,2014-12-25
Colorado,Hawaii,66,69,1,-3,2014-12-25
Ohio,Nebraska,58,71,1,-13,2014-12-25
Gonzaga,BYU,87,80,0,7,2014-12-27
Indiana,Georgetown,87,91,1,-4,2014-12-27
Mercer,Georgia,77,86,1,-9,2014-12-27
Georgia State,Green Bay,61,78,1,-17,2014-12-27
Kennesaw State,Illinois,45,93,1,-48,2014-12-27
Jacksonville State,Jacksonville,61,75,1,-14,2014-12-27
Kentucky,Louisville,58,50,0,8,2014-12-27
Oakland,Maryland,56,72,1,-16,2014-12-27
UNC Wilmington,Minnesota,82,108,1,-26,2014-12-27
Southern Utah,UNLV,45,79,1,-34,2014-12-27
Colorado State,New Mexico State,58,57,0,1,2014-12-27
Alabama-Birmingham,UNC,58,89,1,-31,2014-12-27
Northern Kentucky,Northwestern,55,76,1,-21,2014-12-27
Wright State,Ohio State,55,100,1,-45,2014-12-27
San Francisco,Pacific,77,71,0,6,2014-12-27
IUPUI,Pepperdine,55,53,0,2,2014-12-27
Santa Clara,Saint Mary's,60,73,1,-13,2014-12-27
Portland,San Diego,61,58,0,3,2014-12-27
San Diego Christian,San Diego State,50,72,1,-22,2014-12-27
Maine,Seton Hall,43,72,1,-29,2014-12-27
Tennessee State,Tennessee,46,67,1,-21,2014-12-27
Wayland Baptist,Utah State,63,75,1,-12,2014-12-27
Sacramento State,Utah Valley,74,49,0,25,2014-12-27
Presbyterian,Virginia Tech,65,87,1,-22,2014-12-27
Bristol University,Weber State,59,109,1,-50,2014-12-27
Brescia,Western Kentucky,42,89,1,-47,2014-12-27
UCLA,Alabama,50,56,1,-6,2014-12-28
Harvard,Arizona State,46,56,1,-10,2014-12-28
Northwestern State,Arkansas,92,100,1,-8,2014-12-28
Coast Guard,Army,48,93,1,-45,2014-12-28
Longwood,Ball State,64,69,1,-5,2014-12-28
UIC,Bradley,60,68,1,-8,2014-12-28
Sacred Heart,Brown,76,79,1,-3,2014-12-28
Belmont,Butler,56,67,1,-11,2014-12-28
Cal State Bakersfield,California,55,52,0,3,2014-12-28
Colgate,Columbia,64,69,1,-5,2014-12-28
Central Connecticut,UConn,48,81,1,-33,2014-12-28
St. Peter's,Cornell,59,52,0,7,2014-12-28
Iona,Drexel,81,62,0,19,2014-12-28
Maryland-Eastern Shore,Duquesne,78,69,0,9,2014-12-28
UNC Greensboro,East Carolina,50,71,1,-21,2014-12-28
Concordia (MI),Eastern Michigan,42,100,1,-58,2014-12-28
Marist,Elon,64,69,1,-5,2014-12-28
Coppin State,Evansville,80,85,1,-5,2014-12-28
Loyola (MD),Fairfield,61,59,0,2,2014-12-28
Howard,Fordham,59,74,1,-15,2014-12-28
St. Katherine,Fresno State,62,93,1,-31,2014-12-28
Abilene Christian,Grand Canyon,81,83,1,-2,2014-12-28
Thomas University,High Point,48,85,1,-37,2014-12-28
LIU-Brooklyn,Hofstra,62,88,1,-26,2014-12-28
Mississippi Valley State,Houston,53,80,1,-27,2014-12-28
UMKC,Indiana State,73,70,0,3,2014-12-28
Judson,Purdue-Fort Wayne,46,80,1,-34,2014-12-28
Texas Southern,Kansas State,58,56,0,2,2014-12-28
NJIT,Lafayette,71,76,1,-5,2014-12-28
Cincinnati Christian,Liberty,58,78,1,-20,2014-12-28
Morgan State,Marquette,53,81,1,-28,2014-12-28
Lehigh,UMBC,58,55,0,3,2014-12-28
Rutgers,Monmouth,59,58,0,1,2014-12-28
Northwest Christian,Nevada,67,81,1,-14,2014-12-28
North Carolina Wesleyan,North Carolina A&T,54,58,1,-4,2014-12-28
Northland,North Dakota State,59,83,1,-24,2014-12-28
San Diego Christian,Northern Arizona,45,71,1,-26,2014-12-28
South Dakota State,Northern Iowa,63,74,1,-11,2014-12-28
Haskell Indian Nations Institute,Oral Roberts,42,94,1,-52,2014-12-28
Central Pennsylvania College,Radford,69,119,1,-50,2014-12-28
Wake Forest,Richmond,65,63,0,2,2014-12-28
Campbell,Samford,56,65,1,-9,2014-12-28
Bucknell,Siena,71,73,1,-2,2014-12-28
Milwaukee,South Dakota,60,84,1,-24,2014-12-28
Bowling Green State,South Florida,79,70,0,9,2014-12-28
Harris-Stowe,Southeast Missouri State,66,94,1,-28,2014-12-28
Robert Morris (IL),SIU-Edwardsville,56,104,1,-48,2014-12-28
Tulane,St. John's (NY),57,82,1,-25,2014-12-28
Long Beach State,Syracuse,67,85,1,-18,2014-12-28
Delaware State,Temple,56,66,1,-10,2014-12-28
Stony Brook,Washington,62,57,0,5,2014-12-28
UC-Davis,Washington State,83,90,1,-7,2014-12-28
Buffalo,Wisconsin,56,68,1,-12,2014-12-28
Florida Gulf Coast,Xavier,57,71,1,-14,2014-12-28
Middle Tennessee,Auburn,48,64,1,-16,2014-12-29
UMass-Lowell,Boston College,47,70,1,-23,2014-12-29
Wentworth,Boston University,46,69,1,-23,2014-12-29
Portland,BYU,88,97,1,-9,2014-12-29
Stephen F. Austin,Cal State Northridge,61,57,0,4,2014-12-29
Morehead State,Central Arkansas,95,60,0,35,2014-12-29
Johnson University,Charleston Southern,47,81,1,-34,2014-12-29
Lipscomb,Chattanooga,60,78,1,-18,2014-12-29
Omaha,Chicago State,66,69,1,-3,2014-12-29
St. Joseph's,Denver,73,77,1,-4,2014-12-29
Toledo,Duke,69,86,1,-17,2014-12-29
Florida International,Florida A&M,76,55,0,21,2014-12-29
Southern,Hawaii,57,71,1,-14,2014-12-29
Quincy,Illinois State,57,99,1,-42,2014-12-29
Valparaiso,James Madison,79,52,0,27,2014-12-29
Southern Miss,LSU,67,87,1,-20,2014-12-29
Southern Arkansas,Louisiana Tech,52,74,1,-22,2014-12-29
Pepperdine,Loyola Marymount,69,56,0,13,2014-12-29
Capital,Miami (OH),46,69,1,-23,2014-12-29
IUPUI,North Carolina Central,49,70,1,-21,2014-12-29
Hampton,Northern Illinois,51,83,1,-32,2014-12-29
Mount St. Mary's,Old Dominion,35,69,1,-34,2014-12-29
UC-Irvine,Oregon,67,69,1,-2,2014-12-29
Santa Clara,Pacific,57,40,0,17,2014-12-29
Maine,Quinnipiac,64,81,1,-17,2014-12-29
San Francisco,Saint Mary's,56,69,1,-13,2014-12-29
Howard Payne,Sam Houston State,47,102,1,-55,2014-12-29
Gonzaga,San Diego,60,48,0,12,2014-12-29
Midwestern State,SMU,61,70,1,-9,2014-12-29
Arkansas-Pine Bluff,Stanford,39,74,1,-35,2014-12-29
North Florida,Tennessee Tech,84,87,1,-3,2014-12-29
Rice,Texas,55,66,1,-11,2014-12-29
Tennessee State,TCU,40,60,1,-20,2014-12-29
North Texas,Texas Tech,45,60,1,-15,2014-12-29
Fairleigh Dickinson,Towson,85,84,0,1,2014-12-29
Cleveland State,VCU,63,72,1,-9,2014-12-29
Rider,Wagner,76,71,0,5,2014-12-29
Alice Lloyd,Western Kentucky,62,104,1,-42,2014-12-29
Marshall,Akron,63,70,1,-7,2014-12-30
Fort Valley State,Alabama State,65,76,1,-11,2014-12-30
Concordia (AL),Alcorn State,79,70,0,9,2014-12-30
Louisiana,Little Rock,83,79,0,4,2014-12-30
Norfolk State,Baylor,51,92,1,-41,2014-12-30
Buffalo,Binghamton,76,50,0,26,2014-12-30
Cal State East Bay,Cal State Fullerton,45,77,1,-32,2014-12-30
Morgan State,UC-Riverside,63,68,1,-5,2014-12-30
UMKC,Canisius,55,67,1,-12,2014-12-30
Bethune-Cookman,Citadel,47,51,1,-4,2014-12-30
Robert Morris,Clemson,57,64,1,-7,2014-12-30
Eastern Kentucky,Coppin State,66,63,0,3,2014-12-30
Ole Miss,Dayton,74,78,1,-4,2014-12-30
St. Bonaventure,Delaware,77,82,1,-5,2014-12-30
Oral Roberts,Detroit,77,73,0,4,2014-12-30
Texas-Rio Grande Valley,Duquesne,72,78,1,-6,2014-12-30
Florida,Florida State,63,65,1,-2,2014-12-30
St. Andrews,Furman,35,72,1,-37,2014-12-30
VMI,George Washington,60,80,1,-20,2014-12-30
Louisiana-Monroe,Georgia State,45,65,1,-20,2014-12-30
Charlotte,Georgia Tech,66,67,1,-1,2014-12-30
Harvard,Grand Canyon,72,59,0,13,2014-12-30
Prairie View,Hawaii,68,76,1,-8,2014-12-30
Ecclesia,Houston Baptist,47,98,1,-51,2014-12-30
Judson,UIC,38,79,1,-41,2014-12-30
Cal Poly,Purdue-Fort Wayne,71,57,0,14,2014-12-30
Florida Atlantic,Jacksonville,68,50,0,18,2014-12-30
Kent State,Kansas,62,78,1,-16,2014-12-30
Penn,La Salle,67,84,1,-17,2014-12-30
Huston-Tillotson,Lamar,59,85,1,-26,2014-12-30
Long Beach State,Louisville,48,63,1,-15,2014-12-30
Iona,UMass,82,87,1,-5,2014-12-30
College of Charleston,Miami (FL),40,67,1,-27,2014-12-30
Illinois,Michigan,65,73,1,-8,2014-12-30
Maryland,Michigan State,68,66,0,2,2014-12-30
McNeese State,Mississippi State,66,47,0,19,2014-12-30
Oklahoma State,Missouri,74,72,0,2,2014-12-30
Alabama A&M,Murray State,39,76,1,-37,2014-12-30
Texas Southern,New Mexico State,52,54,1,-2,2014-12-30
Central Baptist,New Orleans,60,90,1,-30,2014-12-30
Albany (NY),Niagara,47,65,1,-18,2014-12-30
Spring Hill,Nicholls State,64,71,1,-7,2014-12-30
Saint Francis (PA),NJIT,65,77,1,-12,2014-12-30
William & Mary,UNC,64,86,1,-22,2014-12-30
Cincinnati,NC State,76,60,0,16,2014-12-30
Hartford,Notre Dame,60,87,1,-27,2014-12-30
UNC Wilmington,Ohio,53,72,1,-19,2014-12-30
Iowa,Ohio State,71,65,0,6,2014-12-30
UCSB,Oregon State,64,76,1,-12,2014-12-30
Florida Gulf Coast,Pitt,54,71,1,-17,2014-12-30
Northwestern,Rutgers,51,47,0,4,2014-12-30
Yale,Sacred Heart,70,64,0,6,2014-12-30
Auburn Montgomery,Samford,60,94,1,-34,2014-12-30
UC-Davis,Seattle,67,76,1,-9,2014-12-30
Arkansas State,South Alabama,63,60,0,3,2014-12-30
North Carolina A&T,South Carolina,54,91,1,-37,2014-12-30
Montreat,USC Upstate,55,101,1,-46,2014-12-30
Vermont,USC,56,64,1,-8,2014-12-30
Columbia,St. Francis (NY),64,72,1,-8,2014-12-30
Florida Tech,Stetson,61,77,1,-16,2014-12-30
Maryland-Eastern Shore,UT-Martin,63,60,0,3,2014-12-30
Mercer,Texas A&M,50,65,1,-15,2014-12-30
Jarvis Christian,Texas A&M-Corpus Christi,55,87,1,-32,2014-12-30
Georgia Southern,Texas-Arlington,61,62,1,-1,2014-12-30
Cameron,UTSA,68,79,1,-11,2014-12-30
Texas State,Troy,57,46,0,11,2014-12-30
Carroll (MT),Utah,49,85,1,-36,2014-12-30
Bristol University,Utah Valley,50,83,1,-33,2014-12-30
Davidson,Virginia,72,83,1,-11,2014-12-30
Virginia Tech,West Virginia,51,82,1,-31,2014-12-30
St. Catharine,Western Carolina,70,86,1,-16,2014-12-30
Anderson (SC),Western Illinois,62,74,1,-12,2014-12-30
New Hampshire,Western Michigan,56,70,1,-14,2014-12-30
Lafayette,Army,92,78,0,14,2014-12-31
North Florida,Austin Peay,60,65,1,-5,2014-12-31
Dartmouth,Bryant,76,59,0,17,2014-12-31
American,Bucknell,47,57,1,-10,2014-12-31
La Verne,Cal State Bakersfield,36,87,1,-51,2014-12-31
Hampden-Sydney,UC-Irvine,53,82,1,-29,2014-12-31
Liberty,Campbell,46,53,1,-7,2014-12-31
Hofstra,Central Connecticut,84,56,0,28,2014-12-31
Tulsa,UCF,56,54,0,2,2014-12-31
Boise State,Colorado State,65,71,1,-6,2014-12-31
Temple,UConn,57,53,0,4,2014-12-31
Marquette,DePaul,58,61,1,-3,2014-12-31
Wichita State,Drake,66,58,0,8,2014-12-31
Wofford,Duke,55,84,1,-29,2014-12-31
Tulane,East Carolina,67,59,0,8,2014-12-31
South Carolina State,Fordham,54,74,1,-20,2014-12-31
Chicago State,Green Bay,50,54,1,-4,2014-12-31
Coastal Carolina,High Point,83,68,0,15,2014-12-31
Boston University,Holy Cross,75,72,0,3,2014-12-31
Indiana State,Illinois State,63,61,0,2,2014-12-31
Mississippi Valley State,Iowa State,33,83,1,-50,2014-12-31
Georgia,Kansas State,50,46,0,4,2014-12-31
Colgate,Lehigh,68,61,0,7,2014-12-31
Bradley,Loyola (IL),49,64,1,-15,2014-12-31
Houston,Memphis,54,73,1,-19,2014-12-31
Loyola (MD),Navy,47,70,1,-23,2014-12-31
Indiana,Nebraska,70,65,0,5,2014-12-31
Fresno State,New Mexico,64,76,1,-12,2014-12-31
Mars Hill,UNC Greensboro,48,92,1,-44,2014-12-31
Louisiana College,Northwestern State,68,94,1,-26,2014-12-31
George Mason,Oklahoma,43,61,1,-18,2014-12-31
Gardner-Webb,Presbyterian,81,64,0,17,2014-12-31
Creighton,Providence,53,65,1,-12,2014-12-31
Minnesota,Purdue,68,72,1,-4,2014-12-31
UNC Asheville,Radford,62,60,0,2,2014-12-31
Brown,Rhode Island,60,80,1,-20,2014-12-31
Northeastern,Richmond,58,57,0,1,2014-12-31
Vanderbilt,Saint Louis,70,55,0,15,2014-12-31
Air Force,San Diego State,49,53,1,-4,2014-12-31
St. John's (NY),Seton Hall,67,78,1,-11,2014-12-31
Missouri State,Southern Illinois,53,50,0,3,2014-12-31
South Florida,SMU,49,83,1,-34,2014-12-31
Cornell,Syracuse,44,61,1,-17,2014-12-31
ETSU,Tennessee,61,71,1,-10,2014-12-31
Kennesaw State,Tennessee State,62,73,1,-11,2014-12-31
San Jose State,Utah State,33,61,1,-28,2014-12-31
Butler,Villanova,55,67,1,-12,2014-12-31
Princeton,Wake Forest,66,80,1,-14,2014-12-31
Longwood,Winthrop,72,82,1,-10,2014-12-31
Penn State,Wisconsin,72,89,1,-17,2014-12-31
UNLV,Wyoming,71,76,1,-5,2014-12-31
Georgetown,Xavier,53,70,1,-17,2014-12-31
Northern Kentucky,Youngstown State,74,78,1,-4,2014-12-31
Southeast Missouri State,Belmont,77,78,1,-1,2015-01-01
Tennessee Tech,Eastern Illinois,59,61,1,-2,2015-01-01
Weber State,Eastern Washington,78,84,1,-6,2015-01-01
Northern Iowa,Evansville,49,52,1,-3,2015-01-01
Idaho State,Idaho,54,77,1,-23,2015-01-01
Pacific,Loyola Marymount,77,63,0,14,2015-01-01
Northern Colorado,Montana,48,66,1,-18,2015-01-01
North Dakota,Montana State,67,60,0,7,2015-01-01
Saint Mary's,Pepperdine,68,59,0,9,2015-01-01
Southern Utah,Portland State,68,71,1,-3,2015-01-01
Northern Arizona,Sacramento State,73,78,1,-5,2015-01-01
San Diego,San Francisco,57,56,0,1,2015-01-01
BYU,Santa Clara,81,46,0,35,2015-01-01
Jacksonville State,SIU-Edwardsville,57,73,1,-16,2015-01-01
Crowley's Ridge,UT-Martin,61,84,1,-23,2015-01-01
North Florida,Alabama,61,76,1,-15,2015-01-02
Morgan State,Cal State Northridge,62,78,1,-16,2015-01-02
Washington,California,75,81,1,-6,2015-01-02
Vermont,UCSB,57,64,1,-7,2015-01-02
Monmouth,Canisius,73,68,0,5,2015-01-02
Central Pennsylvania College,Central Michigan,80,125,1,-45,2015-01-02
Milwaukee,Cleveland State,57,84,1,-27,2015-01-02
UCLA,Colorado,56,62,1,-6,2015-01-02
South Dakota State,Denver,69,76,1,-7,2015-01-02
VMI,ETSU,88,98,1,-10,2015-01-02
Siena,Fairfield,68,67,0,1,2015-01-02
Ave Maria,Florida Gulf Coast,36,49,1,-13,2015-01-02
Youngstown State,UIC,71,77,1,-6,2015-01-02
Texas-Rio Grande Valley,Kent State,54,74,1,-20,2015-01-02
Rider,Marist,69,59,0,10,2015-01-02
NJIT,UMBC,70,55,0,15,2015-01-02
Binghamton,UMass-Lowell,40,50,1,-10,2015-01-02
Florida State,Mississippi State,55,62,1,-7,2015-01-02
Manhattan,Niagara,61,73,1,-12,2015-01-02
Oral Roberts,North Dakota State,66,72,1,-6,2015-01-02
UTEP,North Texas,85,71,0,14,2015-01-02
UC-Riverside,Northern Illinois,67,72,1,-5,2015-01-02
Valparaiso,Oakland,75,89,1,-14,2015-01-02
St. Peter's,Quinnipiac,66,60,0,6,2015-01-02
UTSA,Rice,52,67,1,-15,2015-01-02
Omaha,South Dakota,86,77,0,9,2015-01-02
Washington State,Stanford,56,71,1,-15,2015-01-02
USC,Utah,55,79,1,-24,2015-01-02
Purdue-Fort Wayne,Western Illinois,67,73,1,-6,2015-01-02
Rochester (MI),Western Michigan,54,69,1,-15,2015-01-02
Detroit,Wright State,57,70,1,-13,2015-01-02
Coppin State,Akron,62,79,1,-17,2015-01-03
Jackson State,Alabama A&M,70,67,0,3,2015-01-03
Grambling,Alabama State,50,71,1,-21,2015-01-03
Maine,Albany (NY),56,80,1,-24,2015-01-03
Texas Southern,Alcorn State,72,55,0,17,2015-01-03
Holy Cross,American,49,53,1,-4,2015-01-03
Utah Valley,Arkansas,46,79,1,-33,2015-01-03
Mississippi Valley State,Arkansas-Pine Bluff,67,63,0,4,2015-01-03
Appalachian State,Arkansas State,74,73,0,1,2015-01-03
North Alabama,Auburn,61,82,1,-21,2015-01-03
Bethune-Cookman,Ball State,48,51,1,-3,2015-01-03
Utah State,Boise State,62,61,0,1,2015-01-03
Lehigh,Boston University,56,75,1,-19,2015-01-03
Chicago State,Bowling Green State,35,58,1,-23,2015-01-03
Southern Illinois,Bradley,44,63,1,-19,2015-01-03
Cornell,Buffalo,73,92,1,-19,2015-01-03
Seattle,Cal State Fullerton,55,67,1,-12,2015-01-03
Cal State Maritime,UC-Davis,41,78,1,-37,2015-01-03
Fairleigh Dickinson,Central Connecticut,73,67,0,6,2015-01-03
Furman,Chattanooga,60,72,1,-12,2015-01-03
SMU,Cincinnati,50,56,1,-6,2015-01-03
UNC,Clemson,74,50,0,24,2015-01-03
Charleston Southern,Coastal Carolina,74,83,1,-9,2015-01-03
Bucknell,Colgate,62,68,1,-6,2015-01-03
Richmond,Davidson,67,81,1,-14,2015-01-03
Duquesne,Dayton,55,81,1,-26,2015-01-03
Northeastern,Delaware,72,53,0,19,2015-01-03
Xavier,DePaul,68,71,1,-3,2015-01-03
Elon,Drexel,77,67,0,10,2015-01-03
Boston College,Duke,62,85,1,-23,2015-01-03
Jacksonville State,Eastern Illinois,50,59,1,-9,2015-01-03
South Carolina State,Eastern Kentucky,52,63,1,-11,2015-01-03
Idaho State,Eastern Washington,57,65,1,-8,2015-01-03
UConn,Florida,63,59,0,4,2015-01-03
San Diego State,Fresno State,57,59,1,-2,2015-01-03
La Salle,George Mason,62,70,1,-8,2015-01-03
Creighton,Georgetown,61,76,1,-15,2015-01-03
Norfolk State,Georgia,50,63,1,-13,2015-01-03
Texas State,Georgia Southern,36,40,1,-4,2015-01-03
Little Rock,Georgia State,69,82,1,-13,2015-01-03
Northwestern State,Houston Baptist,99,78,0,21,2015-01-03
Weber State,Idaho,84,86,1,-2,2015-01-03
South Carolina,Iowa State,64,60,0,4,2015-01-03
Towson,James Madison,52,61,1,-9,2015-01-03
Thomas University,Kennesaw State,66,92,1,-26,2015-01-03
Navy,Lafayette,69,65,0,4,2015-01-03
Nicholls State,Lamar,62,75,1,-13,2015-01-03
Presbyterian,Liberty,62,58,0,4,2015-01-03
Fresno Pacific,Long Beach State,46,81,1,-35,2015-01-03
Bryant,LIU-Brooklyn,67,63,0,4,2015-01-03
Radford,Longwood,79,90,1,-11,2015-01-03
Troy,Louisiana,64,91,1,-27,2015-01-03
Savannah State,LSU,59,75,1,-16,2015-01-03
Saint Mary's,Loyola Marymount,72,63,0,9,2015-01-03
Army,Loyola (MD),77,53,0,24,2015-01-03
Providence,Marquette,66,75,1,-9,2015-01-03
Minnesota,Maryland,58,70,1,-12,2015-01-03
St. Bonaventure,UMass,69,55,0,14,2015-01-03
Stephen F. Austin,McNeese State,80,75,0,5,2015-01-03
Tulane,Memphis,74,66,0,8,2015-01-03
Virginia,Miami (FL),89,80,0,9,2015-01-03
UMKC,Miami (OH),61,66,1,-5,2015-01-03
Austin Peay,Ole Miss,63,92,1,-29,2015-01-03
Lipscomb,Missouri,60,72,1,-12,2015-01-03
Drake,Missouri State,37,62,1,-25,2015-01-03
North Dakota,Montana,63,74,1,-11,2015-01-03
Northern Colorado,Montana State,62,54,0,8,2015-01-03
Murray State,Morehead State,66,57,0,9,2015-01-03
Air Force,Nevada,62,80,1,-18,2015-01-03
Colorado State,New Mexico,53,66,1,-13,2015-01-03
UC-Irvine,New Mexico State,67,70,1,-3,2015-01-03
Gardner-Webb,UNC Asheville,55,80,1,-25,2015-01-03
Cal State Bakersfield,North Carolina A&T,70,83,1,-13,2015-01-03
Mercer,UNC Greensboro,76,55,0,21,2015-01-03
Pitt,NC State,50,68,1,-18,2015-01-03
Hofstra,UNC Wilmington,68,56,0,12,2015-01-03
Toledo,Northern Kentucky,57,55,0,2,2015-01-03
Georgia Tech,Notre Dame,76,83,1,-7,2015-01-03
Illinois,Ohio State,61,77,1,-16,2015-01-03
Baylor,Oklahoma,63,73,1,-10,2015-01-03
Kansas State,Oklahoma State,47,61,1,-14,2015-01-03
Oregon State,Oregon,59,71,1,-12,2015-01-03
Pacific,Pepperdine,61,71,1,-10,2015-01-03
Gonzaga,Portland,87,75,0,12,2015-01-03
Northern Arizona,Portland State,73,60,0,13,2015-01-03
Michigan,Purdue,51,64,1,-13,2015-01-03
Mount St. Mary's,Robert Morris,45,70,1,-25,2015-01-03
Penn State,Rutgers,46,50,1,-4,2015-01-03
Southern Utah,Sacramento State,75,90,1,-15,2015-01-03
St. Francis (NY),Sacred Heart,73,71,0,2,2015-01-03
Wagner,Saint Francis (PA),68,85,1,-17,2015-01-03
George Washington,St. Joseph's,64,60,0,4,2015-01-03
Rhode Island,Saint Louis,65,53,0,12,2015-01-03
Incarnate Word,Sam Houston State,78,84,1,-6,2015-01-03
Wofford,Samford,68,65,0,3,2015-01-03
BYU,San Francisco,99,68,0,31,2015-01-03
Wyoming,San Jose State,64,59,0,5,2015-01-03
San Diego,Santa Clara,56,59,1,-3,2015-01-03
Villanova,Seton Hall,61,66,1,-5,2015-01-03
Hampton,USC Upstate,54,68,1,-14,2015-01-03
East Carolina,South Florida,50,58,1,-8,2015-01-03
Prairie View,Southern,56,68,1,-12,2015-01-03
Tennessee Tech,SIU-Edwardsville,62,85,1,-23,2015-01-03
Louisiana Tech,Southern Miss,83,70,0,13,2015-01-03
Butler,St. John's (NY),73,69,0,4,2015-01-03
Florida A&M,Stetson,60,65,1,-5,2015-01-03
New Hampshire,Stony Brook,61,71,1,-10,2015-01-03
Southeast Missouri State,Tennessee State,77,62,0,15,2015-01-03
Hartford,Texas A&M,49,58,1,-9,2015-01-03
South Alabama,Texas-Arlington,87,99,1,-12,2015-01-03
West Virginia,TCU,78,67,0,11,2015-01-03
Texas,Texas Tech,70,61,0,9,2015-01-03
Yale,Vanderbilt,74,79,1,-5,2015-01-03
Syracuse,Virginia Tech,68,66,0,2,2015-01-03
Citadel,Western Carolina,70,78,1,-8,2015-01-03
College of Charleston,William & Mary,45,75,1,-30,2015-01-03
High Point,Winthrop,90,87,0,3,2015-01-03
Central Arkansas,Abilene Christian,70,87,1,-17,2015-01-04
Arizona State,Arizona,49,73,1,-24,2015-01-04
Washington State,California,69,66,0,3,2015-01-04
Manhattan,Canisius,63,60,0,3,2015-01-04
Old Dominion,Charlotte,61,54,0,7,2015-01-04
USC,Colorado,65,86,1,-21,2015-01-04
South Dakota,Denver,74,69,0,5,2015-01-04
Milwaukee,Detroit,67,83,1,-16,2015-01-04
Florida International,Florida Atlantic,62,60,0,2,2015-01-04
VCU,Fordham,75,58,0,17,2015-01-04
UC-Riverside,Grand Canyon,69,71,1,-2,2015-01-04
Cleveland State,UIC,74,69,0,5,2015-01-04
Evansville,Indiana State,75,79,1,-4,2015-01-04
IUPUI,Purdue-Fort Wayne,63,58,0,5,2015-01-04
UNLV,Kansas,61,76,1,-15,2015-01-04
Alabama-Birmingham,Middle Tennessee,54,49,0,5,2015-01-04
Monmouth,Niagara,66,50,0,16,2015-01-04
South Dakota State,North Dakota State,69,72,1,-3,2015-01-04
UTSA,North Texas,71,61,0,10,2015-01-04
Loyola (IL),Northern Iowa,58,67,1,-9,2015-01-04
Wisconsin,Northwestern,81,58,0,23,2015-01-04
UTEP,Rice,66,57,0,9,2015-01-04
Marist,St. Peter's,67,79,1,-12,2015-01-04
Iona,Siena,86,72,0,14,2015-01-04
Washington,Stanford,60,68,1,-8,2015-01-04
UCF,Temple,78,84,1,-6,2015-01-04
Houston,Tulsa,54,72,1,-18,2015-01-04
UCLA,Utah,39,71,1,-32,2015-01-04
Youngstown State,Valparaiso,64,79,1,-15,2015-01-04
Louisville,Wake Forest,85,76,0,9,2015-01-04
Omaha,Western Illinois,78,80,1,-2,2015-01-04
Marshall,Western Kentucky,62,81,1,-19,2015-01-04
Illinois State,Wichita State,62,70,1,-8,2015-01-04
Grambling,Alabama A&M,46,67,1,-21,2015-01-05
Jackson State,Alabama State,52,72,1,-20,2015-01-05
Prairie View,Alcorn State,62,68,1,-6,2015-01-05
Louisiana,Appalachian State,80,64,0,16,2015-01-05
South Alabama,Little Rock,72,69,0,3,2015-01-05
Trinity Baptist,Bethune-Cookman,71,97,1,-26,2015-01-05
UMass-Lowell,Brown,49,58,1,-9,2015-01-05
Florida Gulf Coast,UCSB,50,63,1,-13,2015-01-05
Campbell,Charleston Southern,71,74,1,-3,2015-01-05
Wofford,Chattanooga,68,64,0,4,2015-01-05
James Madison,College of Charleston,61,50,0,11,2015-01-05
Cheyney,Delaware State,68,90,1,-22,2015-01-05
William & Mary,Drexel,73,47,0,26,2015-01-05
Rider,Fairfield,62,46,0,16,2015-01-05
Texas State,Georgia State,77,74,0,3,2015-01-05
Wright State,Green Bay,55,79,1,-24,2015-01-05
Saint Rose,Harvard,38,84,1,-46,2015-01-05
Delaware,Hofstra,58,71,1,-13,2015-01-05
Nebraska,Iowa,59,70,1,-11,2015-01-05
Rhodes,Lipscomb,53,90,1,-37,2015-01-05
Fairleigh Dickinson,LIU-Brooklyn,75,69,0,6,2015-01-05
Arkansas State,Louisiana-Monroe,61,70,1,-9,2015-01-05
Houston Baptist,McNeese State,68,56,0,12,2015-01-05
Indiana,Michigan State,50,70,1,-20,2015-01-05
Lamar,New Orleans,67,72,1,-5,2015-01-05
Notre Dame,UNC,71,70,0,1,2015-01-05
Citadel,UNC Greensboro,85,83,0,2,2015-01-05
UNC Wilmington,Northeastern,75,68,0,7,2015-01-05
Central Connecticut,Sacred Heart,66,75,1,-9,2015-01-05
Robert Morris,Saint Francis (PA),59,66,1,-7,2015-01-05
Northwestern State,Sam Houston State,64,75,1,-11,2015-01-05
ETSU,Samford,76,74,0,2,2015-01-05
Texas Southern,Southern,59,58,0,1,2015-01-05
Bryant,St. Francis (NY),47,63,1,-16,2015-01-05
Southeastern Louisiana,Stephen F. Austin,66,81,1,-15,2015-01-05
Oklahoma,Texas,70,49,0,21,2015-01-05
West Virginia,Texas Tech,78,67,0,11,2015-01-05
Elon,Towson,53,57,1,-4,2015-01-05
Texas-Arlington,Troy,66,71,1,-5,2015-01-05
Mercer,VMI,85,75,0,10,2015-01-05
Mount St. Mary's,Wagner,83,85,1,-2,2015-01-05
Furman,Western Carolina,53,72,1,-19,2015-01-05
Western Michigan,Akron,52,72,1,-20,2015-01-06
Texas A&M,Alabama,44,65,1,-21,2015-01-06
Pitt,Boston College,61,60,0,1,2015-01-06
Providence,Butler,66,62,0,4,2015-01-06
Texas A&M-Corpus Christi,Central Arkansas,77,70,0,7,2015-01-06
East Carolina,Cincinnati,48,69,1,-21,2015-01-06
Stony Brook,Columbia,70,61,0,9,2015-01-06
Jacksonville,Florida A&M,79,56,0,23,2015-01-06
Virginia Tech,Florida State,75,86,1,-11,2015-01-06
Saint Louis,George Washington,72,75,1,-3,2015-01-06
Marquette,Georgetown,59,65,1,-6,2015-01-06
Arkansas,Georgia,79,75,0,4,2015-01-06
UCF,Houston,79,78,0,1,2015-01-06
Quinnipiac,Iona,73,81,1,-8,2015-01-06
Oklahoma State,Iowa State,61,63,1,-2,2015-01-06
Ole Miss,Kentucky,86,89,1,-3,2015-01-06
Ohio State,Minnesota,74,72,0,2,2015-01-06
USC Upstate,UMKC,61,49,0,12,2015-01-06
Albany (NY),New Hampshire,64,62,0,2,2015-01-06
New Mexico Highlands,New Mexico State,67,75,1,-8,2015-01-06
Trinity Baptist,North Florida,60,106,1,-46,2015-01-06
Michigan,Penn State,73,64,0,9,2015-01-06
Norfolk State,Princeton,61,71,1,-10,2015-01-06
Morgan State,Saint Mary's,52,78,1,-26,2015-01-06
New Mexico,San Diego State,42,56,1,-14,2015-01-06
Allen,Savannah State,49,67,1,-18,2015-01-06
UConn,South Florida,58,44,0,14,2015-01-06
Villanova,St. John's (NY),90,72,0,18,2015-01-06
Central Michigan,Toledo,65,62,0,3,2015-01-06
Auburn,Vanderbilt,52,64,1,-12,2015-01-06
San Jose State,Air Force,56,78,1,-22,2015-01-07
Lehigh,Army,71,60,0,11,2015-01-07
Kansas,Baylor,56,55,0,1,2015-01-07
SIU-Edwardsville,Belmont,69,73,1,-4,2015-01-07
Lafayette,Bucknell,69,79,1,-10,2015-01-07
Cal State Northridge,UC-Davis,61,71,1,-10,2015-01-07
Holy Cross,Colgate,60,74,1,-14,2015-01-07
Wyoming,Colorado State,60,54,0,6,2015-01-07
DePaul,Creighton,70,60,0,10,2015-01-07
St. Joseph's,Duquesne,68,71,1,-3,2015-01-07
Ball State,Eastern Michigan,60,59,0,1,2015-01-07
Loyola (IL),Evansville,71,70,0,1,2015-01-07
Utah State,Fresno State,52,61,1,-9,2015-01-07
Syracuse,Georgia Tech,46,45,0,1,2015-01-07
Binghamton,Hartford,59,69,1,-10,2015-01-07
Cal Poly,Hawaii,61,57,0,4,2015-01-07
Maryland,Illinois,57,64,1,-7,2015-01-07
Drake,Illinois State,45,81,1,-36,2015-01-07
Missouri State,Indiana State,56,71,1,-15,2015-01-07
TCU,Kansas State,53,58,1,-5,2015-01-07
Bowling Green State,Kent State,66,64,0,2,2015-01-07
UMass,La Salle,71,65,0,6,2015-01-07
Clemson,Louisville,52,58,1,-6,2015-01-07
American,Loyola (MD),53,56,1,-3,2015-01-07
Vermont,Maine,68,54,0,14,2015-01-07
St. Peter's,Manhattan,63,68,1,-5,2015-01-07
UMass-Lowell,UMBC,73,61,0,12,2015-01-07
Buffalo,Miami (OH),79,72,0,7,2015-01-07
Tennessee,Mississippi State,61,47,0,14,2015-01-07
Boston University,Navy,70,64,0,6,2015-01-07
Nevada,UNLV,64,62,0,2,2015-01-07
Maryland-Eastern Shore,NJIT,60,69,1,-9,2015-01-07
Southern Illinois,Northern Iowa,39,55,1,-16,2015-01-07
Northern Illinois,Ohio,70,60,0,10,2015-01-07
IUPUI,Oral Roberts,61,69,1,-8,2015-01-07
Fordham,Rhode Island,65,68,1,-3,2015-01-07
Florida,South Carolina,72,68,0,4,2015-01-07
Western Illinois,South Dakota State,44,75,1,-31,2015-01-07
California,USC,57,71,1,-14,2015-01-07
Eastern Illinois,Tennessee State,64,57,0,7,2015-01-07
Our Lady of the Lake,Texas-Rio Grande Valley,78,87,1,-9,2015-01-07
Temple,Tulane,64,56,0,8,2015-01-07
Colorado,Utah,49,74,1,-25,2015-01-07
NC State,Virginia,51,61,1,-10,2015-01-07
Davidson,VCU,65,71,1,-6,2015-01-07
Duke,Wake Forest,73,65,0,8,2015-01-07
Bradley,Wichita State,43,63,1,-20,2015-01-07
Purdue,Wisconsin,55,62,1,-7,2015-01-07
Seton Hall,Xavier,58,69,1,-11,2015-01-07
Florida Atlantic,Alabama-Birmingham,57,66,1,-9,2015-01-08
Georgia Southern,Arkansas State,73,61,0,12,2015-01-08
Pepperdine,BYU,67,61,0,6,2015-01-08
Saint Francis (PA),Bryant,54,80,1,-26,2015-01-08
Long Beach State,UC-Irvine,88,82,0,6,2015-01-08
Cal State Fullerton,UC-Riverside,78,84,1,-6,2015-01-08
Western Carolina,Chattanooga,60,66,1,-6,2015-01-08
Samford,Citadel,67,77,1,-10,2015-01-08
Oakland,Cleveland State,61,65,1,-4,2015-01-08
Longwood,Coastal Carolina,70,76,1,-6,2015-01-08
Hofstra,College of Charleston,71,66,0,5,2015-01-08
Howard,Cornell,60,70,1,-10,2015-01-08
Mercer,ETSU,70,71,1,-1,2015-01-08
William & Mary,Elon,79,85,1,-6,2015-01-08
St. Francis (NY),Fairleigh Dickinson,78,69,0,9,2015-01-08
UNC Greensboro,Furman,64,71,1,-7,2015-01-08
Radford,Gardner-Webb,85,88,1,-3,2015-01-08
San Francisco,Gonzaga,57,88,1,-31,2015-01-08
Charleston Southern,High Point,61,72,1,-11,2015-01-08
Montana State,Idaho State,61,70,1,-9,2015-01-08
Michigan State,Iowa,75,61,0,14,2015-01-08
Denver,Purdue-Fort Wayne,53,69,1,-16,2015-01-08
Austin Peay,Jacksonville State,59,71,1,-12,2015-01-08
Northeastern,James Madison,65,59,0,6,2015-01-08
Sacred Heart,LIU-Brooklyn,81,82,1,-1,2015-01-08
Georgia State,Louisiana,80,84,1,-4,2015-01-08
Canisius,Marist,67,52,0,15,2015-01-08
Old Dominion,Marshall,72,51,0,21,2015-01-08
Florida International,Middle Tennessee,52,65,1,-13,2015-01-08
LSU,Missouri,67,74,1,-7,2015-01-08
Central Connecticut,Mount St. Mary's,51,82,1,-31,2015-01-08
Rutgers,Nebraska,49,65,1,-16,2015-01-08
North Dakota State,Omaha,75,72,0,3,2015-01-08
Brown,New Hampshire,61,68,1,-7,2015-01-08
Liberty,UNC Asheville,54,71,1,-17,2015-01-08
Delaware,UNC Wilmington,73,74,1,-1,2015-01-08
Sacramento State,North Dakota,63,61,0,2,2015-01-08
Portland State,Northern Colorado,85,90,1,-5,2015-01-08
Arizona,Oregon,80,62,0,18,2015-01-08
Arizona State,Oregon State,47,55,1,-8,2015-01-08
Santa Clara,Portland,61,78,1,-17,2015-01-08
Winthrop,Presbyterian,57,56,0,1,2015-01-08
George Mason,Richmond,65,75,1,-10,2015-01-08
Loyola Marymount,San Diego,50,59,1,-9,2015-01-08
Niagara,Siena,69,79,1,-10,2015-01-08
Appalachian State,South Alabama,95,104,1,-9,2015-01-08
Morehead State,Southeast Missouri State,70,57,0,13,2015-01-08
Memphis,SMU,59,73,1,-14,2015-01-08
Dayton,St. Bonaventure,78,61,0,17,2015-01-08
Eastern Kentucky,UT-Martin,66,58,0,8,2015-01-08
Murray State,Tennessee Tech,83,67,0,16,2015-01-08
Louisiana-Monroe,Texas-Arlington,76,73,0,3,2015-01-08
Louisiana Tech,UTEP,58,45,0,13,2015-01-08
Southern Miss,UTSA,57,77,1,-20,2015-01-08
Little Rock,Texas State,74,77,1,-3,2015-01-08
Drexel,Towson,55,41,0,14,2015-01-08
Stanford,UCLA,81,86,1,-5,2015-01-08
UIC,Valparaiso,56,85,1,-29,2015-01-08
Robert Morris,Wagner,77,73,0,4,2015-01-08
Montana,Weber State,60,68,1,-8,2015-01-08
Charlotte,Western Kentucky,66,74,1,-8,2015-01-08
VMI,Wofford,70,75,1,-5,2015-01-08
Wright State,Youngstown State,70,61,0,9,2015-01-08
Green Bay,Milwaukee,79,63,0,16,2015-01-09
Quinnipiac,Monmouth,68,64,0,4,2015-01-09
Yale,NJIT,71,78,1,-7,2015-01-09
Akron,Toledo,67,84,1,-17,2015-01-09
Nicholls State,Abilene Christian,54,71,1,-17,2015-01-10
Colorado State,Air Force,92,87,0,5,2015-01-10
Florida International,Alabama-Birmingham,53,70,1,-17,2015-01-10
Colgate,American,69,71,1,-2,2015-01-10
Vanderbilt,Arkansas,70,82,1,-12,2015-01-10
Appalachian State,Little Rock,46,64,1,-18,2015-01-10
Alabama State,Arkansas-Pine Bluff,74,71,0,3,2015-01-10
Navy,Army,75,66,0,9,2015-01-10
Missouri,Auburn,79,85,1,-6,2015-01-10
Central Michigan,Ball State,65,83,1,-18,2015-01-10
Hampton,Bethune-Cookman,58,56,0,2,2015-01-10
Maine,Binghamton,46,65,1,-19,2015-01-10
Lafayette,Boston University,63,62,0,1,2015-01-10
Ohio,Bowling Green State,54,69,1,-15,2015-01-10
Evansville,Bradley,66,56,0,10,2015-01-10
Loyola Marymount,BYU,72,85,1,-13,2015-01-10
Fairleigh Dickinson,Bryant,60,73,1,-13,2015-01-10
Xavier,Butler,76,88,1,-12,2015-01-10
UCSB,Cal Poly,50,45,0,5,2015-01-10
Long Beach State,UC-Davis,67,73,1,-6,2015-01-10
UC-Riverside,UC-Irvine,55,69,1,-14,2015-01-10
Robert Morris,Central Connecticut,72,60,0,12,2015-01-10
Longwood,Charleston Southern,54,68,1,-14,2015-01-10
Delaware,College of Charleston,64,58,0,6,2015-01-10
Central Pennsylvania College,Columbia,63,112,1,-49,2015-01-10
Cincinnati,UConn,56,62,1,-6,2015-01-10
Alfred,Cornell,29,107,1,-78,2015-01-10
Seton Hall,Creighton,68,67,0,1,2015-01-10
Harvard,Dartmouth,57,46,0,11,2015-01-10
Saint Louis,Davidson,54,89,1,-35,2015-01-10
Morgan State,Delaware State,73,69,0,4,2015-01-10
Oakland,Detroit,54,74,1,-20,2015-01-10
Northern Iowa,Drake,64,40,0,24,2015-01-10
Rhode Island,Duquesne,61,60,0,1,2015-01-10
Chattanooga,ETSU,74,71,0,3,2015-01-10
Belmont,Eastern Illinois,73,84,1,-11,2015-01-10
Hofstra,Elon,79,61,0,18,2015-01-10
Mississippi State,Florida,47,72,1,-25,2015-01-10
Norfolk State,Florida A&M,75,51,0,24,2015-01-10
Stetson,Florida Gulf Coast,50,72,1,-22,2015-01-10
Dayton,Fordham,76,58,0,18,2015-01-10
VMI,Furman,83,73,0,10,2015-01-10
Winthrop,Gardner-Webb,64,65,1,-1,2015-01-10
Troy,Georgia State,72,77,1,-5,2015-01-10
Santa Clara,Gonzaga,57,79,1,-22,2015-01-10
Southern,Grambling,59,53,0,6,2015-01-10
Cal State Bakersfield,Grand Canyon,65,73,1,-8,2015-01-10
Cal State Northridge,Hawaii,68,83,1,-15,2015-01-10
Campbell,High Point,62,69,1,-7,2015-01-10
Bucknell,Holy Cross,62,65,1,-3,2015-01-10
Coppin State,Howard,69,71,1,-2,2015-01-10
Eastern Washington,Idaho,89,86,0,3,2015-01-10
Montana,Idaho State,90,64,0,26,2015-01-10
Ohio State,Indiana,66,69,1,-3,2015-01-10
Canisius,Iona,76,79,1,-3,2015-01-10
South Dakota,Purdue-Fort Wayne,64,62,0,2,2015-01-10
Denver,IUPUI,49,52,1,-3,2015-01-10
Alcorn State,Jackson State,54,64,1,-10,2015-01-10
North Florida,Jacksonville,86,63,0,23,2015-01-10
Texas Tech,Kansas,54,86,1,-32,2015-01-10
George Washington,La Salle,50,63,1,-13,2015-01-10
Central Arkansas,Lamar,65,84,1,-19,2015-01-10
Loyola (MD),Lehigh,65,60,0,5,2015-01-10
Coastal Carolina,Liberty,69,54,0,15,2015-01-10
Northern Kentucky,Lipscomb,61,80,1,-19,2015-01-10
Georgia,LSU,84,87,1,-3,2015-01-10
Niagara,Manhattan,75,84,1,-9,2015-01-10
Charlotte,Marshall,77,72,0,5,2015-01-10
Albany (NY),UMass-Lowell,64,51,0,13,2015-01-10
Citadel,Mercer,51,74,1,-23,2015-01-10
Boston College,Miami (FL),56,60,1,-4,2015-01-10
Eastern Michigan,Miami (OH),81,82,1,-1,2015-01-10
Minnesota,Michigan,57,62,1,-5,2015-01-10
Florida Atlantic,Middle Tennessee,58,82,1,-24,2015-01-10
South Carolina,Ole Miss,49,65,1,-16,2015-01-10
Alabama A&M,Mississippi Valley State,86,73,0,13,2015-01-10
St. Francis (NY),Mount St. Mary's,61,71,1,-10,2015-01-10
South Dakota State,Omaha,87,68,0,19,2015-01-10
Fresno State,Nevada,69,66,0,3,2015-01-10
San Jose State,UNLV,40,74,1,-34,2015-01-10
UMKC,New Mexico State,45,63,1,-18,2015-01-10
Sam Houston State,New Orleans,68,62,0,6,2015-01-10
Louisville,UNC,71,72,1,-1,2015-01-10
Savannah State,North Carolina A&T,47,68,1,-21,2015-01-10
South Carolina State,North Carolina Central,45,76,1,-31,2015-01-10
Drexel,UNC Wilmington,57,64,1,-7,2015-01-10
Portland State,North Dakota,82,75,0,7,2015-01-10
Southern Utah,Northern Arizona,67,70,1,-3,2015-01-10
Sacramento State,Northern Colorado,73,84,1,-11,2015-01-10
Kent State,Northern Illinois,67,65,0,2,2015-01-10
Incarnate Word,Northwestern State,101,103,1,-2,2015-01-10
Virginia,Notre Dame,62,56,0,6,2015-01-10
Kansas State,Oklahoma,66,63,0,3,2015-01-10
Texas,Oklahoma State,58,69,1,-11,2015-01-10
Arizona State,Oregon,56,59,1,-3,2015-01-10
Saint Mary's,Pacific,54,47,0,7,2015-01-10
Clemson,Pitt,71,62,0,9,2015-01-10
San Francisco,Portland,89,77,0,12,2015-01-10
Texas Southern,Prairie View,81,77,0,4,2015-01-10
Penn,Princeton,74,78,1,-4,2015-01-10
Georgetown,Providence,57,60,1,-3,2015-01-10
Maryland,Purdue,69,60,0,9,2015-01-10
Presbyterian,Radford,82,95,1,-13,2015-01-10
North Texas,Rice,66,63,0,3,2015-01-10
St. Peter's,Rider,55,68,1,-13,2015-01-10
Saint Francis (PA),Sacred Heart,77,68,0,9,2015-01-10
Pepperdine,San Diego,59,47,0,12,2015-01-10
Georgia Southern,South Alabama,81,73,0,8,2015-01-10
Kennesaw State,USC Upstate,65,68,1,-3,2015-01-10
Eastern Kentucky,Southeast Missouri State,68,55,0,13,2015-01-10
Houston Baptist,Southeastern Louisiana,67,87,1,-20,2015-01-10
Indiana State,Southern Illinois,59,56,0,3,2015-01-10
Tennessee State,SIU-Edwardsville,38,45,1,-7,2015-01-10
Tulsa,Temple,63,56,0,7,2015-01-10
Alabama,Tennessee,56,38,0,18,2015-01-10
Morehead State,UT-Martin,72,75,1,-3,2015-01-10
Austin Peay,Tennessee Tech,56,72,1,-16,2015-01-10
Kentucky,Texas A&M,70,64,0,6,2015-01-10
McNeese State,Texas A&M-Corpus Christi,61,71,1,-10,2015-01-10
Arkansas State,Texas-Arlington,50,77,1,-27,2015-01-10
Baylor,TCU,66,59,0,7,2015-01-10
Southern Miss,UTEP,40,74,1,-34,2015-01-10
Chicago State,Texas-Rio Grande Valley,59,64,1,-5,2015-01-10
Louisiana Tech,UTSA,84,72,0,12,2015-01-10
Louisiana-Monroe,Texas State,62,59,0,3,2015-01-10
Northeastern,Towson,52,49,0,3,2015-01-10
New Mexico,Utah State,66,60,0,6,2015-01-10
Seattle,Utah Valley,52,70,1,-18,2015-01-10
Cleveland State,Valparaiso,56,58,1,-2,2015-01-10
Stony Brook,Vermont,57,71,1,-14,2015-01-10
DePaul,Villanova,64,81,1,-17,2015-01-10
St. Joseph's,VCU,74,89,1,-15,2015-01-10
LIU-Brooklyn,Wagner,82,87,1,-5,2015-01-10
Georgia Tech,Wake Forest,69,76,1,-7,2015-01-10
Washington State,Washington,80,77,0,3,2015-01-10
Montana State,Weber State,62,65,1,-3,2015-01-10
Iowa State,West Virginia,74,72,0,2,2015-01-10
UNC Greensboro,Western Carolina,72,82,1,-10,2015-01-10
Oral Roberts,Western Illinois,66,57,0,9,2015-01-10
Old Dominion,Western Kentucky,65,72,1,-7,2015-01-10
Buffalo,Western Michigan,68,78,1,-10,2015-01-10
James Madison,William & Mary,73,81,1,-8,2015-01-10
Samford,Wofford,62,72,1,-10,2015-01-10
Boise State,Wyoming,54,65,1,-11,2015-01-10
Daniel Webster,Yale,47,102,1,-55,2015-01-10
SMU,UCF,70,61,0,9,2015-01-11
UMass,George Mason,66,62,0,4,2015-01-11
Youngstown State,Green Bay,67,82,1,-15,2015-01-11
Memphis,Houston,62,44,0,18,2015-01-11
Murray State,Jacksonville State,84,57,0,27,2015-01-11
Wichita State,Loyola (IL),67,53,0,14,2015-01-11
New Hampshire,UMBC,63,60,0,3,2015-01-11
Northwestern,Michigan State,77,84,1,-7,2015-01-11
Illinois State,Missouri State,69,55,0,14,2015-01-11
Illinois,Nebraska,43,53,1,-10,2015-01-11
Duke,NC State,75,87,1,-12,2015-01-11
Arizona,Oregon State,56,58,1,-2,2015-01-11
Marist,Quinnipiac,54,66,1,-12,2015-01-11
St. Bonaventure,Richmond,41,60,1,-19,2015-01-11
Wisconsin,Rutgers,62,67,1,-5,2015-01-11
Fairfield,Siena,79,67,0,12,2015-01-11
Stanford,USC,78,76,0,2,2015-01-11
Florida State,Syracuse,57,70,1,-13,2015-01-11
South Florida,Tulane,51,56,1,-5,2015-01-11
California,UCLA,54,73,1,-19,2015-01-11
Alabama A&M,Arkansas-Pine Bluff,51,48,0,3,2015-01-12
Norfolk State,Bethune-Cookman,79,55,0,24,2015-01-12
Lyndon State,Brown,42,88,1,-46,2015-01-12
Coastal Carolina,Campbell,70,67,0,3,2015-01-12
Hampton,Florida A&M,78,63,0,15,2015-01-12
Alcorn State,Grambling,72,70,0,2,2015-01-12
Delaware State,Howard,79,76,0,3,2015-01-12
New Orleans,Incarnate Word,66,97,1,-31,2015-01-12
Southern,Jackson State,60,52,0,8,2015-01-12
Alabama State,Mississippi Valley State,88,76,0,12,2015-01-12
Maryland-Eastern Shore,Morgan State,78,53,0,25,2015-01-12
South Carolina State,North Carolina A&T,52,50,0,2,2015-01-12
Savannah State,North Carolina Central,40,58,1,-18,2015-01-12
Monmouth,Rider,55,54,0,1,2015-01-12
Sam Houston State,Southeastern Louisiana,72,59,0,13,2015-01-12
Lamar,Texas A&M-Corpus Christi,66,64,0,2,2015-01-12
UTSA,Texas-Rio Grande Valley,68,43,0,25,2015-01-12
UNLV,Boise State,73,82,1,-9,2015-01-13
Northern Iowa,Bradley,63,52,0,11,2015-01-13
Stephen F. Austin,Central Arkansas,109,58,0,51,2015-01-13
Georgetown,DePaul,78,72,0,6,2015-01-13
Miami (FL),Duke,90,74,0,16,2015-01-13
Penn State,Indiana,73,76,1,-3,2015-01-13
Fairfield,Iona,58,74,1,-16,2015-01-13
Oklahoma State,Kansas,57,67,1,-10,2015-01-13
Missouri,Kentucky,37,86,1,-49,2015-01-13
USC Upstate,Lipscomb,58,60,1,-2,2015-01-13
Virginia Tech,Louisville,63,78,1,-15,2015-01-13
UMass-Lowell,Maine,62,59,0,3,2015-01-13
Iowa,Minnesota,77,75,0,2,2015-01-13
Montana Tech,Montana,44,86,1,-42,2015-01-13
Penn,Niagara,67,56,0,11,2015-01-13
Houston Baptist,Nicholls State,57,61,1,-4,2015-01-13
Abilene Christian,Northwestern State,95,81,0,14,2015-01-13
Michigan,Ohio State,52,71,1,-19,2015-01-13
VCU,Rhode Island,65,60,0,5,2015-01-13
St. Katherine,Santa Clara,63,77,1,-14,2015-01-13
Butler,Seton Hall,79,75,0,4,2015-01-13
Alabama,South Carolina,66,68,1,-2,2015-01-13
Wake Forest,Syracuse,83,86,1,-3,2015-01-13
Arkansas,Tennessee,69,74,1,-5,2015-01-13
Mississippi State,Texas A&M,70,74,1,-4,2015-01-13
UConn,Tulsa,58,66,1,-8,2015-01-13
Clemson,Virginia,42,65,1,-23,2015-01-13
Oklahoma,West Virginia,65,86,1,-21,2015-01-13
Bowling Green State,Akron,50,67,1,-17,2015-01-14
Binghamton,Albany (NY),58,73,1,-15,2015-01-14
Lehigh,American,59,62,1,-3,2015-01-14
Iowa State,Baylor,73,74,1,-1,2015-01-14
Harvard,Boston College,57,64,1,-7,2015-01-14
Navy,Bucknell,63,65,1,-2,2015-01-14
Northern Illinois,Buffalo,63,82,1,-19,2015-01-14
Stanford,California,69,59,0,10,2015-01-14
Tulane,UCF,100,103,1,-3,2015-01-14
Miami (OH),Central Michigan,77,105,1,-28,2015-01-14
Liberty,Charleston Southern,58,80,1,-22,2015-01-14
Boston University,Colgate,53,62,1,-9,2015-01-14
Nevada,Colorado State,42,98,1,-56,2015-01-14
La Salle,Dayton,50,61,1,-11,2015-01-14
Towson,Delaware,64,67,1,-3,2015-01-14
Western Illinois,Denver,54,68,1,-14,2015-01-14
Houston,East Carolina,61,66,1,-5,2015-01-14
College of Charleston,Elon,66,50,0,16,2015-01-14
High Point,Gardner-Webb,84,72,0,12,2015-01-14
St. Bonaventure,George Mason,75,55,0,20,2015-01-14
Notre Dame,Georgia Tech,62,59,0,3,2015-01-14
Army,Holy Cross,72,70,0,2,2015-01-14
Detroit,UIC,69,68,0,1,2015-01-14
Illinois State,Indiana State,70,71,1,-1,2015-01-14
Stetson,Jacksonville,69,71,1,-2,2015-01-14
Southeast Missouri State,Jacksonville State,69,52,0,17,2015-01-14
Texas Tech,Kansas State,51,58,1,-7,2015-01-14
Eastern Michigan,Kent State,59,65,1,-6,2015-01-14
Loyola (MD),Lafayette,65,69,1,-4,2015-01-14
Presbyterian,Longwood,71,67,0,4,2015-01-14
Drake,Loyola (IL),47,50,1,-3,2015-01-14
Creighton,Marquette,52,53,1,-1,2015-01-14
Rutgers,Maryland,65,73,1,-8,2015-01-14
Davidson,UMass,71,63,0,8,2015-01-14
Youngstown State,Milwaukee,62,77,1,-15,2015-01-14
LSU,Ole Miss,75,71,0,4,2015-01-14
Evansville,Missouri State,56,54,0,2,2015-01-14
St. Peter's,Monmouth,62,61,0,1,2015-01-14
Hartford,New Hampshire,68,67,0,1,2015-01-14
Air Force,New Mexico,48,60,1,-12,2015-01-14
St. Joseph's (NY),NJIT,60,79,1,-19,2015-01-14
Winthrop,UNC Asheville,84,69,0,15,2015-01-14
VMI,UNC Greensboro,63,75,1,-12,2015-01-14
UNC,NC State,81,79,0,2,2015-01-14
Florida Gulf Coast,North Florida,64,80,1,-16,2015-01-14
Hofstra,Northeastern,83,91,1,-8,2015-01-14
Kennesaw State,Northern Kentucky,72,76,1,-4,2015-01-14
Illinois,Northwestern,72,67,0,5,2015-01-14
Toledo,Ohio,80,73,0,7,2015-01-14
Omaha,Oral Roberts,86,102,1,-16,2015-01-14
Florida State,Pitt,64,73,1,-9,2015-01-14
St. John's (NY),Providence,83,70,0,13,2015-01-14
Fordham,St. Joseph's,55,66,1,-11,2015-01-14
Duquesne,Saint Louis,69,78,1,-9,2015-01-14
Fresno State,San Jose State,73,62,0,11,2015-01-14
North Dakota State,South Dakota,67,71,1,-4,2015-01-14
IUPUI,South Dakota State,53,68,1,-15,2015-01-14
UCLA,USC,83,66,0,17,2015-01-14
UMBC,Stony Brook,54,64,1,-10,2015-01-14
SMU,Temple,60,55,0,5,2015-01-14
Georgia,Vanderbilt,70,67,0,3,2015-01-14
Dartmouth,Vermont,52,55,1,-3,2015-01-14
Xavier,Villanova,75,88,1,-13,2015-01-14
Ball State,Western Michigan,93,95,1,-2,2015-01-14
Southern Illinois,Wichita State,55,67,1,-12,2015-01-14
UNC Wilmington,William & Mary,72,76,1,-4,2015-01-14
Cleveland State,Wright State,55,50,0,5,2015-01-14
San Diego State,Wyoming,60,52,0,8,2015-01-14
Arkansas State,Appalachian State,59,50,0,9,2015-01-15
Colorado,Arizona,54,68,1,-14,2015-01-15
Utah,Arizona State,76,59,0,17,2015-01-15
Tennessee State,Austin Peay,68,69,1,-1,2015-01-15
Wagner,Bryant,73,81,1,-8,2015-01-15
New Mexico State,Cal State Bakersfield,70,54,0,16,2015-01-15
UC-Irvine,Cal State Fullerton,63,58,0,5,2015-01-15
UC-Davis,UC-Riverside,74,61,0,13,2015-01-15
Cal State Northridge,UCSB,74,63,0,11,2015-01-15
Radford,Campbell,72,55,0,17,2015-01-15
LIU-Brooklyn,Central Connecticut,71,66,0,5,2015-01-15
North Texas,Charlotte,57,73,1,-16,2015-01-15
Wofford,Citadel,66,69,1,-3,2015-01-15
James Madison,Drexel,54,35,0,19,2015-01-15
Eastern Illinois,Eastern Kentucky,72,65,0,7,2015-01-15
Mount St. Mary's,Fairleigh Dickinson,71,51,0,20,2015-01-15
Auburn,Florida,55,75,1,-20,2015-01-15
Western Kentucky,Florida Atlantic,88,85,0,3,2015-01-15
Marshall,Florida International,62,66,1,-4,2015-01-15
Richmond,George Washington,70,73,1,-3,2015-01-15
Louisiana,Georgia Southern,70,78,1,-8,2015-01-15
Texas-Arlington,Georgia State,62,83,1,-21,2015-01-15
Cal Poly,Long Beach State,48,50,1,-2,2015-01-15
Troy,Louisiana-Monroe,54,63,1,-9,2015-01-15
Alabama-Birmingham,Louisiana Tech,71,74,1,-3,2015-01-15
Portland,Loyola Marymount,68,80,1,-12,2015-01-15
Cincinnati,Memphis,50,63,1,-13,2015-01-15
Furman,Mercer,64,67,1,-3,2015-01-15
SIU-Edwardsville,Morehead State,63,91,1,-28,2015-01-15
Belmont,Murray State,77,92,1,-15,2015-01-15
Weber State,Northern Arizona,74,65,0,9,2015-01-15
Green Bay,Oakland,66,69,1,-3,2015-01-15
Rice,Old Dominion,53,63,1,-10,2015-01-15
BYU,Pacific,93,80,0,13,2015-01-15
Gonzaga,Pepperdine,78,76,0,2,2015-01-15
Eastern Washington,Portland State,92,85,0,7,2015-01-15
Rider,Quinnipiac,56,53,0,3,2015-01-15
Idaho,Sacramento State,76,79,1,-3,2015-01-15
San Diego,Saint Mary's,58,70,1,-12,2015-01-15
Chattanooga,Samford,82,76,0,6,2015-01-15
Texas-Rio Grande Valley,Seattle,47,70,1,-23,2015-01-15
Middle Tennessee,Southern Miss,62,61,0,1,2015-01-15
Idaho State,Southern Utah,67,71,1,-4,2015-01-15
UT-Martin,Tennessee Tech,63,60,0,3,2015-01-15
South Alabama,Texas State,71,82,1,-11,2015-01-15
Grand Canyon,Utah Valley,83,74,0,9,2015-01-15
Oregon State,Washington,43,56,1,-13,2015-01-15
Oregon,Washington State,99,108,1,-9,2015-01-15
ETSU,Western Carolina,83,76,0,7,2015-01-15
Nebraska,Wisconsin,55,70,1,-15,2015-01-15
Siena,Canisius,49,83,1,-34,2015-01-16
Marist,Fairfield,54,60,1,-6,2015-01-16
Iona,Niagara,80,79,0,1,2015-01-16
Western Illinois,North Dakota State,48,61,1,-13,2015-01-16
St. Francis (NY),Robert Morris,68,63,0,5,2015-01-16
Sacred Heart,Saint Francis (PA),78,79,1,-1,2015-01-16
Manhattan,St. Peter's,72,65,0,7,2015-01-16
Stephen F. Austin,Abilene Christian,82,64,0,18,2015-01-17
Central Michigan,Akron,76,82,1,-6,2015-01-17
Kentucky,Alabama,70,48,0,22,2015-01-17
Alabama State,Alabama A&M,59,56,0,3,2015-01-17
Mississippi Valley State,Alcorn State,67,87,1,-20,2015-01-17
Georgia State,Appalachian State,69,74,1,-5,2015-01-17
Utah,Arizona,51,69,1,-18,2015-01-17
Colorado,Arizona State,72,78,1,-6,2015-01-17
Ole Miss,Arkansas,96,82,0,14,2015-01-17
Texas State,Arkansas State,73,78,1,-5,2015-01-17
South Carolina,Auburn,68,71,1,-3,2015-01-17
Belmont,Austin Peay,89,83,0,6,2015-01-17
New Hampshire,Binghamton,73,66,0,7,2015-01-17
Virginia,Boston College,66,51,0,15,2015-01-17
Ball State,Bowling Green State,46,58,1,-12,2015-01-17
Yale,Brown,80,62,0,18,2015-01-17
Army,Bucknell,75,81,1,-6,2015-01-17
Miami (OH),Buffalo,68,77,1,-9,2015-01-17
Texas-Rio Grande Valley,Cal State Bakersfield,53,66,1,-13,2015-01-17
UC-Davis,Cal State Fullerton,79,68,0,11,2015-01-17
Cal Poly,Cal State Northridge,48,55,1,-7,2015-01-17
Hawaii,UC-Riverside,62,66,1,-4,2015-01-17
UNC Asheville,Campbell,69,65,0,4,2015-01-17
Bryant,Central Connecticut,70,54,0,16,2015-01-17
Rice,Charlotte,73,68,0,5,2015-01-17
Temple,Cincinnati,53,84,1,-31,2015-01-17
Furman,Citadel,74,62,0,12,2015-01-17
Syracuse,Clemson,53,66,1,-13,2015-01-17
Gardner-Webb,Coastal Carolina,82,67,0,15,2015-01-17
Bethune-Cookman,Coppin State,58,53,0,5,2015-01-17
Columbia,Cornell,48,45,0,3,2015-01-17
Providence,Creighton,74,65,0,9,2015-01-17
NJIT,Dartmouth,53,62,1,-9,2015-01-17
Saint Louis,Dayton,45,61,1,-16,2015-01-17
Drexel,Delaware,66,62,0,4,2015-01-17
South Carolina State,Delaware State,49,60,1,-11,2015-01-17
Green Bay,Detroit,70,64,0,6,2015-01-17
Indiana State,Drake,78,84,1,-6,2015-01-17
VCU,Duquesne,70,64,0,6,2015-01-17
SIU-Edwardsville,Eastern Kentucky,62,78,1,-16,2015-01-17
Northern Illinois,Eastern Michigan,46,54,1,-8,2015-01-17
Wichita State,Evansville,61,41,0,20,2015-01-17
Wagner,Fairleigh Dickinson,82,68,0,14,2015-01-17
Marshall,Florida Atlantic,62,76,1,-14,2015-01-17
Jacksonville,Florida Gulf Coast,50,79,1,-29,2015-01-17
Western Kentucky,Florida International,65,58,0,7,2015-01-17
NC State,Florida State,72,63,0,9,2015-01-17
Wyoming,Fresno State,70,65,0,5,2015-01-17
George Mason,George Washington,53,63,1,-10,2015-01-17
Butler,Georgetown,59,61,1,-2,2015-01-17
Florida,Georgia,61,73,1,-12,2015-01-17
North Carolina A&T,Hampton,64,61,0,3,2015-01-17
UMass-Lowell,Hartford,62,68,1,-6,2015-01-17
UNC Wilmington,Hofstra,79,74,0,5,2015-01-17
Tulane,Houston,68,65,0,3,2015-01-17
New Orleans,Houston Baptist,73,74,1,-1,2015-01-17
Bradley,Illinois State,72,82,1,-10,2015-01-17
Southeastern Louisiana,Incarnate Word,108,98,0,10,2015-01-17
Ohio State,Iowa,67,76,1,-9,2015-01-17
Kansas,Iowa State,81,86,1,-5,2015-01-17
Elon,James Madison,72,75,1,-3,2015-01-17
Baylor,Kansas State,61,63,1,-2,2015-01-17
Lipscomb,Kennesaw State,91,77,0,14,2015-01-17
Ohio,Kent State,59,69,1,-10,2015-01-17
Fordham,La Salle,49,60,1,-11,2015-01-17
American,Lafayette,78,76,0,2,2015-01-17
Holy Cross,Lehigh,64,69,1,-5,2015-01-17
UCSB,Long Beach State,53,69,1,-16,2015-01-17
Mount St. Mary's,LIU-Brooklyn,61,54,0,7,2015-01-17
Liberty,Longwood,71,85,1,-14,2015-01-17
South Alabama,Louisiana,89,82,0,7,2015-01-17
Little Rock,Louisiana-Monroe,52,64,1,-12,2015-01-17
Texas A&M,LSU,67,64,0,3,2015-01-17
Middle Tennessee,Louisiana Tech,68,75,1,-7,2015-01-17
Duke,Louisville,63,52,0,11,2015-01-17
Gonzaga,Loyola Marymount,72,55,0,17,2015-01-17
Stony Brook,Maine,82,39,0,43,2015-01-17
Michigan State,Maryland,59,75,1,-16,2015-01-17
Vermont,UMBC,71,54,0,17,2015-01-17
Savannah State,Maryland-Eastern Shore,57,87,1,-30,2015-01-17
Rhode Island,UMass,56,60,1,-4,2015-01-17
UCF,Memphis,79,99,1,-20,2015-01-17
Samford,Mercer,56,80,1,-24,2015-01-17
Northwestern,Michigan,54,56,1,-2,2015-01-17
Rutgers,Minnesota,80,89,1,-9,2015-01-17
Vanderbilt,Mississippi State,54,57,1,-3,2015-01-17
Tennessee,Missouri,59,51,0,8,2015-01-17
Chicago State,UMKC,62,64,1,-2,2015-01-17
Montana State,Montana,48,63,1,-15,2015-01-17
Eastern Illinois,Morehead State,65,62,0,3,2015-01-17
Florida A&M,Morgan State,65,75,1,-10,2015-01-17
Tennessee State,Murray State,72,91,1,-19,2015-01-17
Colgate,Navy,65,53,0,12,2015-01-17
Texas A&M-Corpus Christi,Nicholls State,69,66,0,3,2015-01-17
North Carolina Central,Norfolk State,60,56,0,4,2015-01-17
Northern Colorado,North Dakota,88,78,0,10,2015-01-17
College of Charleston,Northeastern,67,69,1,-2,2015-01-17
Idaho State,Northern Arizona,69,72,1,-3,2015-01-17
Lamar,Northwestern State,84,96,1,-12,2015-01-17
Miami (FL),Notre Dame,70,75,1,-5,2015-01-17
Oklahoma State,Oklahoma,65,82,1,-17,2015-01-17
North Texas,Old Dominion,50,61,1,-11,2015-01-17
Purdue-Fort Wayne,Oral Roberts,58,62,1,-4,2015-01-17
San Diego,Pacific,57,59,1,-2,2015-01-17
Purdue,Penn State,84,77,0,7,2015-01-17
Villanova,Penn,62,47,0,15,2015-01-17
Portland,Pepperdine,63,67,1,-4,2015-01-17
Georgia Tech,Pitt,65,70,1,-5,2015-01-17
Idaho,Portland State,73,85,1,-12,2015-01-17
Jackson State,Prairie View,55,70,1,-15,2015-01-17
Charleston Southern,Presbyterian,73,65,0,8,2015-01-17
Davidson,Richmond,63,89,1,-26,2015-01-17
Eastern Washington,Sacramento State,77,90,1,-13,2015-01-17
BYU,Saint Mary's,77,82,1,-5,2015-01-17
McNeese State,Sam Houston State,60,69,1,-9,2015-01-17
UNLV,San Diego State,47,53,1,-6,2015-01-17
Colorado State,San Jose State,70,41,0,29,2015-01-17
San Francisco,Santa Clara,64,70,1,-6,2015-01-17
New Mexico State,Seattle,52,58,1,-6,2015-01-17
Northern Kentucky,USC Upstate,66,65,0,1,2015-01-17
South Dakota,South Dakota State,57,71,1,-14,2015-01-17
Tulsa,South Florida,75,58,0,17,2015-01-17
Tennessee Tech,Southeast Missouri State,61,65,1,-4,2015-01-17
Arkansas-Pine Bluff,Southern,60,70,1,-10,2015-01-17
East Carolina,SMU,54,77,1,-23,2015-01-17
Alabama-Birmingham,Southern Miss,63,56,0,7,2015-01-17
Weber State,Southern Utah,60,70,1,-10,2015-01-17
UConn,Stanford,59,72,1,-13,2015-01-17
North Florida,Stetson,80,65,0,15,2015-01-17
Jacksonville State,UT-Martin,52,55,1,-3,2015-01-17
West Virginia,Texas,50,77,1,-27,2015-01-17
UTEP,UTSA,73,55,0,18,2015-01-17
Grambling,Texas Southern,51,60,1,-9,2015-01-17
TCU,Texas Tech,62,42,0,20,2015-01-17
Western Michigan,Toledo,81,78,0,3,2015-01-17
William & Mary,Towson,85,72,0,13,2015-01-17
Georgia Southern,Troy,71,75,1,-4,2015-01-17
Air Force,Utah State,59,71,1,-12,2015-01-17
ETSU,VMI,79,85,1,-6,2015-01-17
Oregon State,Washington State,62,47,0,15,2015-01-17
Radford,Winthrop,85,77,0,8,2015-01-17
Western Carolina,Wofford,43,62,1,-19,2015-01-17
Valparaiso,Wright State,66,56,0,10,2015-01-17
Marquette,Xavier,58,62,1,-4,2015-01-17
Cleveland State,Youngstown State,74,61,0,13,2015-01-17
Iona,Canisius,74,78,1,-4,2015-01-18
St. John's (NY),DePaul,67,71,1,-4,2015-01-18
Indiana,Illinois,80,74,0,6,2015-01-18
Boston University,Loyola (MD),86,91,1,-5,2015-01-18
Rider,Manhattan,82,79,0,3,2015-01-18
Quinnipiac,Marist,72,71,0,1,2015-01-18
Fairfield,Monmouth,70,77,1,-7,2015-01-18
IUPUI,Omaha,89,84,0,5,2015-01-18
Boise State,New Mexico,69,59,0,10,2015-01-18
Siena,Niagara,74,70,0,4,2015-01-18
Virginia Tech,UNC,53,68,1,-15,2015-01-18
Missouri State,Northern Iowa,46,60,1,-14,2015-01-18
Albion,Oakland,68,83,1,-15,2015-01-18
Sacred Heart,Robert Morris,65,85,1,-20,2015-01-18
St. Francis (NY),Saint Francis (PA),60,59,0,1,2015-01-18
Loyola (IL),Southern Illinois,52,59,1,-7,2015-01-18
St. Joseph's,St. Bonaventure,61,70,1,-9,2015-01-18
Oregon,Washington,77,85,1,-8,2015-01-18
Arkansas-Pine Bluff,Alcorn State,54,49,0,5,2015-01-19
Georgia State,Arkansas State,60,54,0,6,2015-01-19
UNC Asheville,Charleston Southern,75,82,1,-7,2015-01-19
Florida State,Clemson,59,55,0,4,2015-01-19
Florida A&M,Coppin State,75,87,1,-12,2015-01-19
Savannah State,Delaware State,50,59,1,-9,2015-01-19
Pitt,Duke,65,79,1,-14,2015-01-19
Tusculum,ETSU,52,90,1,-38,2015-01-19
Villanova,Georgetown,58,78,1,-20,2015-01-19
North Carolina Central,Hampton,59,52,0,7,2015-01-19
Longwood,High Point,67,72,1,-5,2015-01-19
Central Arkansas,Houston Baptist,61,84,1,-23,2015-01-19
Oklahoma,Kansas,78,85,1,-7,2015-01-19
Southeastern Louisiana,Lamar,50,57,1,-7,2015-01-19
Louisiana-Monroe,Louisiana,57,55,0,2,2015-01-19
NJIT,Maine,65,55,0,10,2015-01-19
Hartford,UMBC,65,63,0,2,2015-01-19
South Carolina State,Maryland-Eastern Shore,73,72,0,1,2015-01-19
Bethune-Cookman,Morgan State,65,58,0,7,2015-01-19
UMass-Lowell,New Hampshire,64,67,1,-3,2015-01-19
North Carolina A&T,Norfolk State,60,74,1,-14,2015-01-19
Detroit,Northeastern,81,69,0,12,2015-01-19
Grambling,Prairie View,60,74,1,-14,2015-01-19
Little Rock,South Alabama,64,66,1,-2,2015-01-19
Mississippi Valley State,Southern,55,79,1,-24,2015-01-19
New Orleans,Stephen F. Austin,54,79,1,-25,2015-01-19
Albany (NY),Stony Brook,64,47,0,17,2015-01-19
Texas State,Texas-Arlington,55,66,1,-11,2015-01-19
Texas,TCU,66,48,0,18,2015-01-19
Jackson State,Texas Southern,54,67,1,-13,2015-01-19
Appalachian State,Troy,69,64,0,5,2015-01-19
Binghamton,Vermont,44,64,1,-20,2015-01-19
San Diego State,Air Force,77,45,0,32,2015-01-20
Harvard,Bryant,66,57,0,9,2015-01-20
Dayton,Davidson,60,77,1,-17,2015-01-20
Illinois State,Drake,64,56,0,8,2015-01-20
LSU,Florida,79,61,0,18,2015-01-20
Ole Miss,Georgia,64,69,1,-5,2015-01-20
UIC,Green Bay,55,78,1,-23,2015-01-20
Kansas State,Iowa State,71,77,1,-6,2015-01-20
Vanderbilt,Kentucky,57,65,1,-8,2015-01-20
Abilene Christian,McNeese State,56,63,1,-7,2015-01-20
Wright State,Milwaukee,41,67,1,-26,2015-01-20
Minnesota,Nebraska,49,52,1,-3,2015-01-20
Utah State,Nevada,70,54,0,16,2015-01-20
Sam Houston State,Nicholls State,62,39,0,23,2015-01-20
Michigan,Rutgers,54,50,0,4,2015-01-20
Tennessee,South Carolina,66,62,0,4,2015-01-20
Boston College,Syracuse,61,69,1,-8,2015-01-20
Northwestern State,Texas A&M-Corpus Christi,76,88,1,-12,2015-01-20
Iowa,Wisconsin,50,82,1,-32,2015-01-20
Valparaiso,Youngstown State,77,62,0,15,2015-01-20
Colgate,Army,63,65,1,-2,2015-01-21
Mississippi State,Auburn,78,71,0,7,2015-01-21
Ohio,Ball State,82,73,0,9,2015-01-21
Huston-Tillotson,Baylor,61,81,1,-20,2015-01-21
San Jose State,Boise State,36,86,1,-50,2015-01-21
American,Boston University,54,59,1,-5,2015-01-21
Eastern Michigan,Bowling Green State,58,74,1,-16,2015-01-21
Creighton,Butler,61,64,1,-3,2015-01-21
St. Francis (NY),Central Connecticut,63,51,0,12,2015-01-21
Buffalo,Central Michigan,73,84,1,-11,2015-01-21
Houston,Cincinnati,54,67,1,-13,2015-01-21
UNC Wilmington,College of Charleston,58,56,0,2,2015-01-21
William & Mary,Delaware,80,84,1,-4,2015-01-21
Oral Roberts,Denver,66,73,1,-7,2015-01-21
Drexel,Hofstra,58,86,1,-28,2015-01-21
Lafayette,Holy Cross,73,74,1,-1,2015-01-21
Purdue,Illinois,57,66,1,-9,2015-01-21
Toledo,Kent State,60,67,1,-7,2015-01-21
Navy,Lehigh,47,61,1,-14,2015-01-21
Evansville,Loyola (IL),65,56,0,9,2015-01-21
Bucknell,Loyola (MD),75,61,0,14,2015-01-21
Western Michigan,Miami (OH),69,58,0,11,2015-01-21
Penn State,Michigan State,60,66,1,-6,2015-01-21
Wichita State,Missouri State,76,53,0,23,2015-01-21
New Mexico,UNLV,71,69,0,2,2015-01-21
Akron,Northern Illinois,61,64,1,-3,2015-01-21
Indiana State,Northern Iowa,60,66,1,-6,2015-01-21
Texas Tech,Oklahoma State,43,63,1,-20,2015-01-21
Monmouth,Penn,71,56,0,15,2015-01-21
UMass,St. Joseph's,56,62,1,-6,2015-01-21
Quinnipiac,St. Peter's,63,55,0,8,2015-01-21
Purdue-Fort Wayne,South Dakota State,53,82,1,-29,2015-01-21
Bradley,Southern Illinois,59,70,1,-11,2015-01-21
Marquette,St. John's (NY),57,60,1,-3,2015-01-21
Missouri,Texas A&M,50,62,1,-12,2015-01-21
SMU,Tulane,66,52,0,14,2015-01-21
Memphis,Tulsa,55,73,1,-18,2015-01-21
Washington State,Utah,64,86,1,-22,2015-01-21
UNC,Wake Forest,87,71,0,16,2015-01-21
Charlotte,Alabama-Birmingham,76,81,1,-5,2015-01-22
South Alabama,Appalachian State,53,64,1,-11,2015-01-22
Alabama,Arkansas,91,93,1,-2,2015-01-22
Troy,Little Rock,65,73,1,-8,2015-01-22
UT-Martin,Belmont,67,72,1,-5,2015-01-22
LIU-Brooklyn,Bryant,69,74,1,-5,2015-01-22
Cal State Fullerton,Cal Poly,55,66,1,-11,2015-01-22
UC-Irvine,Cal State Northridge,80,49,0,31,2015-01-22
Arizona State,California,79,44,0,35,2015-01-22
UC-Riverside,UCSB,75,83,1,-8,2015-01-22
VMI,Chattanooga,64,86,1,-22,2015-01-22
Seattle,Chicago State,75,67,0,8,2015-01-22
Washington,Colorado,52,50,0,2,2015-01-22
UCF,UConn,60,67,1,-7,2015-01-22
St. Bonaventure,Duquesne,100,97,0,3,2015-01-22
Citadel,ETSU,59,70,1,-11,2015-01-22
Murray State,Eastern Illinois,77,62,0,15,2015-01-22
Northern Colorado,Eastern Washington,85,95,1,-10,2015-01-22
Towson,Elon,53,51,0,2,2015-01-22
Canisius,Fairfield,64,50,0,14,2015-01-22
George Washington,Fordham,79,59,0,20,2015-01-22
Longwood,Gardner-Webb,67,79,1,-12,2015-01-22
Saint Mary's,Gonzaga,47,68,1,-21,2015-01-22
Albany (NY),Hartford,62,53,0,9,2015-01-22
UC-Davis,Hawaii,76,84,1,-8,2015-01-22
North Dakota,Idaho,71,63,0,8,2015-01-22
Sacramento State,Idaho State,62,59,0,3,2015-01-22
Maryland,Indiana,70,89,1,-19,2015-01-22
North Dakota State,IUPUI,69,61,0,8,2015-01-22
Eastern Kentucky,Jacksonville State,67,71,1,-4,2015-01-22
Stetson,Kennesaw State,82,88,1,-6,2015-01-22
Winthrop,Liberty,71,56,0,15,2015-01-22
Jacksonville,Lipscomb,77,80,1,-3,2015-01-22
Arkansas State,Louisiana,59,96,1,-37,2015-01-22
Texas-Arlington,Louisiana-Monroe,61,57,0,4,2015-01-22
UMBC,Maine,76,59,0,17,2015-01-22
UTSA,Marshall,82,68,0,14,2015-01-22
Stony Brook,UMass-Lowell,65,45,0,20,2015-01-22
NC State,Miami (FL),60,65,1,-5,2015-01-22
Old Dominion,Middle Tennessee,58,68,1,-10,2015-01-22
Cal State Bakersfield,UMKC,63,66,1,-3,2015-01-22
Northern Arizona,Montana,57,64,1,-7,2015-01-22
Southern Utah,Montana State,65,79,1,-14,2015-01-22
Robert Morris,Mount St. Mary's,63,59,0,4,2015-01-22
Vermont,New Hampshire,68,73,1,-5,2015-01-22
Grand Canyon,New Mexico State,63,85,1,-22,2015-01-22
Coastal Carolina,UNC Asheville,65,75,1,-10,2015-01-22
Louisiana Tech,North Texas,66,73,1,-7,2015-01-22
James Madison,Northeastern,59,82,1,-23,2015-01-22
North Florida,Northern Kentucky,74,66,0,8,2015-01-22
Ohio State,Northwestern,69,67,0,2,2015-01-22
Milwaukee,Oakland,53,66,1,-13,2015-01-22
USC,Oregon,67,75,1,-8,2015-01-22
UCLA,Oregon State,55,66,1,-11,2015-01-22
Pacific,Portland,69,72,1,-3,2015-01-22
Campbell,Presbyterian,70,72,1,-2,2015-01-22
Xavier,Providence,66,69,1,-3,2015-01-22
High Point,Radford,66,73,1,-7,2015-01-22
La Salle,Rhode Island,47,59,1,-12,2015-01-22
Southern Miss,Rice,56,58,1,-2,2015-01-22
Iona,Rider,78,68,0,10,2015-01-22
Fairleigh Dickinson,Sacred Heart,77,78,1,-1,2015-01-22
UNC Greensboro,Samford,78,89,1,-11,2015-01-22
Pepperdine,San Francisco,59,71,1,-12,2015-01-22
Loyola Marymount,Santa Clara,62,65,1,-3,2015-01-22
DePaul,Seton Hall,64,60,0,4,2015-01-22
Florida Gulf Coast,USC Upstate,71,68,0,3,2015-01-22
Austin Peay,SIU-Edwardsville,65,69,1,-4,2015-01-22
Arizona,Stanford,89,82,0,7,2015-01-22
South Florida,Temple,48,73,1,-25,2015-01-22
Morehead State,Tennessee Tech,78,74,0,4,2015-01-22
Utah Valley,Texas-Rio Grande Valley,72,54,0,18,2015-01-22
Georgia Southern,Texas State,45,43,0,2,2015-01-22
Georgia Tech,Virginia,28,57,1,-29,2015-01-22
Notre Dame,Virginia Tech,85,60,0,25,2015-01-22
Saint Francis (PA),Wagner,58,63,1,-5,2015-01-22
Portland State,Weber State,69,63,0,6,2015-01-22
Mercer,Western Carolina,52,60,1,-8,2015-01-22
South Dakota,Western Illinois,68,58,0,10,2015-01-22
UTEP,Western Kentucky,66,71,1,-5,2015-01-22
Furman,Wofford,49,74,1,-25,2015-01-22
Detroit,Cleveland State,66,70,1,-4,2015-01-23
Valparaiso,Green Bay,50,51,1,-1,2015-01-23
Niagara,Monmouth,58,69,1,-11,2015-01-23
Manhattan,Quinnipiac,59,73,1,-14,2015-01-23
VCU,Saint Louis,63,61,0,2,2015-01-23
Marist,Siena,60,69,1,-9,2015-01-23
Incarnate Word,Abilene Christian,77,61,0,16,2015-01-24
Boise State,Air Force,77,68,0,9,2015-01-24
Auburn,Alabama,55,57,1,-2,2015-01-24
Southern,Alabama A&M,65,58,0,7,2015-01-24
Old Dominion,Alabama-Birmingham,68,81,1,-13,2015-01-24
Alcorn State,Alabama State,60,84,1,-24,2015-01-24
Texas-Arlington,Little Rock,75,68,0,7,2015-01-24
Texas Southern,Arkansas-Pine Bluff,62,66,1,-4,2015-01-24
Kent State,Ball State,63,52,0,11,2015-01-24
Oklahoma,Baylor,58,69,1,-11,2015-01-24
Maryland-Eastern Shore,Bethune-Cookman,74,70,0,4,2015-01-24
Bucknell,Boston University,92,77,0,15,2015-01-24
Missouri State,Bradley,59,61,1,-2,2015-01-24
Sacred Heart,Bryant,83,66,0,17,2015-01-24
UC-Riverside,Cal Poly,49,68,1,-19,2015-01-24
Long Beach State,Cal State Northridge,64,58,0,6,2015-01-24
Arizona,California,73,50,0,23,2015-01-24
Cal State Fullerton,UCSB,49,68,1,-19,2015-01-24
Nicholls State,Central Arkansas,71,61,0,10,2015-01-24
Wagner,Central Connecticut,50,53,1,-3,2015-01-24
Eastern Michigan,Central Michigan,51,65,1,-14,2015-01-24
Gardner-Webb,Charleston Southern,80,93,1,-13,2015-01-24
UNC Greensboro,Chattanooga,72,81,1,-9,2015-01-24
Cal State Bakersfield,Chicago State,57,41,0,16,2015-01-24
Wake Forest,Clemson,57,59,1,-2,2015-01-24
Presbyterian,Coastal Carolina,52,63,1,-11,2015-01-24
Loyola (MD),Colgate,58,59,1,-1,2015-01-24
Washington State,Colorado,58,90,1,-32,2015-01-24
San Diego State,Colorado State,73,79,1,-6,2015-01-24
Cornell,Columbia,57,47,0,10,2015-01-24
Richmond,Dayton,60,63,1,-3,2015-01-24
College of Charleston,Drexel,51,53,1,-2,2015-01-24
Tulsa,East Carolina,66,64,0,2,2015-01-24
Austin Peay,Eastern Illinois,56,52,0,4,2015-01-24
North Dakota,Eastern Washington,80,102,1,-22,2015-01-24
Delaware,Elon,82,94,1,-12,2015-01-24
Southern Illinois,Evansville,66,75,1,-9,2015-01-24
LIU-Brooklyn,Fairleigh Dickinson,80,76,0,4,2015-01-24
Howard,Florida A&M,59,50,0,9,2015-01-24
Nevada,Fresno State,62,66,1,-4,2015-01-24
Allen,Furman,46,82,1,-36,2015-01-24
Davidson,George Mason,80,73,0,7,2015-01-24
Duquesne,George Washington,59,74,1,-15,2015-01-24
Louisiana,Georgia State,64,75,1,-11,2015-01-24
Pacific,Gonzaga,60,91,1,-31,2015-01-24
Jackson State,Grambling,74,63,0,11,2015-01-24
Dartmouth,Harvard,70,61,0,9,2015-01-24
UC-Irvine,Hawaii,78,72,0,6,2015-01-24
UNC Asheville,High Point,51,72,1,-21,2015-01-24
James Madison,Hofstra,69,63,0,6,2015-01-24
Navy,Holy Cross,65,76,1,-11,2015-01-24
Lamar,Houston Baptist,77,79,1,-2,2015-01-24
Northern Colorado,Idaho,79,83,1,-4,2015-01-24
Portland State,Idaho State,76,80,1,-4,2015-01-24
Loyola (IL),Indiana State,61,72,1,-11,2015-01-24
North Dakota State,Purdue-Fort Wayne,71,77,1,-6,2015-01-24
South Dakota,IUPUI,50,65,1,-15,2015-01-24
Morehead State,Jacksonville State,66,63,0,3,2015-01-24
Oklahoma State,Kansas State,53,63,1,-10,2015-01-24
Florida Gulf Coast,Kennesaw State,54,48,0,6,2015-01-24
Lehigh,Lafayette,75,71,0,4,2015-01-24
North Florida,Lipscomb,75,66,0,9,2015-01-24
Georgia Southern,Louisiana-Monroe,57,53,0,4,2015-01-24
Georgetown,Marquette,95,85,0,10,2015-01-24
UTEP,Marshall,71,78,1,-7,2015-01-24
Tulane,Memphis,55,57,1,-2,2015-01-24
Wisconsin,Michigan,69,64,0,5,2015-01-24
Charlotte,Middle Tennessee,69,72,1,-3,2015-01-24
Illinois,Minnesota,71,79,1,-8,2015-01-24
Florida,Ole Miss,71,72,1,-1,2015-01-24
Georgia,Mississippi State,72,66,0,6,2015-01-24
Prairie View,Mississippi Valley State,72,65,0,7,2015-01-24
Arkansas,Missouri,61,60,0,1,2015-01-24
Seattle,UMKC,55,75,1,-20,2015-01-24
Southern Utah,Montana,56,58,1,-2,2015-01-24
Northern Arizona,Montana State,71,64,0,7,2015-01-24
Saint Francis (PA),Mount St. Mary's,40,52,1,-12,2015-01-24
Michigan State,Nebraska,77,79,1,-2,2015-01-24
Denver,Omaha,69,80,1,-11,2015-01-24
Utah State,UNLV,77,79,1,-2,2015-01-24
Utah Valley,New Mexico State,44,69,1,-25,2015-01-24
Texas A&M-Corpus Christi,New Orleans,71,67,0,4,2015-01-24
Florida State,UNC,74,78,1,-4,2015-01-24
Delaware State,North Carolina A&T,67,52,0,15,2015-01-24
Coppin State,North Carolina Central,77,79,1,-2,2015-01-24
Towson,UNC Wilmington,65,69,1,-4,2015-01-24
Southern Miss,North Texas,75,71,0,4,2015-01-24
Miami (OH),Northern Illinois,60,55,0,5,2015-01-24
Jacksonville,Northern Kentucky,59,81,1,-22,2015-01-24
McNeese State,Northwestern State,67,93,1,-26,2015-01-24
Buffalo,Ohio,61,63,1,-2,2015-01-24
South Dakota State,Oral Roberts,76,72,0,4,2015-01-24
UCLA,Oregon,64,82,1,-18,2015-01-24
USC,Oregon State,55,59,1,-4,2015-01-24
Rutgers,Penn State,51,79,1,-28,2015-01-24
Saint Mary's,Portland,74,64,0,10,2015-01-24
Iowa,Purdue,63,67,1,-4,2015-01-24
Liberty,Radford,76,84,1,-8,2015-01-24
Louisiana Tech,Rice,58,45,0,13,2015-01-24
Canisius,Rider,46,59,1,-13,2015-01-24
Penn,St. Joseph's,56,52,0,4,2015-01-24
Stephen F. Austin,Sam Houston State,79,68,0,11,2015-01-24
Western Carolina,Samford,72,78,1,-6,2015-01-24
BYU,San Diego,74,77,1,-3,2015-01-24
Loyola Marymount,San Francisco,70,69,0,1,2015-01-24
Pepperdine,Santa Clara,57,60,1,-3,2015-01-24
Hampton,Savannah State,66,68,1,-2,2015-01-24
Kentucky,South Carolina,58,43,0,15,2015-01-24
Norfolk State,South Carolina State,76,63,0,13,2015-01-24
Stetson,USC Upstate,67,91,1,-24,2015-01-24
Murray State,SIU-Edwardsville,60,54,0,6,2015-01-24
Houston,SMU,59,80,1,-21,2015-01-24
Robert Morris,St. Francis (NY),67,65,0,2,2015-01-24
Arizona State,Stanford,70,89,1,-19,2015-01-24
Miami (FL),Syracuse,66,62,0,4,2015-01-24
Texas A&M,Tennessee,67,61,0,6,2015-01-24
Southeast Missouri State,UT-Martin,53,70,1,-17,2015-01-24
Eastern Kentucky,Tennessee Tech,81,83,1,-2,2015-01-24
Kansas,Texas,75,62,0,13,2015-01-24
Grand Canyon,Texas-Rio Grande Valley,72,73,1,-1,2015-01-24
Appalachian State,Texas State,64,58,0,6,2015-01-24
Iowa State,Texas Tech,73,78,1,-5,2015-01-24
Bowling Green State,Toledo,67,71,1,-4,2015-01-24
Arkansas State,Troy,64,55,0,9,2015-01-24
LSU,Vanderbilt,79,75,0,4,2015-01-24
Citadel,VMI,75,85,1,-10,2015-01-24
Sacramento State,Weber State,78,71,0,7,2015-01-24
TCU,West Virginia,85,86,1,-1,2015-01-24
UTSA,Western Kentucky,74,83,1,-9,2015-01-24
Akron,Western Michigan,71,69,0,2,2015-01-24
Northeastern,William & Mary,62,78,1,-16,2015-01-24
Campbell,Winthrop,63,71,1,-8,2015-01-24
ETSU,Wofford,64,72,1,-8,2015-01-24
New Mexico,Wyoming,62,63,1,-1,2015-01-24
DePaul,Xavier,76,89,1,-13,2015-01-24
Brown,Yale,65,69,1,-4,2015-01-24
UIC,Youngstown State,64,77,1,-13,2015-01-24
UMBC,Albany (NY),55,69,1,-14,2015-01-25
Stony Brook,Binghamton,61,54,0,7,2015-01-25
Seton Hall,Butler,57,77,1,-20,2015-01-25
Cincinnati,UCF,56,46,0,10,2015-01-25
South Florida,UConn,53,66,1,-13,2015-01-25
Boston College,Georgia Tech,64,62,0,2,2015-01-25
Maine,Hartford,70,61,0,9,2015-01-25
Northern Iowa,Illinois State,54,53,0,1,2015-01-25
Niagara,Iona,64,87,1,-23,2015-01-25
Monmouth,Manhattan,64,71,1,-7,2015-01-25
Fairfield,Marist,67,73,1,-6,2015-01-25
Northwestern,Maryland,67,68,1,-1,2015-01-25
Vermont,UMass-Lowell,61,50,0,11,2015-01-25
Notre Dame,NC State,81,78,0,3,2015-01-25
Indiana,Ohio State,70,82,1,-12,2015-01-25
Louisville,Pitt,80,68,0,12,2015-01-25
Rowan,Princeton,48,96,1,-48,2015-01-25
St. Bonaventure,Rhode Island,48,53,1,-5,2015-01-25
St. Peter's,Siena,69,55,0,14,2015-01-25
NJIT,South Alabama,72,55,0,17,2015-01-25
Duke,St. John's (NY),77,68,0,9,2015-01-25
Belmont,Tennessee State,63,55,0,8,2015-01-25
Washington,Utah,56,77,1,-21,2015-01-25
Creighton,Villanova,50,71,1,-21,2015-01-25
Virginia,Virginia Tech,50,47,0,3,2015-01-25
Drake,Wichita State,40,74,1,-34,2015-01-25
Sam Houston State,Abilene Christian,80,63,0,17,2015-01-26
Alcorn State,Alabama A&M,66,78,1,-12,2015-01-26
Southern,Alabama State,59,63,1,-4,2015-01-26
Army,American,68,66,0,2,2015-01-26
Prairie View,Arkansas-Pine Bluff,68,105,1,-37,2015-01-26
Howard,Bethune-Cookman,45,42,0,3,2015-01-26
Gardner-Webb,Campbell,59,78,1,-19,2015-01-26
Wright State,Detroit,64,53,0,11,2015-01-26
Maryland-Eastern Shore,Florida A&M,72,65,0,7,2015-01-26
McNeese State,Incarnate Word,84,86,1,-2,2015-01-26
Texas,Iowa State,86,89,1,-3,2015-01-26
Stephen F. Austin,Lamar,82,65,0,17,2015-01-26
Texas Southern,Mississippi Valley State,85,84,0,1,2015-01-26
Central Arkansas,New Orleans,67,87,1,-20,2015-01-26
Syracuse,UNC,83,93,1,-10,2015-01-26
Coppin State,North Carolina A&T,84,71,0,13,2015-01-26
Delaware State,North Carolina Central,54,55,1,-1,2015-01-26
Nicholls State,Northwestern State,51,80,1,-29,2015-01-26
Cleveland State,Oakland,56,59,1,-3,2015-01-26
High Point,Presbyterian,63,54,0,9,2015-01-26
Norfolk State,Savannah State,70,54,0,16,2015-01-26
Hampton,South Carolina State,56,65,1,-9,2015-01-26
Texas A&M-Corpus Christi,Southeastern Louisiana,70,61,0,9,2015-01-26
Milwaukee,Valparaiso,48,73,1,-25,2015-01-26
Ball State,Akron,47,59,1,-12,2015-01-27
Florida,Alabama,52,50,0,2,2015-01-27
Tennessee,Arkansas,64,69,1,-5,2015-01-27
Texas A&M,Auburn,71,61,0,10,2015-01-27
Colorado State,Boise State,78,82,1,-4,2015-01-27
Northern Illinois,Bowling Green State,46,56,1,-10,2015-01-27
Western Michigan,Buffalo,71,77,1,-6,2015-01-27
San Diego Christian,Cal State Bakersfield,54,79,1,-25,2015-01-27
Ohio,Eastern Michigan,40,76,1,-36,2015-01-27
Indiana State,Evansville,78,89,1,-11,2015-01-27
Xavier,Georgetown,66,53,0,13,2015-01-27
Vanderbilt,Georgia,62,70,1,-8,2015-01-27
West Virginia,Kansas State,65,59,0,6,2015-01-27
Central Michigan,Kent State,53,63,1,-10,2015-01-27
St. Joseph's,La Salle,48,53,1,-5,2015-01-27
Nebraska,Michigan,44,58,1,-14,2015-01-27
UNLV,Nevada,67,62,0,5,2015-01-27
Baylor,Oklahoma State,53,64,1,-11,2015-01-27
Tabor College,Oral Roberts,53,94,1,-41,2015-01-27
Fresno State,San Diego State,47,58,1,-11,2015-01-27
Miami (OH),Toledo,65,70,1,-5,2015-01-27
Tulsa,Tulane,62,55,0,7,2015-01-27
Wyoming,Utah State,44,56,1,-12,2015-01-27
George Washington,VCU,48,72,1,-24,2015-01-27
Pitt,Virginia Tech,67,70,1,-3,2015-01-27
Oregon,Arizona,56,90,1,-34,2015-01-28
Oregon State,Arizona State,55,73,1,-18,2015-01-28
Morehead State,Austin Peay,82,69,0,13,2015-01-28
Louisville,Boston College,81,72,0,9,2015-01-28
Drake,Bradley,69,57,0,12,2015-01-28
Lehigh,Bucknell,62,68,1,-6,2015-01-28
Temple,UCF,86,62,0,24,2015-01-28
Radford,Charleston Southern,84,77,0,7,2015-01-28
Winthrop,Coastal Carolina,75,68,0,7,2015-01-28
Lafayette,Colgate,59,54,0,5,2015-01-28
St. John's (NY),Creighton,74,77,1,-3,2015-01-28
Northeastern,Drexel,60,65,1,-5,2015-01-28
Wake Forest,Florida State,76,82,1,-6,2015-01-28
Rhode Island,Fordham,64,63,0,1,2015-01-28
Rice,Houston,48,59,1,-11,2015-01-28
Missouri State,Illinois State,57,67,1,-10,2015-01-28
Delaware,James Madison,82,88,1,-6,2015-01-28
UNC Asheville,Longwood,74,64,0,10,2015-01-28
South Carolina,LSU,58,64,1,-6,2015-01-28
New Hampshire,Maine,63,58,0,5,2015-01-28
Seton Hall,Marquette,80,70,0,10,2015-01-28
Binghamton,UMBC,68,56,0,12,2015-01-28
East Carolina,Memphis,58,70,1,-12,2015-01-28
Georgia Tech,Miami (FL),70,50,0,20,2015-01-28
Mississippi State,Ole Miss,73,79,1,-6,2015-01-28
American,Navy,54,64,1,-10,2015-01-28
Clemson,NC State,68,57,0,11,2015-01-28
Elon,UNC Wilmington,65,82,1,-17,2015-01-28
Duke,Notre Dame,73,77,1,-4,2015-01-28
Wright State,Oakland,76,84,1,-8,2015-01-28
Texas Tech,Oklahoma,36,81,1,-45,2015-01-28
Minnesota,Penn State,58,63,1,-5,2015-01-28
Indiana,Purdue,67,83,1,-16,2015-01-28
Duquesne,Richmond,55,86,1,-31,2015-01-28
Air Force,San Jose State,66,52,0,14,2015-01-28
Omaha,South Dakota State,64,86,1,-22,2015-01-28
SMU,South Florida,63,52,0,11,2015-01-28
Northern Iowa,Southern Illinois,59,52,0,7,2015-01-28
Hartford,Stony Brook,66,72,1,-6,2015-01-28
Kansas,TCU,64,61,0,3,2015-01-28
Albany (NY),Vermont,47,44,0,3,2015-01-28
Stanford,Washington,84,74,0,10,2015-01-28
Loyola (IL),Wichita State,47,58,1,-11,2015-01-28
Hofstra,William & Mary,79,100,1,-21,2015-01-28
Little Rock,Arkansas State,75,65,0,10,2015-01-29
Boston University,Army,67,71,1,-4,2015-01-29
Jacksonville State,Belmont,82,103,1,-21,2015-01-29
San Francisco,BYU,74,78,1,-4,2015-01-29
Long Beach State,Cal State Fullerton,91,85,0,6,2015-01-29
Hawaii,Cal State Northridge,84,73,0,11,2015-01-29
UCSB,UC-Davis,64,70,1,-6,2015-01-29
Cal Poly,UC-Irvine,57,67,1,-10,2015-01-29
Florida Atlantic,Charlotte,61,86,1,-25,2015-01-29
UConn,Cincinnati,58,70,1,-12,2015-01-29
Youngstown State,Detroit,87,93,1,-6,2015-01-29
Lipscomb,Florida Gulf Coast,62,78,1,-16,2015-01-29
ETSU,Furman,55,59,1,-4,2015-01-29
Saint Louis,George Mason,60,68,1,-8,2015-01-29
Appalachian State,Georgia Southern,46,83,1,-37,2015-01-29
Portland,Gonzaga,46,64,1,-18,2015-01-29
UMKC,Grand Canyon,57,78,1,-21,2015-01-29
USC Upstate,Jacksonville,78,65,0,13,2015-01-29
High Point,Liberty,72,53,0,19,2015-01-29
Central Connecticut,LIU-Brooklyn,55,67,1,-12,2015-01-29
Western Kentucky,Louisiana Tech,56,69,1,-13,2015-01-29
Holy Cross,Loyola (MD),54,64,1,-10,2015-01-29
Dayton,UMass,64,66,1,-2,2015-01-29
Chattanooga,Mercer,72,75,1,-3,2015-01-29
UIC,Milwaukee,65,71,1,-6,2015-01-29
Kentucky,Missouri,69,53,0,16,2015-01-29
Eastern Kentucky,Murray State,78,85,1,-7,2015-01-29
Wofford,UNC Greensboro,58,42,0,16,2015-01-29
Weber State,North Dakota,67,60,0,7,2015-01-29
Denver,North Dakota State,54,61,1,-7,2015-01-29
Kennesaw State,North Florida,67,86,1,-19,2015-01-29
Idaho State,Northern Colorado,76,79,1,-3,2015-01-29
Maryland,Ohio State,56,80,1,-24,2015-01-29
Florida International,Old Dominion,56,71,1,-15,2015-01-29
Pepperdine,Pacific,50,43,0,7,2015-01-29
Montana,Portland State,73,54,0,19,2015-01-29
DePaul,Providence,72,83,1,-11,2015-01-29
Fairleigh Dickinson,Robert Morris,65,87,1,-22,2015-01-29
Michigan State,Rutgers,71,51,0,20,2015-01-29
Montana State,Sacramento State,59,75,1,-16,2015-01-29
Bryant,Saint Francis (PA),68,75,1,-7,2015-01-29
Loyola Marymount,Saint Mary's,54,68,1,-14,2015-01-29
Rider,St. Peter's,58,49,0,9,2015-01-29
Santa Clara,San Diego,64,69,1,-5,2015-01-29
Louisiana,South Alabama,85,89,1,-4,2015-01-29
Purdue-Fort Wayne,South Dakota,66,55,0,11,2015-01-29
SIU-Edwardsville,Southeast Missouri State,75,61,0,14,2015-01-29
Colorado,USC,98,94,0,4,2015-01-29
Marshall,Southern Miss,69,54,0,15,2015-01-29
Mount St. Mary's,St. Francis (NY),67,73,1,-6,2015-01-29
Northern Kentucky,Stetson,75,85,1,-10,2015-01-29
Eastern Illinois,UT-Martin,51,81,1,-30,2015-01-29
Tennessee Tech,Tennessee State,56,64,1,-8,2015-01-29
Georgia State,Texas-Arlington,88,74,0,14,2015-01-29
Alabama-Birmingham,UTEP,69,71,1,-2,2015-01-29
Middle Tennessee,UTSA,58,69,1,-11,2015-01-29
College of Charleston,Towson,70,74,1,-4,2015-01-29
Louisiana-Monroe,Troy,58,55,0,3,2015-01-29
Utah,UCLA,59,69,1,-10,2015-01-29
Chicago State,Utah Valley,62,78,1,-16,2015-01-29
Western Carolina,VMI,85,70,0,15,2015-01-29
Sacred Heart,Wagner,64,75,1,-11,2015-01-29
California,Washington State,76,67,0,9,2015-01-29
Oregon State,Arizona,34,57,1,-23,2015-01-30
Oregon,Arizona State,68,67,0,1,2015-01-30
Kent State,Buffalo,55,80,1,-25,2015-01-30
Quinnipiac,Canisius,57,63,1,-6,2015-01-30
Yale,Columbia,63,59,0,4,2015-01-30
Brown,Cornell,49,57,1,-8,2015-01-30
Monmouth,Fairfield,60,59,0,1,2015-01-30
Siena,Manhattan,79,87,1,-8,2015-01-30
Marist,Niagara,65,61,0,4,2015-01-30
Dartmouth,Penn,51,58,1,-7,2015-01-30
Harvard,Princeton,75,72,0,3,2015-01-30
IUPUI,Western Illinois,59,63,1,-4,2015-01-30
Southern,Alcorn State,65,56,0,9,2015-01-31
Loyola (MD),Army,77,71,0,6,2015-01-31
Southeast Missouri State,Austin Peay,70,64,0,6,2015-01-31
Texas,Baylor,60,83,1,-23,2015-01-31
Tennessee Tech,Belmont,53,71,1,-18,2015-01-31
UMass-Lowell,Binghamton,69,76,1,-7,2015-01-31
Akron,Bowling Green State,69,68,0,1,2015-01-31
Santa Clara,BYU,57,78,1,-21,2015-01-31
Colgate,Bucknell,71,69,0,2,2015-01-31
Seattle,Cal State Bakersfield,61,71,1,-10,2015-01-31
Cal Poly,UC-Davis,78,81,1,-3,2015-01-31
UCSB,UC-Irvine,55,77,1,-22,2015-01-31
Cal State Northridge,UC-Riverside,62,66,1,-4,2015-01-31
Ohio,Central Michigan,69,74,1,-5,2015-01-31
Florida International,Charlotte,78,70,0,8,2015-01-31
Citadel,Chattanooga,73,78,1,-5,2015-01-31
Boston College,Clemson,49,64,1,-15,2015-01-31
Green Bay,Cleveland State,62,76,1,-14,2015-01-31
Fresno State,Colorado State,57,80,1,-23,2015-01-31
Brown,Columbia,65,86,1,-21,2015-01-31
Yale,Cornell,65,57,0,8,2015-01-31
Georgetown,Creighton,67,40,0,27,2015-01-31
College of Charleston,Delaware,68,71,1,-3,2015-01-31
Villanova,DePaul,68,55,0,13,2015-01-31
Evansville,Drake,65,70,1,-5,2015-01-31
UNC Wilmington,Drexel,76,85,1,-9,2015-01-31
George Mason,Duquesne,53,62,1,-9,2015-01-31
North Carolina Central,ETSU,59,61,1,-2,2015-01-31
SIU-Edwardsville,Eastern Illinois,54,57,1,-3,2015-01-31
Western Michigan,Eastern Michigan,63,69,1,-6,2015-01-31
Idaho,Eastern Washington,95,98,1,-3,2015-01-31
Arkansas,Florida,56,57,1,-1,2015-01-31
Bethune-Cookman,Florida A&M,61,44,0,17,2015-01-31
Northern Kentucky,Florida Gulf Coast,64,74,1,-10,2015-01-31
Coastal Carolina,Gardner-Webb,64,66,1,-2,2015-01-31
Little Rock,Georgia Southern,61,76,1,-15,2015-01-31
Arkansas State,Georgia State,43,74,1,-31,2015-01-31
NC State,Georgia Tech,81,80,0,1,2015-01-31
Memphis,Gonzaga,64,82,1,-18,2015-01-31
Arkansas-Pine Bluff,Grambling,65,53,0,12,2015-01-31
Chicago State,Grand Canyon,56,55,0,1,2015-01-31
Vermont,Hartford,65,46,0,19,2015-01-31
Towson,Hofstra,86,72,0,14,2015-01-31
Morgan State,Howard,48,64,1,-16,2015-01-31
Penn State,Illinois,58,60,1,-2,2015-01-31
Valparaiso,UIC,70,65,0,5,2015-01-31
Rutgers,Indiana,64,72,1,-8,2015-01-31
Bradley,Indiana State,58,64,1,-6,2015-01-31
St. Peter's,Iona,61,68,1,-7,2015-01-31
Wisconsin,Iowa,74,63,0,11,2015-01-31
TCU,Iowa State,66,83,1,-17,2015-01-31
Kennesaw State,Jacksonville,51,50,0,1,2015-01-31
William & Mary,James Madison,84,65,0,19,2015-01-31
Kansas State,Kansas,57,68,1,-11,2015-01-31
Alabama,Kentucky,55,70,1,-15,2015-01-31
Abilene Christian,Lamar,74,84,1,-10,2015-01-31
Boston University,Lehigh,86,89,1,-3,2015-01-31
Charleston Southern,Liberty,74,62,0,12,2015-01-31
Hawaii,Long Beach State,50,65,1,-15,2015-01-31
South Alabama,Louisiana-Monroe,61,67,1,-6,2015-01-31
Marshall,Louisiana Tech,57,81,1,-24,2015-01-31
UNC,Louisville,68,78,1,-10,2015-01-31
Illinois State,Loyola (IL),48,45,0,3,2015-01-31
Albany (NY),Maine,77,59,0,18,2015-01-31
Butler,Marquette,72,68,0,4,2015-01-31
Coppin State,Maryland-Eastern Shore,82,92,1,-10,2015-01-31
New Orleans,McNeese State,61,68,1,-7,2015-01-31
Ball State,Miami (OH),73,79,1,-6,2015-01-31
Detroit,Milwaukee,74,78,1,-4,2015-01-31
Nebraska,Minnesota,42,60,1,-18,2015-01-31
LSU,Mississippi State,67,73,1,-6,2015-01-31
Jackson State,Mississippi Valley State,62,75,1,-13,2015-01-31
Ole Miss,Missouri,67,47,0,20,2015-01-31
Southern Illinois,Missouri State,46,52,1,-6,2015-01-31
Eastern Kentucky,Morehead State,66,57,0,9,2015-01-31
UT-Martin,Murray State,62,65,1,-3,2015-01-31
Lafayette,Navy,74,65,0,9,2015-01-31
Purdue-Fort Wayne,Omaha,75,65,0,10,2015-01-31
Air Force,UNLV,63,74,1,-11,2015-01-31
Stony Brook,New Hampshire,48,63,1,-15,2015-01-31
San Jose State,New Mexico,41,67,1,-26,2015-01-31
Texas-Rio Grande Valley,New Mexico State,48,53,1,-5,2015-01-31
Incarnate Word,Nicholls State,69,58,0,11,2015-01-31
Hampton,Norfolk State,60,63,1,-3,2015-01-31
Campbell,UNC Asheville,63,70,1,-7,2015-01-31
Western Carolina,UNC Greensboro,78,73,0,5,2015-01-31
Idaho State,North Dakota,69,80,1,-11,2015-01-31
USC Upstate,North Florida,79,74,0,5,2015-01-31
Rice,North Texas,65,75,1,-10,2015-01-31
Elon,Northeastern,61,80,1,-19,2015-01-31
Weber State,Northern Colorado,57,71,1,-14,2015-01-31
Toledo,Northern Illinois,80,69,0,11,2015-01-31
Wichita State,Northern Iowa,54,70,1,-16,2015-01-31
Purdue,Northwestern,68,60,0,8,2015-01-31
Oklahoma,Oklahoma State,64,56,0,8,2015-01-31
Florida Atlantic,Old Dominion,57,68,1,-11,2015-01-31
Loyola Marymount,Pacific,76,71,0,5,2015-01-31
Harvard,Penn,63,38,0,25,2015-01-31
Notre Dame,Pitt,72,76,1,-4,2015-01-31
Montana State,Portland State,62,80,1,-18,2015-01-31
Alabama A&M,Prairie View,63,89,1,-26,2015-01-31
Longwood,Presbyterian,71,67,0,4,2015-01-31
Dartmouth,Princeton,53,64,1,-11,2015-01-31
Winthrop,Radford,66,73,1,-7,2015-01-31
George Washington,Rhode Island,55,59,1,-4,2015-01-31
Bryant,Robert Morris,71,68,0,3,2015-01-31
Montana,Sacramento State,69,70,1,-1,2015-01-31
Mount St. Mary's,Sacred Heart,77,71,0,6,2015-01-31
Fairleigh Dickinson,Saint Francis (PA),63,68,1,-5,2015-01-31
Davidson,St. Joseph's,70,75,1,-5,2015-01-31
UMass,Saint Louis,60,56,0,4,2015-01-31
Pepperdine,Saint Mary's,67,62,0,5,2015-01-31
Houston Baptist,Sam Houston State,52,63,1,-11,2015-01-31
Furman,Samford,58,68,1,-10,2015-01-31
San Francisco,San Diego,69,77,1,-8,2015-01-31
Utah State,San Diego State,42,62,1,-20,2015-01-31
North Carolina A&T,Savannah State,62,59,0,3,2015-01-31
Xavier,Seton Hall,82,90,1,-8,2015-01-31
Georgia,South Carolina,50,67,1,-17,2015-01-31
Delaware State,South Carolina State,74,78,1,-4,2015-01-31
Oral Roberts,South Dakota,73,72,0,1,2015-01-31
Denver,South Dakota State,39,69,1,-30,2015-01-31
Northwestern State,Southeastern Louisiana,88,73,0,15,2015-01-31
UCF,SMU,56,75,1,-19,2015-01-31
Western Kentucky,Southern Miss,73,62,0,11,2015-01-31
Northern Arizona,Southern Utah,81,60,0,21,2015-01-31
La Salle,St. Bonaventure,66,56,0,10,2015-01-31
LIU-Brooklyn,St. Francis (NY),64,81,1,-17,2015-01-31
Providence,St. John's (NY),66,75,1,-9,2015-01-31
Texas A&M-Corpus Christi,Stephen F. Austin,51,61,1,-10,2015-01-31
Lipscomb,Stetson,73,75,1,-2,2015-01-31
Tulane,Temple,37,55,1,-18,2015-01-31
Auburn,Tennessee,63,71,1,-8,2015-01-31
Jacksonville State,Tennessee State,43,45,1,-2,2015-01-31
Vanderbilt,Texas A&M,58,69,1,-11,2015-01-31
Troy,Texas-Arlington,55,54,0,1,2015-01-31
Middle Tennessee,UTEP,70,83,1,-13,2015-01-31
Alabama-Birmingham,UTSA,65,57,0,8,2015-01-31
Alabama State,Texas Southern,65,80,1,-15,2015-01-31
Louisiana,Texas State,72,63,0,9,2015-01-31
South Florida,Tulsa,71,78,1,-7,2015-01-31
Colorado,UCLA,59,72,1,-13,2015-01-31
UMKC,Utah Valley,66,59,0,7,2015-01-31
Duke,Virginia,69,63,0,6,2015-01-31
Richmond,VCU,64,55,0,9,2015-01-31
Central Connecticut,Wagner,55,86,1,-31,2015-01-31
Virginia Tech,Wake Forest,70,73,1,-3,2015-01-31
Stanford,Washington State,88,89,1,-1,2015-01-31
Texas Tech,West Virginia,58,77,1,-19,2015-01-31
Mercer,Wofford,46,49,1,-3,2015-01-31
Nevada,Wyoming,55,63,1,-8,2015-01-31
Marist,Canisius,75,67,0,8,2015-02-01
Fordham,Dayton,77,101,1,-24,2015-02-01
Cincinnati,East Carolina,46,50,1,-4,2015-02-01
Miami (FL),Florida State,54,55,1,-1,2015-02-01
UConn,Houston,68,70,1,-2,2015-02-01
Michigan,Michigan State,66,76,1,-10,2015-02-01
Manhattan,Monmouth,87,76,0,11,2015-02-01
Quinnipiac,Niagara,100,105,1,-5,2015-02-01
Utah,USC,67,39,0,28,2015-02-01
California,Washington,90,88,0,2,2015-02-01
North Dakota State,Western Illinois,64,62,0,2,2015-02-01
Oakland,Youngstown State,96,80,0,16,2015-02-01
Morgan State,Coppin State,67,80,1,-13,2015-02-02
Mississippi Valley State,Grambling,68,65,0,3,2015-02-02
American,Holy Cross,57,50,0,7,2015-02-02
Abilene Christian,Houston Baptist,61,77,1,-16,2015-02-02
Maryland-Eastern Shore,Howard,74,83,1,-9,2015-02-02
Arkansas-Pine Bluff,Jackson State,45,69,1,-24,2015-02-02
Iowa State,Kansas,76,89,1,-13,2015-02-02
New Orleans,Nicholls State,55,67,1,-12,2015-02-02
Hampton,NJIT,67,86,1,-19,2015-02-02
Virginia,UNC,75,64,0,11,2015-02-02
Florida A&M,North Carolina Central,43,85,1,-42,2015-02-02
Bryant,Pitt,67,72,1,-5,2015-02-02
Alabama State,Prairie View,73,71,0,2,2015-02-02
Lamar,Sam Houston State,50,79,1,-29,2015-02-02
Rider,Siena,72,79,1,-7,2015-02-02
McNeese State,Southeastern Louisiana,73,60,0,13,2015-02-02
Alabama A&M,Texas Southern,65,68,1,-3,2015-02-02
Charleston Southern,Winthrop,55,77,1,-22,2015-02-02
Green Bay,Wright State,71,58,0,13,2015-02-02
South Carolina,Arkansas,55,75,1,-20,2015-02-03
Stetson,Bethune-Cookman,77,72,0,5,2015-02-03
Hartford,Binghamton,62,61,0,1,2015-02-03
St. John's (NY),Butler,62,85,1,-23,2015-02-03
Presbyterian,Campbell,53,66,1,-13,2015-02-03
Northwestern State,Central Arkansas,110,108,0,2,2015-02-03
UNC Asheville,Coastal Carolina,56,68,1,-12,2015-02-03
Seton Hall,DePaul,62,75,1,-13,2015-02-03
Baker,Eastern Illinois,32,59,1,-27,2015-02-03
Florida Atlantic,Florida International,56,64,1,-8,2015-02-03
Radford,High Point,67,64,0,3,2015-02-03
Rutgers,Illinois,54,66,1,-12,2015-02-03
Evansville,Illinois State,51,77,1,-26,2015-02-03
Northern Iowa,Indiana State,61,51,0,10,2015-02-03
Paine,Kennesaw State,75,80,1,-5,2015-02-03
Georgia,Kentucky,58,69,1,-11,2015-02-03
Gardner-Webb,Longwood,87,78,0,9,2015-02-03
Louisville,Miami (FL),63,55,0,8,2015-02-03
Northwestern,Nebraska,60,76,1,-16,2015-02-03
Delaware State,NJIT,51,69,1,-18,2015-02-03
West Virginia,Oklahoma,52,71,1,-19,2015-02-03
St. Joseph's,Saint Louis,61,68,1,-7,2015-02-03
St. Andrews,USC Upstate,39,79,1,-40,2015-02-03
Virginia Tech,Syracuse,70,72,1,-2,2015-02-03
Mississippi State,Tennessee,71,66,0,5,2015-02-03
Incarnate Word,Texas A&M-Corpus Christi,70,71,1,-1,2015-02-03
Boise State,Utah State,68,63,0,5,2015-02-03
Florida,Vanderbilt,61,67,1,-6,2015-02-03
Maine,Vermont,49,68,1,-19,2015-02-03
UNC Greensboro,VMI,85,56,0,29,2015-02-03
NC State,Wake Forest,84,88,1,-4,2015-02-03
Indiana,Wisconsin,78,92,1,-14,2015-02-03
New Mexico,Air Force,49,53,1,-4,2015-02-04
Missouri,Alabama,49,62,1,-13,2015-02-04
New Hampshire,Albany (NY),62,63,1,-1,2015-02-04
Loyola (MD),American,49,64,1,-15,2015-02-04
Buffalo,Ball State,82,78,0,4,2015-02-04
TCU,Baylor,57,77,1,-20,2015-02-04
Navy,Boston University,59,62,1,-3,2015-02-04
Wichita State,Bradley,62,59,0,3,2015-02-04
Bowling Green State,Central Michigan,76,74,0,2,2015-02-04
North Carolina A&T,Charlotte,61,77,1,-16,2015-02-04
Youngstown State,Cleveland State,60,73,1,-13,2015-02-04
East Carolina,UConn,52,65,1,-13,2015-02-04
St. Bonaventure,Davidson,62,61,0,1,2015-02-04
Hofstra,Delaware,79,69,0,10,2015-02-04
Southern Illinois,Drake,61,63,1,-2,2015-02-04
Georgia Tech,Duke,66,72,1,-6,2015-02-04
Clemson,Florida State,62,56,0,6,2015-02-04
UMass,Fordham,78,72,0,6,2015-02-04
San Jose State,Fresno State,63,81,1,-18,2015-02-04
VCU,George Mason,72,60,0,12,2015-02-04
Providence,Georgetown,74,71,0,3,2015-02-04
Oakland,UIC,91,77,0,14,2015-02-04
UNC Wilmington,James Madison,77,65,0,12,2015-02-04
Bucknell,Lafayette,74,84,1,-10,2015-02-04
Army,Lehigh,74,103,1,-29,2015-02-04
Penn State,Maryland,58,64,1,-6,2015-02-04
Jacksonville State,Memphis,48,74,1,-26,2015-02-04
Northern Illinois,Miami (OH),69,67,0,2,2015-02-04
Texas A&M,Ole Miss,59,69,1,-10,2015-02-04
Loyola (IL),Missouri State,53,50,0,3,2015-02-04
San Diego State,Nevada,65,63,0,2,2015-02-04
Towson,Northeastern,62,69,1,-7,2015-02-04
Boston College,Notre Dame,63,71,1,-8,2015-02-04
Akron,Ohio,82,83,1,-1,2015-02-04
Washington,Oregon,74,78,1,-4,2015-02-04
Ohio State,Purdue,58,60,1,-2,2015-02-04
Texas State,South Alabama,63,43,0,20,2015-02-04
St. Andrews,South Carolina State,48,80,1,-32,2015-02-04
Temple,South Florida,61,48,0,13,2015-02-04
Oklahoma State,Texas,65,63,0,2,2015-02-04
Kansas State,Texas Tech,47,64,1,-17,2015-02-04
Eastern Michigan,Toledo,60,84,1,-24,2015-02-04
Detroit,Valparaiso,70,78,1,-8,2015-02-04
Marquette,Villanova,52,70,1,-18,2015-02-04
Kent State,Western Michigan,66,67,1,-1,2015-02-04
Liberty,Winthrop,61,74,1,-13,2015-02-04
Colorado State,Wyoming,48,59,1,-11,2015-02-04
Creighton,Xavier,79,72,0,7,2015-02-04
Louisiana Tech,Alabama-Birmingham,60,80,1,-20,2015-02-05
Louisiana-Monroe,Little Rock,77,61,0,16,2015-02-05
Troy,Arkansas State,69,64,0,5,2015-02-05
UT-Martin,Austin Peay,76,64,0,12,2015-02-05
Mount St. Mary's,Bryant,53,55,1,-2,2015-02-05
Hawaii,Cal Poly,59,56,0,3,2015-02-05
Utah Valley,Cal State Bakersfield,69,72,1,-3,2015-02-05
Cal State Northridge,Cal State Fullerton,53,69,1,-16,2015-02-05
USC,California,69,70,1,-1,2015-02-05
UC-Davis,UC-Irvine,75,56,0,19,2015-02-05
St. Francis (NY),Central Connecticut,90,81,0,9,2015-02-05
New Mexico State,Chicago State,69,61,0,8,2015-02-05
Mercer,Citadel,76,53,0,23,2015-02-05
William & Mary,College of Charleston,72,80,1,-8,2015-02-05
Wofford,ETSU,74,64,0,10,2015-02-05
Belmont,Eastern Kentucky,69,81,1,-12,2015-02-05
Drexel,Elon,67,63,0,4,2015-02-05
Saint Francis (PA),Fairleigh Dickinson,64,60,0,4,2015-02-05
UTEP,Florida Atlantic,63,56,0,7,2015-02-05
UTSA,Florida International,74,63,0,11,2015-02-05
Chattanooga,Furman,74,71,0,3,2015-02-05
Georgia State,Georgia Southern,54,58,1,-4,2015-02-05
Milwaukee,Green Bay,70,81,1,-11,2015-02-05
Colgate,Holy Cross,60,70,1,-10,2015-02-05
Tulsa,Houston,57,44,0,13,2015-02-05
South Dakota State,Purdue-Fort Wayne,74,84,1,-10,2015-02-05
Oral Roberts,IUPUI,78,68,0,10,2015-02-05
Richmond,La Salle,62,64,1,-2,2015-02-05
UC-Riverside,Long Beach State,63,68,1,-5,2015-02-05
Robert Morris,LIU-Brooklyn,65,72,1,-7,2015-02-05
Appalachian State,Louisiana,66,81,1,-15,2015-02-05
Auburn,LSU,81,77,0,4,2015-02-05
San Diego,Loyola Marymount,61,70,1,-9,2015-02-05
Rice,Marshall,55,69,1,-14,2015-02-05
UMBC,UMass-Lowell,51,67,1,-16,2015-02-05
Iowa,Michigan,72,54,0,18,2015-02-05
Southern Miss,Middle Tennessee,51,61,1,-10,2015-02-05
Texas-Rio Grande Valley,UMKC,45,70,1,-25,2015-02-05
Eastern Washington,Montana,75,69,0,6,2015-02-05
Idaho,Montana State,80,71,0,9,2015-02-05
Tennessee State,Morehead State,57,72,1,-15,2015-02-05
Southeast Missouri State,Murray State,72,82,1,-10,2015-02-05
Omaha,North Dakota State,57,64,1,-7,2015-02-05
Northern Colorado,Northern Arizona,60,65,1,-5,2015-02-05
Washington State,Oregon State,50,55,1,-5,2015-02-05
BYU,Pepperdine,74,80,1,-6,2015-02-05
Monmouth,Quinnipiac,52,72,1,-20,2015-02-05
Fairfield,Rider,52,54,1,-2,2015-02-05
Wagner,Sacred Heart,75,86,1,-11,2015-02-05
Portland,San Francisco,69,57,0,12,2015-02-05
Gonzaga,Santa Clara,77,63,0,14,2015-02-05
Grand Canyon,Seattle,66,64,0,2,2015-02-05
Western Illinois,South Dakota,61,75,1,-14,2015-02-05
Cincinnati,SMU,62,54,0,8,2015-02-05
North Dakota,Southern Utah,89,85,0,4,2015-02-05
UCLA,Stanford,69,67,0,2,2015-02-05
Samford,Western Carolina,76,72,0,4,2015-02-05
North Texas,Western Kentucky,59,65,1,-6,2015-02-05
Harvard,Brown,76,74,0,2,2015-02-06
High Point,Coastal Carolina,60,65,1,-5,2015-02-06
Princeton,Columbia,74,62,0,12,2015-02-06
Penn,Cornell,71,69,0,2,2015-02-06
Campbell,Gardner-Webb,65,73,1,-8,2015-02-06
Dayton,George Washington,64,65,1,-1,2015-02-06
Siena,Iona,83,87,1,-4,2015-02-06
Canisius,Manhattan,69,78,1,-9,2015-02-06
Niagara,Marist,61,63,1,-2,2015-02-06
Longwood,UNC Asheville,56,71,1,-15,2015-02-06
Jacksonville,North Florida,50,77,1,-27,2015-02-06
Liberty,Presbyterian,61,69,1,-8,2015-02-06
Charleston Southern,Radford,79,71,0,8,2015-02-06
Dartmouth,Yale,66,81,1,-15,2015-02-06
Southeastern Louisiana,Abilene Christian,65,52,0,13,2015-02-07
Wyoming,Air Force,50,73,1,-23,2015-02-07
Buffalo,Akron,72,75,1,-3,2015-02-07
Mississippi Valley State,Alabama A&M,68,74,1,-6,2015-02-07
Southern Miss,Alabama-Birmingham,68,78,1,-10,2015-02-07
Arkansas-Pine Bluff,Alabama State,55,73,1,-18,2015-02-07
UMass-Lowell,Albany (NY),59,69,1,-10,2015-02-07
Jackson State,Alcorn State,64,61,0,3,2015-02-07
Troy,Appalachian State,62,65,1,-3,2015-02-07
Arizona,Arizona State,78,81,1,-3,2015-02-07
Mississippi State,Arkansas,41,61,1,-20,2015-02-07
Texas State,Little Rock,61,69,1,-8,2015-02-07
Ole Miss,Auburn,86,79,0,7,2015-02-07
Murray State,Austin Peay,82,72,0,10,2015-02-07
Toledo,Ball State,72,61,0,11,2015-02-07
UNC,Boston College,79,68,0,11,2015-02-07
Dartmouth,Brown,64,67,1,-3,2015-02-07
DePaul,Butler,73,83,1,-10,2015-02-07
Grand Canyon,Cal State Bakersfield,78,76,0,2,2015-02-07
UC-Riverside,Cal State Fullerton,71,66,0,5,2015-02-07
UC-Davis,Cal State Northridge,68,55,0,13,2015-02-07
UCLA,California,62,64,1,-2,2015-02-07
Hawaii,UCSB,74,75,1,-1,2015-02-07
New Orleans,Central Arkansas,67,70,1,-3,2015-02-07
Mount St. Mary's,Central Connecticut,63,46,0,17,2015-02-07
Western Michigan,Central Michigan,65,70,1,-5,2015-02-07
Texas-Rio Grande Valley,Chicago State,73,78,1,-5,2015-02-07
South Florida,Cincinnati,58,63,1,-5,2015-02-07
UNC Greensboro,Citadel,79,63,0,16,2015-02-07
Wright State,Cleveland State,72,88,1,-16,2015-02-07
American,Colgate,43,59,1,-16,2015-02-07
Drexel,College of Charleston,59,45,0,14,2015-02-07
Utah,Colorado,79,51,0,28,2015-02-07
UNLV,Colorado State,82,83,1,-1,2015-02-07
Penn,Columbia,56,83,1,-27,2015-02-07
South Carolina State,Coppin State,74,77,1,-3,2015-02-07
Princeton,Cornell,60,68,1,-8,2015-02-07
Duquesne,Davidson,69,95,1,-26,2015-02-07
Bethune-Cookman,Delaware State,75,70,0,5,2015-02-07
Omaha,Denver,74,88,1,-14,2015-02-07
Notre Dame,Duke,60,90,1,-30,2015-02-07
UCF,East Carolina,49,67,1,-18,2015-02-07
Samford,ETSU,71,68,0,3,2015-02-07
Tennessee State,Eastern Kentucky,72,77,1,-5,2015-02-07
Bradley,Evansville,56,53,0,3,2015-02-07
Robert Morris,Fairleigh Dickinson,76,62,0,14,2015-02-07
Kentucky,Florida,68,61,0,7,2015-02-07
UTSA,Florida Atlantic,74,59,0,15,2015-02-07
UTEP,Florida International,67,64,0,3,2015-02-07
Saint Louis,Fordham,65,83,1,-18,2015-02-07
Mercer,Furman,74,68,0,6,2015-02-07
Tennessee,Georgia,53,56,1,-3,2015-02-07
Louisiana-Monroe,Georgia Southern,71,68,0,3,2015-02-07
Wake Forest,Georgia Tech,59,73,1,-14,2015-02-07
Maryland-Eastern Shore,Hampton,61,64,1,-3,2015-02-07
Elon,Hofstra,69,80,1,-11,2015-02-07
Weber State,Idaho State,70,63,0,7,2015-02-07
Lamar,Incarnate Word,72,78,1,-6,2015-02-07
Texas Tech,Iowa State,38,75,1,-37,2015-02-07
Oral Roberts,Purdue-Fort Wayne,69,75,1,-6,2015-02-07
South Dakota State,IUPUI,63,56,0,7,2015-02-07
Texas,Kansas State,61,57,0,4,2015-02-07
USC Upstate,Kennesaw State,74,46,0,28,2015-02-07
Miami (OH),Kent State,60,61,1,-1,2015-02-07
UC-Irvine,Long Beach State,56,55,0,1,2015-02-07
Saint Francis (PA),LIU-Brooklyn,60,66,1,-6,2015-02-07
Texas-Arlington,Louisiana,84,69,0,15,2015-02-07
Alabama,LSU,60,71,1,-11,2015-02-07
Indiana State,Loyola (IL),79,65,0,14,2015-02-07
BYU,Loyola Marymount,87,68,0,19,2015-02-07
Lehigh,Loyola (MD),69,63,0,6,2015-02-07
Binghamton,Maine,64,67,1,-3,2015-02-07
North Texas,Marshall,73,80,1,-7,2015-02-07
Temple,Memphis,61,60,0,1,2015-02-07
Illinois,Michigan State,59,54,0,5,2015-02-07
Louisiana Tech,Middle Tennessee,73,62,0,11,2015-02-07
Purdue,Minnesota,58,62,1,-4,2015-02-07
Texas A&M,Missouri,83,61,0,22,2015-02-07
New Mexico State,UMKC,77,63,0,14,2015-02-07
Idaho,Montana,56,70,1,-14,2015-02-07
Eastern Washington,Montana State,61,51,0,10,2015-02-07
Belmont,Morehead State,71,73,1,-2,2015-02-07
Savannah State,Morgan State,57,67,1,-10,2015-02-07
Army,Navy,59,67,1,-8,2015-02-07
UMBC,New Hampshire,46,80,1,-34,2015-02-07
Utah State,New Mexico,63,60,0,3,2015-02-07
McNeese State,Nicholls State,59,70,1,-11,2015-02-07
Fisher College,NJIT,70,96,1,-26,2015-02-07
Howard,Norfolk State,69,72,1,-3,2015-02-07
North Carolina Central,North Carolina A&T,58,44,0,14,2015-02-07
William & Mary,UNC Wilmington,56,53,0,3,2015-02-07
South Dakota,North Dakota State,47,71,1,-24,2015-02-07
Delaware,Northeastern,73,68,0,5,2015-02-07
North Dakota,Northern Arizona,63,88,1,-25,2015-02-07
Bowling Green State,Northern Illinois,69,65,0,4,2015-02-07
Drake,Northern Iowa,53,69,1,-16,2015-02-07
Lipscomb,Northern Kentucky,60,77,1,-17,2015-02-07
Eastern Michigan,Ohio,73,76,1,-3,2015-02-07
Kansas,Oklahoma State,62,67,1,-5,2015-02-07
Charlotte,Old Dominion,57,61,1,-4,2015-02-07
Nebraska,Penn State,43,56,1,-13,2015-02-07
San Diego,Pepperdine,72,50,0,22,2015-02-07
Syracuse,Pitt,77,83,1,-6,2015-02-07
Portland State,Sacramento State,60,64,1,-4,2015-02-07
Bryant,Sacred Heart,75,84,1,-9,2015-02-07
George Mason,St. Joseph's,54,58,1,-4,2015-02-07
Pacific,Saint Mary's,58,73,1,-15,2015-02-07
Fairfield,St. Peter's,58,69,1,-11,2015-02-07
Texas A&M-Corpus Christi,Sam Houston State,59,67,1,-8,2015-02-07
Gonzaga,San Francisco,81,70,0,11,2015-02-07
Nevada,San Jose State,60,57,0,3,2015-02-07
Portland,Santa Clara,74,54,0,20,2015-02-07
Utah Valley,Seattle,33,53,1,-20,2015-02-07
Marquette,Seton Hall,57,54,0,3,2015-02-07
Georgia State,South Alabama,65,54,0,11,2015-02-07
Eastern Illinois,Southeast Missouri State,64,68,1,-4,2015-02-07
Grambling,Southern,50,58,1,-8,2015-02-07
Illinois State,Southern Illinois,59,65,1,-6,2015-02-07
Northern Colorado,Southern Utah,84,80,0,4,2015-02-07
VCU,St. Bonaventure,71,73,1,-2,2015-02-07
Creighton,St. John's (NY),66,84,1,-18,2015-02-07
Houston Baptist,Stephen F. Austin,59,95,1,-36,2015-02-07
Florida Gulf Coast,Stetson,67,51,0,16,2015-02-07
Vermont,Stony Brook,57,48,0,9,2015-02-07
SIU-Edwardsville,UT-Martin,59,64,1,-5,2015-02-07
Jacksonville State,Tennessee Tech,59,72,1,-13,2015-02-07
Oklahoma,TCU,68,56,0,12,2015-02-07
Prairie View,Texas Southern,58,55,0,3,2015-02-07
James Madison,Towson,63,61,0,2,2015-02-07
UConn,Tulane,62,53,0,9,2015-02-07
SMU,Tulsa,68,57,0,11,2015-02-07
South Carolina,Vanderbilt,50,65,1,-15,2015-02-07
Georgetown,Villanova,53,69,1,-16,2015-02-07
Louisville,Virginia,47,52,1,-5,2015-02-07
Wofford,VMI,65,62,0,3,2015-02-07
Florida State,Virginia Tech,73,65,0,8,2015-02-07
St. Francis (NY),Wagner,66,51,0,15,2015-02-07
Baylor,West Virginia,87,69,0,18,2015-02-07
Chattanooga,Western Carolina,70,73,1,-3,2015-02-07
Rice,Western Kentucky,72,68,0,4,2015-02-07
Missouri State,Wichita State,35,78,1,-43,2015-02-07
Northwestern,Wisconsin,50,65,1,-15,2015-02-07
Providence,Xavier,69,78,1,-9,2015-02-07
Harvard,Yale,52,50,0,2,2015-02-07
San Diego State,Boise State,46,61,1,-15,2015-02-08
Holy Cross,Bucknell,57,70,1,-13,2015-02-08
UIC,Detroit,83,73,0,10,2015-02-08
Michigan,Indiana,67,70,1,-3,2015-02-08
Marist,Iona,67,89,1,-22,2015-02-08
Maryland,Iowa,55,71,1,-16,2015-02-08
La Salle,UMass,59,66,1,-7,2015-02-08
Clemson,Miami (FL),45,56,1,-11,2015-02-08
Canisius,Monmouth,40,44,1,-4,2015-02-08
Washington State,Oregon,72,95,1,-23,2015-02-08
Washington,Oregon State,50,64,1,-14,2015-02-08
Niagara,Quinnipiac,69,91,1,-22,2015-02-08
Rhode Island,Richmond,79,74,0,5,2015-02-08
Manhattan,Rider,77,85,1,-8,2015-02-08
Ohio State,Rutgers,79,60,0,19,2015-02-08
USC,Stanford,62,70,1,-8,2015-02-08
Oakland,Valparaiso,76,82,1,-6,2015-02-08
Lamar,Abilene Christian,80,61,0,19,2015-02-09
Arkansas-Pine Bluff,Alabama A&M,56,42,0,14,2015-02-09
Mississippi Valley State,Alabama State,57,65,1,-8,2015-02-09
Grambling,Alcorn State,77,91,1,-14,2015-02-09
Oklahoma State,Baylor,74,65,0,9,2015-02-09
Savannah State,Coppin State,73,70,0,3,2015-02-09
Florida A&M,Delaware State,74,90,1,-16,2015-02-09
Duke,Florida State,73,70,0,3,2015-02-09
UNC Asheville,Gardner-Webb,92,89,0,3,2015-02-09
Howard,Hampton,69,73,1,-4,2015-02-09
Texas A&M-Corpus Christi,Houston Baptist,66,77,1,-11,2015-02-09
Boston University,Lafayette,74,60,0,14,2015-02-09
South Carolina State,Morgan State,43,55,1,-12,2015-02-09
McNeese State,New Orleans,71,81,1,-10,2015-02-09
Maryland-Eastern Shore,Norfolk State,82,64,0,18,2015-02-09
Stephen F. Austin,Northwestern State,93,82,0,11,2015-02-09
Iowa State,Oklahoma,83,94,1,-11,2015-02-09
Siena,St. Peter's,57,65,1,-8,2015-02-09
Texas College,Sam Houston State,39,88,1,-49,2015-02-09
Jackson State,Southern,62,52,0,10,2015-02-09
St. Katherine,Utah Valley,55,77,1,-22,2015-02-09
Georgia Tech,Virginia Tech,63,65,1,-2,2015-02-09
Kent State,Akron,52,61,1,-9,2015-02-10
Arkansas,Auburn,101,87,0,14,2015-02-10
Albany (NY),Binghamton,62,46,0,16,2015-02-10
Western Michigan,Bowling Green State,49,65,1,-16,2015-02-10
Toledo,Buffalo,92,88,0,4,2015-02-10
Notre Dame,Clemson,60,58,0,2,2015-02-10
New Mexico,Colorado State,59,70,1,-11,2015-02-10
James Madison,Delaware,67,54,0,13,2015-02-10
Towson,Drexel,49,53,1,-4,2015-02-10
Memphis,East Carolina,53,64,1,-11,2015-02-10
Miami (OH),Eastern Michigan,69,83,1,-14,2015-02-10
Missouri State,Evansville,66,73,1,-7,2015-02-10
Iona,Fairfield,72,57,0,15,2015-02-10
New Hampshire,Hartford,76,70,0,6,2015-02-10
Nicholls State,Incarnate Word,64,73,1,-9,2015-02-10
Campbell,Liberty,60,73,1,-13,2015-02-10
Kentucky,LSU,71,69,0,2,2015-02-10
Xavier,Marquette,64,44,0,20,2015-02-10
Oakland,Milwaukee,67,84,1,-17,2015-02-10
Alabama,Mississippi State,55,51,0,4,2015-02-10
Wisconsin,Nebraska,65,55,0,10,2015-02-10
Fresno State,UNLV,61,73,1,-12,2015-02-10
Ball State,Northern Illinois,63,75,1,-12,2015-02-10
Michigan State,Northwestern,68,44,0,24,2015-02-10
Central Michigan,Ohio,68,57,0,11,2015-02-10
Dayton,Saint Louis,51,44,0,7,2015-02-10
Georgetown,Seton Hall,86,67,0,19,2015-02-10
Missouri,South Carolina,60,65,1,-5,2015-02-10
Central Arkansas,Southeastern Louisiana,58,83,1,-25,2015-02-10
Cincinnati,Temple,59,75,1,-16,2015-02-10
Kansas,Texas Tech,73,51,0,22,2015-02-10
Nevada,Utah State,62,75,1,-13,2015-02-10
Holy Cross,Army,73,64,0,9,2015-02-11
Air Force,Boise State,42,67,1,-25,2015-02-11
Syracuse,Boston College,70,56,0,14,2015-02-11
Colgate,Boston University,76,69,0,7,2015-02-11
South Florida,UCF,62,73,1,-11,2015-02-11
Coastal Carolina,Charleston Southern,72,83,1,-11,2015-02-11
George Mason,Davidson,71,92,1,-21,2015-02-11
Bradley,Drake,54,60,1,-6,2015-02-11
George Washington,Duquesne,62,78,1,-16,2015-02-11
Morehead State,Eastern Kentucky,57,69,1,-12,2015-02-11
Winthrop,High Point,72,73,1,-1,2015-02-11
Purdue-Fort Wayne,IUPUI,69,54,0,15,2015-02-11
Belmont,Jacksonville State,70,72,1,-2,2015-02-11
Pitt,Louisville,56,69,1,-13,2015-02-11
Southern Illinois,Loyola (IL),62,66,1,-4,2015-02-11
Lafayette,Loyola (MD),43,62,1,-19,2015-02-11
Indiana,Maryland,66,68,1,-2,2015-02-11
Stony Brook,UMBC,73,61,0,12,2015-02-11
Bucknell,Navy,52,51,0,1,2015-02-11
Virginia,NC State,51,47,0,4,2015-02-11
College of Charleston,UNC Wilmington,45,58,1,-13,2015-02-11
Illinois State,Northern Iowa,64,83,1,-19,2015-02-11
Penn State,Ohio State,55,75,1,-20,2015-02-11
Villanova,Providence,74,68,0,6,2015-02-11
Longwood,Radford,75,80,1,-5,2015-02-11
Fordham,Richmond,71,73,1,-2,2015-02-11
Rhode Island,St. Joseph's,64,65,1,-1,2015-02-11
Wyoming,San Diego State,41,67,1,-26,2015-02-11
Oregon,USC,80,75,0,5,2015-02-11
UMass,St. Bonaventure,55,53,0,2,2015-02-11
DePaul,St. John's (NY),78,86,1,-8,2015-02-11
TCU,Texas,43,66,1,-23,2015-02-11
Georgia,Texas A&M,62,53,0,9,2015-02-11
Oregon State,UCLA,59,75,1,-16,2015-02-11
Tennessee,Vanderbilt,76,73,0,3,2015-02-11
UMass-Lowell,Vermont,53,96,1,-43,2015-02-11
La Salle,VCU,74,69,0,5,2015-02-11
Miami (FL),Wake Forest,70,72,1,-2,2015-02-11
Kansas State,West Virginia,72,76,1,-4,2015-02-11
Indiana State,Wichita State,57,74,1,-17,2015-02-11
Elon,William & Mary,58,77,1,-19,2015-02-11
Green Bay,Youngstown State,63,62,0,1,2015-02-11
Little Rock,Appalachian State,79,74,0,5,2015-02-12
Eastern Illinois,Austin Peay,66,55,0,11,2015-02-12
Saint Mary's,BYU,60,82,1,-22,2015-02-12
Cal State Northridge,Cal Poly,63,70,1,-7,2015-02-12
Cal State Fullerton,UC-Davis,69,75,1,-6,2015-02-12
Long Beach State,UCSB,55,70,1,-15,2015-02-12
California,Colorado,68,61,0,7,2015-02-12
Tulsa,UConn,45,70,1,-25,2015-02-12
North Dakota State,Denver,73,69,0,4,2015-02-12
Sacramento State,Eastern Washington,61,64,1,-3,2015-02-12
Bryant,Fairleigh Dickinson,74,71,0,3,2015-02-12
Ole Miss,Florida,62,61,0,1,2015-02-12
Arkansas State,Georgia Southern,60,65,1,-5,2015-02-12
Loyola Marymount,Gonzaga,51,80,1,-29,2015-02-12
UC-Riverside,Hawaii,52,73,1,-21,2015-02-12
Northeastern,Hofstra,79,68,0,11,2015-02-12
SMU,Houston,75,69,0,6,2015-02-12
Portland State,Idaho,76,87,1,-11,2015-02-12
Northern Arizona,Idaho State,66,80,1,-14,2015-02-12
Michigan,Illinois,52,64,1,-12,2015-02-12
Minnesota,Iowa,64,59,0,5,2015-02-12
Jacksonville,Kennesaw State,65,78,1,-13,2015-02-12
American,Lehigh,58,65,1,-7,2015-02-12
Stetson,Lipscomb,85,87,1,-2,2015-02-12
Louisiana,Louisiana-Monroe,55,67,1,-12,2015-02-12
Florida Atlantic,Louisiana Tech,54,65,1,-11,2015-02-12
Siena,Marist,66,64,0,2,2015-02-12
Western Carolina,Mercer,58,54,0,4,2015-02-12
Sacred Heart,Mount St. Mary's,62,55,0,7,2015-02-12
SIU-Edwardsville,Murray State,46,78,1,-32,2015-02-12
South Dakota,Omaha,74,73,0,1,2015-02-12
Seattle,New Mexico State,47,73,1,-26,2015-02-12
Presbyterian,UNC Asheville,69,65,0,4,2015-02-12
ETSU,UNC Greensboro,65,62,0,3,2015-02-12
Montana,North Dakota,65,61,0,4,2015-02-12
Alabama-Birmingham,North Texas,64,67,1,-3,2015-02-12
Montana State,Northern Colorado,90,87,0,3,2015-02-12
Florida Gulf Coast,Northern Kentucky,65,59,0,6,2015-02-12
Western Illinois,Oral Roberts,67,77,1,-10,2015-02-12
Pepperdine,Portland,52,69,1,-17,2015-02-12
Middle Tennessee,Rice,68,71,1,-3,2015-02-12
LIU-Brooklyn,Robert Morris,63,62,0,1,2015-02-12
Purdue,Rutgers,61,51,0,10,2015-02-12
Central Connecticut,Saint Francis (PA),63,74,1,-11,2015-02-12
Citadel,Samford,66,65,0,1,2015-02-12
Pacific,San Diego,48,68,1,-20,2015-02-12
Santa Clara,San Francisco,62,69,1,-7,2015-02-12
North Florida,USC Upstate,63,80,1,-17,2015-02-12
UT-Martin,Southeast Missouri State,76,98,1,-22,2015-02-12
Florida International,Southern Miss,73,71,0,2,2015-02-12
Wagner,St. Francis (NY),66,83,1,-17,2015-02-12
Tennessee State,Tennessee Tech,52,71,1,-19,2015-02-12
Charlotte,UTEP,68,73,1,-5,2015-02-12
Cal State Bakersfield,Texas-Rio Grande Valley,66,54,0,12,2015-02-12
Old Dominion,UTSA,67,72,1,-5,2015-02-12
Texas-Arlington,Texas State,70,61,0,9,2015-02-12
South Alabama,Troy,71,67,0,4,2015-02-12
Stanford,Utah,59,75,1,-16,2015-02-12
Furman,VMI,59,93,1,-34,2015-02-12
Southern Utah,Weber State,65,56,0,9,2015-02-12
Chattanooga,Wofford,56,46,0,10,2015-02-12
UIC,Wright State,79,75,0,4,2015-02-12
Rider,Canisius,60,59,0,1,2015-02-13
Incarnate Word,Central Arkansas,77,67,0,10,2015-02-13
Cornell,Dartmouth,81,72,0,9,2015-02-13
Cleveland State,Detroit,65,66,1,-1,2015-02-13
Quinnipiac,Fairfield,60,59,0,1,2015-02-13
Columbia,Harvard,68,72,1,-4,2015-02-13
Iona,Manhattan,70,67,0,3,2015-02-13
St. Peter's,Niagara,77,65,0,12,2015-02-13
Albany (NY),NJIT,65,59,0,6,2015-02-13
Yale,Penn,75,48,0,27,2015-02-13
Brown,Princeton,64,75,1,-11,2015-02-13
Kent State,Toledo,76,75,0,1,2015-02-13
Green Bay,Valparaiso,59,63,1,-4,2015-02-13
Arizona,Washington,86,62,0,24,2015-02-13
Arizona State,Washington State,71,74,1,-3,2015-02-13
UNLV,Air Force,75,76,1,-1,2015-02-14
Vanderbilt,Alabama,76,68,0,8,2015-02-14
Alabama A&M,Alabama State,80,71,0,9,2015-02-14
Lafayette,American,77,88,1,-11,2015-02-14
Georgia Southern,Little Rock,72,70,0,2,2015-02-14
Southern,Arkansas-Pine Bluff,74,56,0,18,2015-02-14
Bowling Green State,Ball State,79,65,0,14,2015-02-14
Morehead State,Belmont,57,58,1,-1,2015-02-14
North Carolina Central,Bethune-Cookman,65,51,0,14,2015-02-14
Loyola (MD),Boston University,60,73,1,-13,2015-02-14
Pacific,BYU,59,84,1,-25,2015-02-14
Central Michigan,Buffalo,75,74,0,1,2015-02-14
Villanova,Butler,68,65,0,3,2015-02-14
Long Beach State,Cal Poly,58,71,1,-13,2015-02-14
UCSB,Cal State Northridge,65,57,0,8,2015-02-14
UC-Irvine,UC-Riverside,63,70,1,-7,2015-02-14
High Point,Campbell,63,51,0,12,2015-02-14
Samford,Chattanooga,72,79,1,-7,2015-02-14
UMKC,Chicago State,61,50,0,11,2015-02-14
Tulane,Cincinnati,50,49,0,1,2015-02-14
Virginia Tech,Clemson,54,75,1,-21,2015-02-14
Liberty,Coastal Carolina,56,96,1,-40,2015-02-14
Navy,Colgate,70,69,0,1,2015-02-14
Howard,Coppin State,77,60,0,17,2015-02-14
Marquette,Creighton,70,77,1,-7,2015-02-14
Columbia,Dartmouth,49,61,1,-12,2015-02-14
St. Bonaventure,Dayton,61,75,1,-14,2015-02-14
IUPUI,Denver,54,53,0,1,2015-02-14
Furman,ETSU,59,66,1,-7,2015-02-14
Akron,Eastern Michigan,75,78,1,-3,2015-02-14
Portland State,Eastern Washington,68,66,0,2,2015-02-14
James Madison,Elon,86,75,0,11,2015-02-14
North Carolina A&T,Florida A&M,50,57,1,-7,2015-02-14
Boise State,Fresno State,64,70,1,-6,2015-02-14
Richmond,George Mason,67,71,1,-4,2015-02-14
VCU,George Washington,79,66,0,13,2015-02-14
Auburn,Georgia,69,68,0,1,2015-02-14
Florida State,Georgia Tech,57,53,0,4,2015-02-14
Pepperdine,Gonzaga,48,56,1,-8,2015-02-14
Texas Southern,Grambling,81,58,0,23,2015-02-14
Utah Valley,Grand Canyon,57,83,1,-26,2015-02-14
Cornell,Harvard,40,61,1,-21,2015-02-14
Cal State Fullerton,Hawaii,61,81,1,-20,2015-02-14
Lehigh,Holy Cross,52,58,1,-6,2015-02-14
Sam Houston State,Houston Baptist,87,64,0,23,2015-02-14
Sacramento State,Idaho,58,69,1,-11,2015-02-14
Southern Utah,Idaho State,71,67,0,4,2015-02-14
Wichita State,Illinois State,68,62,0,6,2015-02-14
Drake,Indiana State,54,75,1,-21,2015-02-14
West Virginia,Iowa State,59,79,1,-20,2015-02-14
Prairie View,Jackson State,61,55,0,6,2015-02-14
Tennessee Tech,Jacksonville State,68,82,1,-14,2015-02-14
Baylor,Kansas,64,74,1,-10,2015-02-14
Oklahoma,Kansas State,56,59,1,-3,2015-02-14
North Florida,Kennesaw State,67,51,0,16,2015-02-14
South Carolina,Kentucky,43,77,1,-34,2015-02-14
Davidson,La Salle,77,69,0,8,2015-02-14
Florida Gulf Coast,Lipscomb,76,74,0,2,2015-02-14
Charleston Southern,Longwood,65,64,0,1,2015-02-14
Appalachian State,Louisiana-Monroe,58,69,1,-11,2015-02-14
Florida International,Louisiana Tech,42,75,1,-33,2015-02-14
NC State,Louisville,74,65,0,9,2015-02-14
Western Kentucky,Marshall,82,87,1,-5,2015-02-14
Delaware State,Maryland-Eastern Shore,91,85,0,6,2015-02-14
Duquesne,UMass,74,82,1,-8,2015-02-14
Hartford,UMass-Lowell,63,69,1,-6,2015-02-14
Northwestern State,McNeese State,75,72,0,3,2015-02-14
UNC Greensboro,Mercer,50,55,1,-5,2015-02-14
Ohio,Miami (OH),66,77,1,-11,2015-02-14
Ohio State,Michigan State,56,59,1,-3,2015-02-14
Arkansas,Ole Miss,71,70,0,1,2015-02-14
Alcorn State,Mississippi Valley State,60,76,1,-16,2015-02-14
Mississippi State,Missouri,77,74,0,3,2015-02-14
Norfolk State,Morgan State,70,73,1,-3,2015-02-14
Bryant,Mount St. Mary's,68,75,1,-7,2015-02-14
Western Illinois,Omaha,58,77,1,-19,2015-02-14
New Mexico,Nevada,63,66,1,-3,2015-02-14
Binghamton,New Hampshire,48,66,1,-18,2015-02-14
Cal State Bakersfield,New Mexico State,58,74,1,-16,2015-02-14
Southeastern Louisiana,Nicholls State,65,59,0,6,2015-02-14
Northeastern,UNC Wilmington,61,66,1,-5,2015-02-14
Montana State,North Dakota,80,78,0,2,2015-02-14
Middle Tennessee,North Texas,56,57,1,-1,2015-02-14
Montana,Northern Colorado,83,81,0,2,2015-02-14
Stetson,Northern Kentucky,57,82,1,-25,2015-02-14
South Dakota,Oral Roberts,83,70,0,13,2015-02-14
Maryland,Penn State,76,73,0,3,2015-02-14
Brown,Penn,71,55,0,16,2015-02-14
UNC,Pitt,76,89,1,-13,2015-02-14
Loyola Marymount,Portland,63,66,1,-3,2015-02-14
Radford,Presbyterian,62,56,0,6,2015-02-14
Yale,Princeton,81,73,0,8,2015-02-14
Seton Hall,Providence,62,69,1,-7,2015-02-14
Saint Louis,Rhode Island,68,81,1,-13,2015-02-14
Alabama-Birmingham,Rice,73,82,1,-9,2015-02-14
Central Connecticut,Robert Morris,52,53,1,-1,2015-02-14
LIU-Brooklyn,Saint Francis (PA),79,74,0,5,2015-02-14
Saint Mary's,San Diego,69,62,0,7,2015-02-14
Colorado State,San Diego State,63,72,1,-9,2015-02-14
South Carolina State,Savannah State,56,53,0,3,2015-02-14
Monmouth,Siena,83,64,0,19,2015-02-14
Texas-Arlington,South Alabama,91,97,1,-6,2015-02-14
Jacksonville,USC Upstate,89,70,0,19,2015-02-14
North Dakota State,South Dakota State,58,68,1,-10,2015-02-14
Memphis,South Florida,75,48,0,27,2015-02-14
Murray State,Southeast Missouri State,94,92,0,2,2015-02-14
Oregon State,USC,55,68,1,-13,2015-02-14
Evansville,Southern Illinois,72,64,0,8,2015-02-14
Eastern Illinois,SIU-Edwardsville,63,80,1,-17,2015-02-14
UConn,SMU,55,73,1,-18,2015-02-14
Florida Atlantic,Southern Miss,54,62,1,-8,2015-02-14
Sacred Heart,St. Francis (NY),62,71,1,-9,2015-02-14
Maine,Stony Brook,52,80,1,-28,2015-02-14
Duke,Syracuse,80,72,0,8,2015-02-14
East Carolina,Temple,53,66,1,-13,2015-02-14
LSU,Tennessee,73,55,0,18,2015-02-14
Austin Peay,UT-Martin,61,67,1,-6,2015-02-14
Eastern Kentucky,Tennessee State,69,41,0,28,2015-02-14
Texas Tech,Texas,41,56,1,-15,2015-02-14
Florida,Texas A&M,62,63,1,-1,2015-02-14
Stephen F. Austin,Texas A&M-Corpus Christi,63,71,1,-8,2015-02-14
Oklahoma State,TCU,55,70,1,-15,2015-02-14
Old Dominion,UTEP,47,62,1,-15,2015-02-14
Seattle,Texas-Rio Grande Valley,57,68,1,-11,2015-02-14
Charlotte,UTSA,89,81,0,8,2015-02-14
Georgia State,Texas State,53,41,0,12,2015-02-14
Louisiana,Troy,84,80,0,4,2015-02-14
Oregon,UCLA,63,72,1,-9,2015-02-14
UMBC,Vermont,51,74,1,-23,2015-02-14
Wake Forest,Virginia,60,61,1,-1,2015-02-14
Fairleigh Dickinson,Wagner,79,83,1,-4,2015-02-14
Northern Arizona,Weber State,61,54,0,7,2015-02-14
Wofford,Western Carolina,75,55,0,20,2015-02-14
Northern Illinois,Western Michigan,65,69,1,-4,2015-02-14
Delaware,William & Mary,73,70,0,3,2015-02-14
Gardner-Webb,Winthrop,68,71,1,-3,2015-02-14
San Jose State,Wyoming,60,77,1,-17,2015-02-14
St. John's (NY),Xavier,78,70,0,8,2015-02-14
Bucknell,Army,78,75,0,3,2015-02-15
Loyola (IL),Bradley,58,53,0,5,2015-02-15
St. Peter's,Canisius,55,69,1,-14,2015-02-15
Houston,UCF,54,56,1,-2,2015-02-15
VMI,Citadel,84,69,0,15,2015-02-15
UIC,Cleveland State,59,67,1,-8,2015-02-15
Towson,College of Charleston,53,50,0,3,2015-02-15
Stanford,Colorado,58,64,1,-6,2015-02-15
Hofstra,Drexel,81,57,0,24,2015-02-15
St. Joseph's,Fordham,55,69,1,-14,2015-02-15
Minnesota,Indiana,71,90,1,-19,2015-02-15
Fairfield,Manhattan,70,79,1,-9,2015-02-15
Valparaiso,Milwaukee,62,55,0,7,2015-02-15
Northern Iowa,Missouri State,68,57,0,11,2015-02-15
Rider,Niagara,69,60,0,9,2015-02-15
Iowa,Northwestern,61,66,1,-5,2015-02-15
Detroit,Oakland,78,83,1,-5,2015-02-15
Nebraska,Purdue,54,66,1,-12,2015-02-15
Iona,Quinnipiac,60,57,0,3,2015-02-15
California,Utah,61,76,1,-15,2015-02-15
Arizona State,Washington,78,68,0,10,2015-02-15
Arizona,Washington State,86,59,0,27,2015-02-15
Illinois,Wisconsin,49,68,1,-19,2015-02-15
Youngstown State,Wright State,74,69,0,5,2015-02-15
North Carolina A&T,Bethune-Cookman,56,78,1,-22,2015-02-16
Miami (FL),Boston College,89,86,0,3,2015-02-16
Butler,Creighton,58,56,0,2,2015-02-16
Coppin State,Delaware State,96,92,0,4,2015-02-16
Tennessee Tech,ETSU,79,87,1,-8,2015-02-16
North Carolina Central,Florida A&M,73,48,0,25,2015-02-16
Clemson,Georgia Tech,52,63,1,-11,2015-02-16
Prairie View,Grambling,95,44,0,51,2015-02-16
Stephen F. Austin,Incarnate Word,90,76,0,14,2015-02-16
Texas Southern,Jackson State,71,70,0,1,2015-02-16
Houston Baptist,Lamar,64,72,1,-8,2015-02-16
Howard,Maryland-Eastern Shore,60,71,1,-11,2015-02-16
Southeastern Louisiana,McNeese State,69,74,1,-5,2015-02-16
Southern,Mississippi Valley State,68,56,0,12,2015-02-16
Marist,Monmouth,65,69,1,-4,2015-02-16
Hampton,Morgan State,93,65,0,28,2015-02-16
Maine-Fort Kent,NJIT,55,89,1,-34,2015-02-16
Central Arkansas,Northwestern State,70,86,1,-16,2015-02-16
Coastal Carolina,Radford,65,59,0,6,2015-02-16
Abilene Christian,Sam Houston State,49,71,1,-22,2015-02-16
New Orleans,Texas A&M-Corpus Christi,53,55,1,-2,2015-02-16
Seton Hall,Villanova,54,80,1,-26,2015-02-16
Pitt,Virginia,49,61,1,-12,2015-02-16
Kansas,West Virginia,61,62,1,-1,2015-02-16
Stony Brook,Albany (NY),59,56,0,3,2015-02-17
Alcorn State,Arkansas-Pine Bluff,70,74,1,-4,2015-02-17
Alabama,Auburn,79,68,0,11,2015-02-17
Bethesda University (CA),Cal State Northridge,61,89,1,-28,2015-02-17
Drake,Evansville,52,61,1,-9,2015-02-17
St. John's (NY),Georgetown,57,79,1,-22,2015-02-17
South Carolina,Georgia,64,58,0,6,2015-02-17
UMBC,Hartford,52,55,1,-3,2015-02-17
Longwood,Liberty,78,72,0,6,2015-02-17
Michigan State,Michigan,80,67,0,13,2015-02-17
Wyoming,Nevada,64,58,0,6,2015-02-17
San Diego State,New Mexico,63,46,0,17,2015-02-17
Wake Forest,Notre Dame,75,88,1,-13,2015-02-17
Texas,Oklahoma,69,71,1,-2,2015-02-17
Avila,South Dakota,60,84,1,-24,2015-02-17
Houston,South Florida,67,69,1,-2,2015-02-17
Wichita State,Southern Illinois,84,62,0,22,2015-02-17
Kentucky,Tennessee,66,48,0,18,2015-02-17
LSU,Texas A&M,62,68,1,-6,2015-02-17
Baylor,Texas Tech,54,49,0,5,2015-02-17
Saint Louis,VCU,54,74,1,-20,2015-02-17
Toledo,Akron,68,66,0,2,2015-02-18
Boston University,American,61,53,0,8,2015-02-18
UCLA,Arizona State,66,68,1,-2,2015-02-18
Missouri,Arkansas,69,84,1,-15,2015-02-18
Vermont,Binghamton,55,57,1,-2,2015-02-18
Miami (OH),Bowling Green State,67,56,0,11,2015-02-18
Illinois State,Bradley,60,47,0,13,2015-02-18
Loyola (MD),Bucknell,50,61,1,-11,2015-02-18
Northern Illinois,Central Michigan,66,68,1,-2,2015-02-18
Presbyterian,Charleston Southern,49,75,1,-26,2015-02-18
Xavier,Cincinnati,59,57,0,2,2015-02-18
Army,Colgate,69,84,1,-15,2015-02-18
Elon,College of Charleston,63,77,1,-14,2015-02-18
Providence,DePaul,84,57,0,27,2015-02-18
UNC,Duke,90,92,1,-2,2015-02-18
Buffalo,Eastern Michigan,78,63,0,15,2015-02-18
Vanderbilt,Florida,47,50,1,-3,2015-02-18
Boston College,Florida State,60,69,1,-9,2015-02-18
Colorado State,Fresno State,81,73,0,8,2015-02-18
Fordham,George Mason,80,68,0,12,2015-02-18
Davidson,George Washington,65,63,0,2,2015-02-18
Detroit,Green Bay,76,96,1,-20,2015-02-18
Gardner-Webb,High Point,62,83,1,-21,2015-02-18
Drexel,James Madison,78,82,1,-4,2015-02-18
Ball State,Kent State,53,58,1,-5,2015-02-18
Duquesne,La Salle,72,87,1,-15,2015-02-18
Holy Cross,Lafayette,81,89,1,-8,2015-02-18
Northern Iowa,Loyola (IL),58,39,0,19,2015-02-18
Maine,UMass-Lowell,71,82,1,-11,2015-02-18
Virginia Tech,Miami (FL),52,76,1,-24,2015-02-18
Northwestern,Minnesota,72,66,0,6,2015-02-18
Indiana State,Missouri State,56,60,1,-4,2015-02-18
Lehigh,Navy,59,53,0,6,2015-02-18
Boise State,UNLV,53,48,0,5,2015-02-18
William & Mary,Northeastern,64,75,1,-11,2015-02-18
Iowa State,Oklahoma State,70,65,0,5,2015-02-18
Colorado,Oregon,60,73,1,-13,2015-02-18
Wisconsin,Penn State,55,47,0,8,2015-02-18
UMass,Rhode Island,59,75,1,-16,2015-02-18
Utah State,San Jose State,76,54,0,22,2015-02-18
UMKC,Seattle,56,74,1,-18,2015-02-18
Richmond,St. Bonaventure,71,56,0,15,2015-02-18
Louisville,Syracuse,59,69,1,-10,2015-02-18
Kansas State,TCU,55,69,1,-14,2015-02-18
Hofstra,Towson,87,82,0,5,2015-02-18
East Carolina,Tulsa,58,69,1,-11,2015-02-18
South Dakota State,Western Illinois,79,77,0,2,2015-02-18
Ohio,Western Michigan,69,80,1,-11,2015-02-18
UNC Asheville,Winthrop,70,91,1,-21,2015-02-18
Oakland,Wright State,76,67,0,9,2015-02-18
Western Kentucky,Alabama-Birmingham,66,71,1,-5,2015-02-19
USC,Arizona,57,87,1,-30,2015-02-19
Arkansas State,Little Rock,57,70,1,-13,2015-02-19
Eastern Kentucky,Belmont,61,66,1,-5,2015-02-19
San Diego,BYU,62,75,1,-13,2015-02-19
Chicago State,Cal State Bakersfield,51,64,1,-13,2015-02-19
Cal Poly,Cal State Fullerton,65,54,0,11,2015-02-19
Hawaii,UC-Irvine,60,75,1,-15,2015-02-19
UCSB,UC-Riverside,62,64,1,-2,2015-02-19
Saint Francis (PA),Central Connecticut,50,53,1,-3,2015-02-19
Louisiana Tech,Charlotte,83,82,0,1,2015-02-19
Mercer,Chattanooga,61,74,1,-13,2015-02-19
Campbell,Coastal Carolina,57,81,1,-24,2015-02-19
St. Joseph's,Dayton,64,68,1,-4,2015-02-19
UNC Wilmington,Delaware,59,70,1,-11,2015-02-19
Purdue-Fort Wayne,Denver,63,47,0,16,2015-02-19
UT-Martin,Eastern Illinois,75,73,0,2,2015-02-19
Niagara,Fairfield,55,53,0,2,2015-02-19
North Texas,Florida Atlantic,79,72,0,7,2015-02-19
Kennesaw State,Florida Gulf Coast,53,54,1,-1,2015-02-19
Rice,Florida International,56,60,1,-4,2015-02-19
Citadel,Furman,62,56,0,6,2015-02-19
Troy,Georgia Southern,65,62,0,3,2015-02-19
South Alabama,Georgia State,51,79,1,-28,2015-02-19
Texas-Rio Grande Valley,Grand Canyon,59,64,1,-5,2015-02-19
Milwaukee,UIC,71,60,0,11,2015-02-19
Purdue,Indiana,67,63,0,4,2015-02-19
Rutgers,Iowa,47,81,1,-34,2015-02-19
Northern Kentucky,Jacksonville,75,83,1,-8,2015-02-19
UC-Davis,Long Beach State,65,58,0,7,2015-02-19
Texas State,Louisiana,42,64,1,-22,2015-02-19
San Francisco,Loyola Marymount,72,45,0,27,2015-02-19
Nebraska,Maryland,65,69,1,-4,2015-02-19
UConn,Memphis,72,75,1,-3,2015-02-19
Marshall,Middle Tennessee,51,90,1,-39,2015-02-19
Ole Miss,Mississippi State,71,65,0,6,2015-02-19
Idaho State,Montana,77,88,1,-11,2015-02-19
Weber State,Montana State,74,71,0,3,2015-02-19
LIU-Brooklyn,Mount St. Mary's,65,82,1,-17,2015-02-19
Oral Roberts,Omaha,81,78,0,3,2015-02-19
IUPUI,North Dakota State,48,57,1,-9,2015-02-19
Lipscomb,North Florida,78,93,1,-15,2015-02-19
Idaho,Northern Arizona,65,72,1,-7,2015-02-19
Southern Miss,Old Dominion,38,64,1,-26,2015-02-19
Utah,Oregon State,47,37,0,10,2015-02-19
Gonzaga,Pacific,86,74,0,12,2015-02-19
Santa Clara,Pepperdine,55,64,1,-9,2015-02-19
North Dakota,Portland State,70,80,1,-10,2015-02-19
Quinnipiac,Rider,83,94,1,-11,2015-02-19
Northern Colorado,Sacramento State,59,66,1,-7,2015-02-19
Robert Morris,Sacred Heart,76,80,1,-4,2015-02-19
Portland,Saint Mary's,51,68,1,-17,2015-02-19
Monmouth,St. Peter's,63,58,0,5,2015-02-19
Canisius,Siena,69,63,0,6,2015-02-19
Southeast Missouri State,SIU-Edwardsville,72,75,1,-3,2015-02-19
Temple,SMU,58,67,1,-9,2015-02-19
Eastern Washington,Southern Utah,78,75,0,3,2015-02-19
Fairleigh Dickinson,St. Francis (NY),54,70,1,-16,2015-02-19
USC Upstate,Stetson,73,54,0,19,2015-02-19
Appalachian State,Texas-Arlington,68,81,1,-13,2015-02-19
UCF,Tulane,69,55,0,14,2015-02-19
New Mexico State,Utah Valley,51,38,0,13,2015-02-19
Bryant,Wagner,66,65,0,1,2015-02-19
UNC Greensboro,Wofford,62,77,1,-15,2015-02-19
Hartford,Albany (NY),64,70,1,-6,2015-02-20
Columbia,Brown,76,59,0,17,2015-02-20
Princeton,Dartmouth,63,56,0,7,2015-02-20
Cleveland State,Green Bay,66,61,0,5,2015-02-20
Penn,Harvard,46,69,1,-23,2015-02-20
Iona,Marist,72,68,0,4,2015-02-20
Cornell,Yale,51,62,1,-11,2015-02-20
Miami (OH),Akron,57,52,0,5,2015-02-21
Georgia,Alabama,66,65,0,1,2015-02-21
Marshall,Alabama-Birmingham,54,72,1,-18,2015-02-21
Alabama State,Alcorn State,71,67,0,4,2015-02-21
UCLA,Arizona,47,57,1,-10,2015-02-21
Louisiana-Monroe,Arkansas State,68,70,1,-2,2015-02-21
Kansas State,Baylor,42,69,1,-27,2015-02-21
Florida A&M,Bethune-Cookman,57,64,1,-7,2015-02-21
Nevada,Boise State,46,78,1,-32,2015-02-21
Notre Dame,Boston College,87,70,0,17,2015-02-21
Buffalo,Bowling Green State,68,56,0,12,2015-02-21
Cornell,Brown,56,57,1,-1,2015-02-21
Robert Morris,Bryant,76,70,0,6,2015-02-21
UMKC,Cal State Bakersfield,62,64,1,-2,2015-02-21
UCSB,Cal State Fullerton,69,54,0,15,2015-02-21
Hawaii,UC-Davis,67,74,1,-7,2015-02-21
Cal State Northridge,UC-Irvine,58,67,1,-9,2015-02-21
Cal Poly,UC-Riverside,44,48,1,-4,2015-02-21
Charleston Southern,Campbell,86,57,0,29,2015-02-21
Sam Houston State,Central Arkansas,70,42,0,28,2015-02-21
Sacred Heart,Central Connecticut,73,76,1,-3,2015-02-21
Ball State,Central Michigan,60,83,1,-23,2015-02-21
Southern Miss,Charlotte,43,71,1,-28,2015-02-21
ETSU,Chattanooga,59,67,1,-8,2015-02-21
Air Force,Colorado State,53,66,1,-13,2015-02-21
Norfolk State,Coppin State,99,81,0,18,2015-02-21
Penn,Dartmouth,62,67,1,-5,2015-02-21
Fordham,Davidson,57,76,1,-19,2015-02-21
Elon,Delaware,83,75,0,8,2015-02-21
Clemson,Duke,56,78,1,-22,2015-02-21
Dayton,Duquesne,73,83,1,-10,2015-02-21
South Florida,East Carolina,60,73,1,-13,2015-02-21
St. Peter's,Fairfield,43,57,1,-14,2015-02-21
Rice,Florida Atlantic,76,69,0,7,2015-02-21
USC Upstate,Florida Gulf Coast,72,86,1,-14,2015-02-21
North Texas,Florida International,70,56,0,14,2015-02-21
Liberty,Gardner-Webb,67,77,1,-10,2015-02-21
Rhode Island,George Mason,71,56,0,15,2015-02-21
DePaul,Georgetown,63,68,1,-5,2015-02-21
South Alabama,Georgia Southern,74,80,1,-6,2015-02-21
Appalachian State,Georgia State,43,87,1,-44,2015-02-21
New Mexico State,Grand Canyon,72,55,0,17,2015-02-21
Delaware State,Hampton,74,71,0,3,2015-02-21
Princeton,Harvard,55,63,1,-8,2015-02-21
Presbyterian,High Point,58,67,1,-9,2015-02-21
Cincinnati,Houston,63,53,0,10,2015-02-21
Loyola (IL),Illinois State,60,67,1,-7,2015-02-21
Texas A&M-Corpus Christi,Incarnate Word,68,74,1,-6,2015-02-21
Southern Illinois,Indiana State,58,78,1,-20,2015-02-21
Grambling,Jackson State,33,72,1,-39,2015-02-21
Lipscomb,Jacksonville,87,83,0,4,2015-02-21
Tennessee State,Jacksonville State,50,55,1,-5,2015-02-21
TCU,Kansas,72,81,1,-9,2015-02-21
Auburn,Kentucky,75,110,1,-35,2015-02-21
McNeese State,Lamar,53,58,1,-5,2015-02-21
Wagner,LIU-Brooklyn,60,47,0,13,2015-02-21
Winthrop,Longwood,83,59,0,24,2015-02-21
Florida,LSU,63,70,1,-7,2015-02-21
Miami (FL),Louisville,53,55,1,-2,2015-02-21
Santa Clara,Loyola Marymount,70,63,0,7,2015-02-21
Villanova,Marquette,87,76,0,11,2015-02-21
Maine,UMBC,66,73,1,-7,2015-02-21
New Hampshire,UMass-Lowell,76,60,0,16,2015-02-21
Tennessee,Ole Miss,57,59,1,-2,2015-02-21
Arkansas,Mississippi State,65,61,0,4,2015-02-21
Weber State,Montana,63,74,1,-11,2015-02-21
Idaho State,Montana State,53,67,1,-14,2015-02-21
Fairleigh Dickinson,Mount St. Mary's,64,75,1,-11,2015-02-21
Austin Peay,Murray State,54,89,1,-35,2015-02-21
UNLV,New Mexico,76,68,0,8,2015-02-21
Northwestern State,New Orleans,87,84,0,3,2015-02-21
Georgia Tech,UNC,60,89,1,-29,2015-02-21
Radford,UNC Asheville,75,68,0,7,2015-02-21
Morgan State,North Carolina Central,59,74,1,-15,2015-02-21
Virginia Tech,NC State,53,69,1,-16,2015-02-21
Purdue-Fort Wayne,North Dakota State,62,66,1,-4,2015-02-21
Northern Kentucky,North Florida,69,88,1,-19,2015-02-21
Drexel,Northeastern,73,83,1,-10,2015-02-21
Eastern Washington,Northern Arizona,69,73,1,-4,2015-02-21
Eastern Michigan,Northern Illinois,73,65,0,8,2015-02-21
Bradley,Northern Iowa,39,56,1,-17,2015-02-21
Penn State,Northwestern,39,60,1,-21,2015-02-21
Kent State,Ohio,64,51,0,13,2015-02-21
West Virginia,Oklahoma State,73,63,0,10,2015-02-21
Louisiana Tech,Old Dominion,53,72,1,-19,2015-02-21
Colorado,Oregon State,58,72,1,-14,2015-02-21
Portland,Pacific,77,79,1,-2,2015-02-21
San Francisco,Pepperdine,56,54,0,2,2015-02-21
Northern Colorado,Portland State,75,91,1,-16,2015-02-21
Mississippi Valley State,Prairie View,74,84,1,-10,2015-02-21
Canisius,Quinnipiac,65,63,0,2,2015-02-21
George Washington,Richmond,48,56,1,-8,2015-02-21
Niagara,Rider,65,61,0,4,2015-02-21
North Dakota,Sacramento State,66,74,1,-8,2015-02-21
St. Bonaventure,St. Joseph's,70,60,0,10,2015-02-21
Gonzaga,Saint Mary's,70,60,0,10,2015-02-21
Mercer,Samford,62,61,0,1,2015-02-21
San Diego State,San Jose State,74,56,0,18,2015-02-21
Howard,Savannah State,50,48,0,2,2015-02-21
Chicago State,Seattle,31,57,1,-26,2015-02-21
Manhattan,Siena,80,74,0,6,2015-02-21
Texas A&M,South Carolina,62,52,0,10,2015-02-21
Maryland-Eastern Shore,South Carolina State,68,56,0,12,2015-02-21
IUPUI,South Dakota,62,77,1,-15,2015-02-21
Oral Roberts,South Dakota State,52,81,1,-29,2015-02-21
Abilene Christian,Southeastern Louisiana,54,55,1,-1,2015-02-21
Alabama A&M,Southern,63,72,1,-9,2015-02-21
UT-Martin,SIU-Edwardsville,68,76,1,-8,2015-02-21
Idaho,Southern Utah,77,79,1,-2,2015-02-21
Saint Francis (PA),St. Francis (NY),54,66,1,-12,2015-02-21
Seton Hall,St. John's (NY),72,85,1,-13,2015-02-21
California,Stanford,61,72,1,-11,2015-02-21
Nicholls State,Stephen F. Austin,71,86,1,-15,2015-02-21
Kennesaw State,Stetson,61,56,0,5,2015-02-21
Binghamton,Stony Brook,52,64,1,-12,2015-02-21
Pitt,Syracuse,65,61,0,4,2015-02-21
Belmont,Tennessee Tech,88,82,0,6,2015-02-21
Iowa State,Texas,85,77,0,8,2015-02-21
Louisiana,Texas-Arlington,81,70,0,11,2015-02-21
UTSA,UTEP,62,69,1,-7,2015-02-21
Arkansas-Pine Bluff,Texas Southern,50,56,1,-6,2015-02-21
Oklahoma,Texas Tech,79,75,0,4,2015-02-21
UNC Wilmington,Towson,73,69,0,4,2015-02-21
Little Rock,Troy,63,58,0,5,2015-02-21
Fresno State,Utah State,79,85,1,-6,2015-02-21
Texas-Rio Grande Valley,Utah Valley,49,72,1,-23,2015-02-21
Wright State,Valparaiso,48,55,1,-7,2015-02-21
Missouri,Vanderbilt,53,76,1,-23,2015-02-21
UMass,VCU,72,78,1,-6,2015-02-21
VMI,Western Carolina,113,111,0,2,2015-02-21
Denver,Western Illinois,59,46,0,13,2015-02-21
Toledo,Western Michigan,97,87,0,10,2015-02-21
Minnesota,Wisconsin,53,63,1,-10,2015-02-21
Citadel,Wofford,52,78,1,-26,2015-02-21
Butler,Xavier,56,73,1,-17,2015-02-21
Columbia,Yale,56,50,0,6,2015-02-21
Detroit,Youngstown State,83,70,0,13,2015-02-21
USC,Arizona State,59,64,1,-5,2015-02-22
American,Army,63,72,1,-9,2015-02-22
Boston University,Bucknell,69,78,1,-9,2015-02-22
Memphis,UCF,75,65,0,10,2015-02-22
Tulane,UConn,60,67,1,-7,2015-02-22
Missouri State,Drake,43,78,1,-35,2015-02-22
Southeast Missouri State,Eastern Illinois,65,73,1,-8,2015-02-22
William & Mary,Hofstra,80,78,0,2,2015-02-22
Michigan State,Illinois,60,53,0,7,2015-02-22
Monmouth,Iona,68,69,1,-1,2015-02-22
College of Charleston,James Madison,61,68,1,-7,2015-02-22
Lafayette,Lehigh,63,61,0,2,2015-02-22
Colgate,Loyola (MD),78,80,1,-2,2015-02-22
Ohio State,Michigan,57,64,1,-7,2015-02-22
Western Kentucky,Middle Tennessee,66,68,1,-2,2015-02-22
Cleveland State,Milwaukee,60,66,1,-6,2015-02-22
Holy Cross,Navy,70,84,1,-14,2015-02-22
Iowa,Nebraska,74,46,0,28,2015-02-22
Furman,UNC Greensboro,49,84,1,-35,2015-02-22
UIC,Oakland,56,81,1,-25,2015-02-22
Utah,Oregon,58,69,1,-11,2015-02-22
Indiana,Rutgers,84,54,0,30,2015-02-22
La Salle,Saint Louis,64,68,1,-4,2015-02-22
Temple,Tulsa,39,55,1,-16,2015-02-22
Florida State,Virginia,41,51,1,-10,2015-02-22
Washington,Washington State,87,84,0,3,2015-02-22
Evansville,Wichita State,43,62,1,-19,2015-02-22
Alabama A&M,Alcorn State,73,69,0,4,2015-02-23
Austin Peay,Eastern Kentucky,64,76,1,-12,2015-02-23
Louisville,Georgia Tech,52,51,0,1,2015-02-23
Houston Baptist,Incarnate Word,64,77,1,-13,2015-02-23
Kansas,Kansas State,63,70,1,-7,2015-02-23
Coastal Carolina,Longwood,72,59,0,13,2015-02-23
Manhattan,Marist,67,54,0,13,2015-02-23
Northwestern State,Nicholls State,79,57,0,22,2015-02-23
Delaware State,Norfolk State,71,81,1,-10,2015-02-23
Morgan State,North Carolina A&T,57,60,1,-3,2015-02-23
Arkansas-Pine Bluff,Prairie View,58,79,1,-21,2015-02-23
Florida A&M,Savannah State,52,63,1,-11,2015-02-23
Howard,South Carolina State,75,65,0,10,2015-02-23
New Orleans,Southeastern Louisiana,74,73,0,1,2015-02-23
Alabama State,Southern,56,54,0,2,2015-02-23
Xavier,St. John's (NY),57,58,1,-1,2015-02-23
Lamar,Stephen F. Austin,74,103,1,-29,2015-02-23
Morehead State,Tennessee State,86,70,0,16,2015-02-23
Mississippi Valley State,Texas Southern,73,83,1,-10,2015-02-23
Texas A&M-Corpus Christi,Abilene Christian,67,44,0,23,2015-02-24
South Carolina,Alabama,51,59,1,-8,2015-02-24
Texas A&M,Arkansas,75,81,1,-6,2015-02-24
LSU,Auburn,84,61,0,23,2015-02-24
Western Michigan,Ball State,53,48,0,5,2015-02-24
New Mexico,Boise State,65,76,1,-11,2015-02-24
Akron,Buffalo,62,67,1,-5,2015-02-24
Bristol University,Cal State Bakersfield,81,95,1,-14,2015-02-24
Niagara,Canisius,82,71,0,11,2015-02-24
McNeese State,Central Arkansas,77,60,0,17,2015-02-24
Creighton,DePaul,75,62,0,13,2015-02-24
Central Michigan,Eastern Michigan,72,56,0,16,2015-02-24
Wisconsin,Maryland,53,59,1,-6,2015-02-24
Kent State,Miami (OH),81,86,1,-5,2015-02-24
Florida,Missouri,52,64,1,-12,2015-02-24
NC State,UNC,58,46,0,12,2015-02-24
Syracuse,Notre Dame,65,60,0,5,2015-02-24
Bowling Green State,Ohio,76,65,0,11,2015-02-24
Boston College,Pitt,65,71,1,-6,2015-02-24
UNLV,Utah State,65,83,1,-18,2015-02-24
Providence,Villanova,61,89,1,-28,2015-02-24
Texas,West Virginia,64,71,1,-7,2015-02-24
Nevada,Air Force,70,75,1,-5,2015-02-25
Navy,American,49,68,1,-19,2015-02-25
Army,Boston University,57,63,1,-6,2015-02-25
Marquette,Butler,52,73,1,-21,2015-02-25
Oregon,California,80,69,0,11,2015-02-25
UCF,Cincinnati,60,83,1,-23,2015-02-25
San Jose State,Colorado State,56,72,1,-16,2015-02-25
George Mason,Dayton,63,76,1,-13,2015-02-25
Valparaiso,Detroit,60,63,1,-3,2015-02-25
Loyola (IL),Drake,80,75,0,5,2015-02-25
Saint Louis,Duquesne,66,79,1,-13,2015-02-25
UConn,East Carolina,60,49,0,11,2015-02-25
North Florida,Florida Gulf Coast,76,62,0,14,2015-02-25
La Salle,Fordham,48,63,1,-15,2015-02-25
St. Bonaventure,George Washington,46,69,1,-23,2015-02-25
College of Charleston,Hofstra,40,73,1,-33,2015-02-25
Loyola (MD),Holy Cross,60,63,1,-3,2015-02-25
Southern Illinois,Illinois State,56,73,1,-17,2015-02-25
Wichita State,Indiana State,63,53,0,10,2015-02-25
Illinois,Iowa,60,68,1,-8,2015-02-25
Baylor,Iowa State,79,70,0,9,2015-02-25
Colgate,Lafayette,95,83,0,12,2015-02-25
Bucknell,Lehigh,65,84,1,-19,2015-02-25
Hartford,Maine,63,60,0,3,2015-02-25
Albany (NY),UMBC,67,49,0,18,2015-02-25
St. Joseph's,UMass,82,71,0,11,2015-02-25
Florida State,Miami (FL),77,81,1,-4,2015-02-25
Georgia,Ole Miss,76,72,0,4,2015-02-25
Kentucky,Mississippi State,74,56,0,18,2015-02-25
Bradley,Missouri State,77,80,1,-3,2015-02-25
James Madison,UNC Wilmington,54,74,1,-20,2015-02-25
Evansville,Northern Iowa,57,68,1,-11,2015-02-25
Indiana,Northwestern,65,72,1,-7,2015-02-25
Youngstown State,Oakland,71,82,1,-11,2015-02-25
Davidson,Rhode Island,60,59,0,1,2015-02-25
VCU,Richmond,63,67,1,-4,2015-02-25
Bethune-Cookman,Savannah State,49,58,1,-9,2015-02-25
Lipscomb,USC Upstate,47,70,1,-23,2015-02-25
Denver,South Dakota,66,48,0,18,2015-02-25
Washington State,USC,70,66,0,4,2015-02-25
Jacksonville,Stetson,67,70,1,-3,2015-02-25
UMass-Lowell,Stony Brook,60,75,1,-15,2015-02-25
Texas Tech,TCU,54,71,1,-17,2015-02-25
Northern Illinois,Toledo,84,82,0,2,2015-02-25
Tulane,Tulsa,55,76,1,-21,2015-02-25
Washington,UCLA,66,88,1,-22,2015-02-25
New Hampshire,Vermont,49,64,1,-15,2015-02-25
Duke,Virginia Tech,91,86,0,5,2015-02-25
Virginia,Wake Forest,70,34,0,36,2015-02-25
Towson,William & Mary,50,65,1,-15,2015-02-25
Fresno State,Wyoming,64,59,0,5,2015-02-25
Georgia Southern,Appalachian State,77,58,0,19,2015-02-26
Georgia State,Little Rock,83,92,1,-9,2015-02-26
Texas-Arlington,Arkansas State,80,81,1,-1,2015-02-26
SIU-Edwardsville,Austin Peay,61,64,1,-3,2015-02-26
Central Connecticut,Bryant,69,77,1,-8,2015-02-26
UC-Irvine,Cal Poly,63,56,0,7,2015-02-26
Cal State Fullerton,Cal State Northridge,72,82,1,-10,2015-02-26
UC-Davis,UCSB,60,74,1,-14,2015-02-26
Winthrop,Campbell,50,65,1,-15,2015-02-26
Grand Canyon,Chicago State,70,74,1,-4,2015-02-26
ETSU,Citadel,73,74,1,-1,2015-02-26
Arizona,Colorado,82,54,0,28,2015-02-26
Delaware,Drexel,58,44,0,14,2015-02-26
Jacksonville State,Eastern Kentucky,57,63,1,-6,2015-02-26
Montana State,Eastern Washington,68,92,1,-24,2015-02-26
Northeastern,Elon,65,72,1,-7,2015-02-26
Sacred Heart,Fairleigh Dickinson,90,85,0,5,2015-02-26
Western Carolina,Furman,49,53,1,-4,2015-02-26
Charleston Southern,Gardner-Webb,81,91,1,-10,2015-02-26
San Diego,Gonzaga,39,59,1,-20,2015-02-26
Long Beach State,Hawaii,59,78,1,-19,2015-02-26
Montana,Idaho,87,92,1,-5,2015-02-26
Green Bay,UIC,72,67,0,5,2015-02-26
Omaha,Purdue-Fort Wayne,73,67,0,6,2015-02-26
Western Illinois,IUPUI,66,71,1,-5,2015-02-26
Northern Kentucky,Kennesaw State,78,53,0,25,2015-02-26
Radford,Liberty,69,80,1,-11,2015-02-26
St. Francis (NY),LIU-Brooklyn,74,69,0,5,2015-02-26
UTEP,Louisiana Tech,60,77,1,-17,2015-02-26
Florida International,Marshall,69,87,1,-18,2015-02-26
SMU,Memphis,66,57,0,9,2015-02-26
Wofford,Mercer,76,72,0,4,2015-02-26
Minnesota,Michigan State,96,90,0,6,2015-02-26
Utah Valley,UMKC,50,69,1,-19,2015-02-26
Rider,Monmouth,63,60,0,3,2015-02-26
Tennessee Tech,Morehead State,73,86,1,-13,2015-02-26
Eastern Illinois,Murray State,57,65,1,-8,2015-02-26
High Point,UNC Asheville,75,71,0,4,2015-02-26
Samford,UNC Greensboro,67,81,1,-14,2015-02-26
Northern Arizona,North Dakota,85,75,0,10,2015-02-26
Charlotte,North Texas,65,81,1,-16,2015-02-26
Southern Utah,Northern Colorado,67,77,1,-10,2015-02-26
Nebraska,Ohio State,57,81,1,-24,2015-02-26
North Dakota State,Oral Roberts,58,74,1,-16,2015-02-26
BYU,Portland,82,69,0,13,2015-02-26
Coastal Carolina,Presbyterian,69,80,1,-11,2015-02-26
Rutgers,Purdue,85,92,1,-7,2015-02-26
Old Dominion,Rice,63,54,0,9,2015-02-26
Wagner,Robert Morris,59,91,1,-32,2015-02-26
Mount St. Mary's,Saint Francis (PA),60,63,1,-3,2015-02-26
Saint Mary's,San Francisco,84,53,0,31,2015-02-26
Pacific,Santa Clara,64,57,0,7,2015-02-26
Louisiana-Monroe,South Alabama,75,57,0,18,2015-02-26
UTSA,Southern Miss,66,70,1,-4,2015-02-26
Oregon State,Stanford,48,75,1,-27,2015-02-26
Houston,Temple,54,66,1,-12,2015-02-26
Vanderbilt,Tennessee,73,65,0,8,2015-02-26
UT-Martin,Tennessee State,69,52,0,17,2015-02-26
Troy,Texas State,61,67,1,-6,2015-02-26
Arizona State,Utah,41,83,1,-42,2015-02-26
Chattanooga,VMI,86,82,0,4,2015-02-26
Florida Atlantic,Western Kentucky,68,71,1,-3,2015-02-26
Milwaukee,Wright State,61,58,0,3,2015-02-26
Ohio,Akron,58,70,1,-12,2015-02-27
Penn,Brown,69,75,1,-6,2015-02-27
Fairfield,Canisius,65,72,1,-7,2015-02-27
Valparaiso,Cleveland State,56,53,0,3,2015-02-27
Dartmouth,Columbia,84,71,0,13,2015-02-27
Harvard,Cornell,49,57,1,-8,2015-02-27
Manhattan,Iona,75,79,1,-4,2015-02-27
St. Peter's,Marist,67,69,1,-2,2015-02-27
Siena,Quinnipiac,63,73,1,-10,2015-02-27
Princeton,Yale,60,81,1,-21,2015-02-27
Utah State,Air Force,74,60,0,14,2015-02-28
Prairie View,Alabama A&M,75,72,0,3,2015-02-28
Middle Tennessee,Alabama-Birmingham,95,100,1,-5,2015-02-28
Texas Southern,Alabama State,58,49,0,9,2015-02-28
Vermont,Albany (NY),73,79,1,-6,2015-02-28
Bucknell,American,71,69,0,2,2015-02-28
Louisiana-Monroe,Appalachian State,43,66,1,-23,2015-02-28
Grambling,Arkansas-Pine Bluff,57,66,1,-9,2015-02-28
West Virginia,Baylor,66,78,1,-12,2015-02-28
Tennessee State,Belmont,62,88,1,-26,2015-02-28
UMBC,Binghamton,69,76,1,-7,2015-02-28
NC State,Boston College,63,79,1,-16,2015-02-28
Holy Cross,Boston University,77,70,0,7,2015-02-28
Indiana State,Bradley,60,52,0,8,2015-02-28
Princeton,Brown,80,62,0,18,2015-02-28
St. Francis (NY),Bryant,51,61,1,-10,2015-02-28
UC-Davis,Cal Poly,66,56,0,10,2015-02-28
UC-Riverside,Cal State Northridge,76,83,1,-7,2015-02-28
UC-Irvine,UCSB,51,54,1,-3,2015-02-28
Southeastern Louisiana,Central Arkansas,72,74,1,-2,2015-02-28
East Carolina,UCF,71,66,0,5,2015-02-28
High Point,Charleston Southern,93,97,1,-4,2015-02-28
Utah Valley,Chicago State,44,65,1,-21,2015-02-28
Western Carolina,Citadel,67,54,0,13,2015-02-28
Georgia Tech,Clemson,63,70,1,-7,2015-02-28
Lehigh,Colgate,55,61,1,-6,2015-02-28
Northeastern,College of Charleston,65,56,0,9,2015-02-28
Harvard,Columbia,80,70,0,10,2015-02-28
Dartmouth,Cornell,56,45,0,11,2015-02-28
George Washington,Davidson,66,77,1,-11,2015-02-28
Maryland-Eastern Shore,Delaware State,69,65,0,4,2015-02-28
Butler,DePaul,67,53,0,14,2015-02-28
Syracuse,Duke,54,73,1,-19,2015-02-28
Tennessee Tech,Eastern Kentucky,67,70,1,-3,2015-02-28
Montana,Eastern Washington,77,76,0,1,2015-02-28
UNC Wilmington,Elon,55,74,1,-19,2015-02-28
Illinois State,Evansville,69,67,0,2,2015-02-28
Central Connecticut,Fairleigh Dickinson,66,73,1,-7,2015-02-28
Tennessee,Florida,49,66,1,-17,2015-02-28
Louisville,Florida State,81,59,0,22,2015-02-28
New Mexico,Fresno State,55,59,1,-4,2015-02-28
Wofford,Furman,62,60,0,2,2015-02-28
Missouri,Georgia,44,68,1,-24,2015-02-28
BYU,Gonzaga,73,70,0,3,2015-02-28
Oakland,Green Bay,63,83,1,-20,2015-02-28
Stony Brook,Hartford,74,59,0,15,2015-02-28
Stephen F. Austin,Houston Baptist,102,87,0,15,2015-02-28
Hampton,Howard,68,67,0,1,2015-02-28
Montana State,Idaho,73,80,1,-7,2015-02-28
Northwestern,Illinois,60,86,1,-26,2015-02-28
Wright State,UIC,46,61,1,-15,2015-02-28
Western Illinois,Purdue-Fort Wayne,64,84,1,-20,2015-02-28
Omaha,IUPUI,87,80,0,7,2015-02-28
Mississippi Valley State,Jackson State,49,73,1,-24,2015-02-28
Florida Gulf Coast,Jacksonville,67,75,1,-8,2015-02-28
Hofstra,James Madison,73,82,1,-9,2015-02-28
Texas,Kansas,64,69,1,-5,2015-02-28
Iowa State,Kansas State,69,70,1,-1,2015-02-28
Buffalo,Kent State,71,65,0,6,2015-02-28
Arkansas,Kentucky,67,84,1,-17,2015-02-28
Rhode Island,La Salle,59,56,0,3,2015-02-28
Army,Lafayette,64,74,1,-10,2015-02-28
Incarnate Word,Lamar,66,79,1,-13,2015-02-28
UNC Asheville,Liberty,95,77,0,18,2015-02-28
Kennesaw State,Lipscomb,75,94,1,-19,2015-02-28
Cal State Fullerton,Long Beach State,47,70,1,-23,2015-02-28
Campbell,Longwood,65,70,1,-5,2015-02-28
Georgia Southern,Louisiana,58,68,1,-10,2015-02-28
Ole Miss,LSU,63,73,1,-10,2015-02-28
UTSA,Louisiana Tech,66,76,1,-10,2015-02-28
Missouri State,Loyola (IL),51,65,1,-14,2015-02-28
Navy,Loyola (MD),57,47,0,10,2015-02-28
Florida Atlantic,Marshall,63,79,1,-16,2015-02-28
Michigan,Maryland,56,66,1,-10,2015-02-28
Fordham,UMass,74,82,1,-8,2015-02-28
Nicholls State,McNeese State,78,83,1,-5,2015-02-28
Tulsa,Memphis,74,72,0,2,2015-02-28
ETSU,Mercer,64,69,1,-5,2015-02-28
UNC,Miami (FL),73,64,0,9,2015-02-28
Bowling Green State,Miami (OH),62,57,0,5,2015-02-28
Grand Canyon,UMKC,65,70,1,-5,2015-02-28
Jacksonville State,Morehead State,55,87,1,-32,2015-02-28
Coppin State,Morgan State,88,77,0,11,2015-02-28
Wagner,Mount St. Mary's,64,74,1,-10,2015-02-28
San Jose State,Nevada,51,62,1,-11,2015-02-28
Wyoming,UNLV,57,69,1,-12,2015-02-28
Maine,New Hampshire,56,65,1,-9,2015-02-28
Abilene Christian,New Orleans,55,75,1,-20,2015-02-28
Sarah Lawrence,NJIT,55,90,1,-35,2015-02-28
Florida A&M,North Carolina A&T,65,77,1,-12,2015-02-28
Bethune-Cookman,North Carolina Central,49,72,1,-23,2015-02-28
Chattanooga,UNC Greensboro,61,58,0,3,2015-02-28
Southern Utah,North Dakota,71,65,0,6,2015-02-28
Stetson,North Florida,71,86,1,-15,2015-02-28
Old Dominion,North Texas,70,57,0,13,2015-02-28
Northern Arizona,Northern Colorado,74,76,1,-2,2015-02-28
Central Michigan,Northern Illinois,55,73,1,-18,2015-02-28
USC Upstate,Northern Kentucky,65,84,1,-19,2015-02-28
TCU,Oklahoma,60,67,1,-7,2015-02-28
Denver,Oral Roberts,57,60,1,-3,2015-02-28
Iowa,Penn State,81,77,0,4,2015-02-28
Loyola Marymount,Pepperdine,49,65,1,-16,2015-02-28
San Diego,Portland,78,66,0,12,2015-02-28
Sacramento State,Portland State,73,60,0,13,2015-02-28
Gardner-Webb,Radford,62,72,1,-10,2015-02-28
Charlotte,Rice,77,76,0,1,2015-02-28
Saint Francis (PA),Robert Morris,70,71,1,-1,2015-02-28
LIU-Brooklyn,Sacred Heart,73,84,1,-11,2015-02-28
Richmond,St. Joseph's,63,57,0,6,2015-02-28
George Mason,Saint Louis,78,50,0,28,2015-02-28
Boise State,San Diego State,56,46,0,10,2015-02-28
Pacific,San Francisco,55,65,1,-10,2015-02-28
Saint Mary's,Santa Clara,70,71,1,-1,2015-02-28
Cal State Bakersfield,Seattle,43,53,1,-10,2015-02-28
Creighton,Seton Hall,66,67,1,-1,2015-02-28
Mississippi State,South Carolina,68,81,1,-13,2015-02-28
Savannah State,South Carolina State,68,57,0,11,2015-02-28
South Dakota State,South Dakota,64,80,1,-16,2015-02-28
Austin Peay,Southeast Missouri State,65,89,1,-24,2015-02-28
Alcorn State,Southern,63,71,1,-8,2015-02-28
Washington,USC,55,70,1,-15,2015-02-28
Drake,Southern Illinois,57,63,1,-6,2015-02-28
UTEP,Southern Miss,60,63,1,-3,2015-02-28
Duquesne,St. Bonaventure,75,92,1,-17,2015-02-28
Georgetown,St. John's (NY),70,81,1,-11,2015-02-28
Murray State,UT-Martin,73,67,0,6,2015-02-28
Auburn,Texas A&M,55,80,1,-25,2015-02-28
Sam Houston State,Texas A&M-Corpus Christi,59,61,1,-2,2015-02-28
Little Rock,Texas-Arlington,73,82,1,-9,2015-02-28
Arkansas State,Texas State,60,70,1,-10,2015-02-28
Oklahoma State,Texas Tech,62,63,1,-1,2015-02-28
Ball State,Toledo,59,70,1,-11,2015-02-28
Delaware,Towson,65,60,0,5,2015-02-28
Georgia State,Troy,75,64,0,11,2015-02-28
Cincinnati,Tulane,63,47,0,16,2015-02-28
Arizona,Utah,63,57,0,6,2015-02-28
Alabama,Vanderbilt,66,73,1,-7,2015-02-28
Virginia Tech,Virginia,57,69,1,-12,2015-02-28
Dayton,VCU,59,55,0,4,2015-02-28
Samford,VMI,80,69,0,11,2015-02-28
Idaho State,Weber State,57,61,1,-4,2015-02-28
Florida International,Western Kentucky,61,77,1,-16,2015-02-28
Eastern Michigan,Western Michigan,72,80,1,-8,2015-02-28
Northern Iowa,Wichita State,60,74,1,-14,2015-02-28
Drexel,William & Mary,80,66,0,14,2015-02-28
Presbyterian,Winthrop,53,80,1,-27,2015-02-28
Villanova,Xavier,78,66,0,12,2015-02-28
Penn,Yale,50,55,1,-5,2015-02-28
Milwaukee,Youngstown State,82,74,0,8,2015-02-28
Oregon State,California,56,73,1,-17,2015-03-01
Arizona State,Colorado,81,87,1,-6,2015-03-01
SMU,UConn,73,81,1,-8,2015-03-01
South Florida,Houston,55,72,1,-17,2015-03-01
Quinnipiac,Manhattan,65,69,1,-4,2015-03-01
Siena,Monmouth,57,63,1,-6,2015-03-01
Fairfield,Niagara,56,57,1,-1,2015-03-01
Purdue,Ohio State,61,65,1,-4,2015-03-01
Marquette,Providence,66,77,1,-11,2015-03-01
Marist,Rider,49,59,1,-10,2015-03-01
Iona,St. Peter's,60,68,1,-8,2015-03-01
Oregon,Stanford,73,70,0,3,2015-03-01
Washington State,UCLA,67,72,1,-5,2015-03-01
Pitt,Wake Forest,66,69,1,-3,2015-03-01
Michigan State,Wisconsin,61,68,1,-7,2015-03-01
Texas Southern,Alabama A&M,77,75,0,2,2015-03-02
Prairie View,Alabama State,67,65,0,2,2015-03-02
Jackson State,Arkansas-Pine Bluff,62,64,1,-2,2015-03-02
Hampton,Delaware State,75,85,1,-10,2015-03-02
Norfolk State,Howard,59,61,1,-2,2015-03-02
Oklahoma,Iowa State,70,77,1,-7,2015-03-02
Lamar,McNeese State,69,70,1,-1,2015-03-02
Grambling,Mississippi Valley State,62,66,1,-4,2015-03-02
Nicholls State,New Orleans,89,79,0,10,2015-03-02
Bethune-Cookman,North Carolina A&T,50,67,1,-17,2015-03-02
Southeastern Louisiana,Northwestern State,79,92,1,-13,2015-03-02
Central Arkansas,Sam Houston State,49,76,1,-27,2015-03-02
North Carolina Central,Savannah State,62,49,0,13,2015-03-02
Incarnate Word,Stephen F. Austin,62,83,1,-21,2015-03-02
Virginia,Syracuse,59,47,0,12,2015-03-02
Baylor,Texas,59,61,1,-2,2015-03-02
Boston College,Virginia Tech,66,59,0,7,2015-03-02
Houston Baptist,Abilene Christian,71,83,1,-12,2015-03-03
Ole Miss,Alabama,82,74,0,8,2015-03-03
Eastern Michigan,Ball State,67,60,0,7,2015-03-03
Kent State,Bowling Green State,81,80,0,1,2015-03-03
Ohio,Buffalo,66,93,1,-27,2015-03-03
Georgetown,Butler,60,54,0,6,2015-03-03
Toledo,Central Michigan,77,85,1,-8,2015-03-03
NC State,Clemson,66,61,0,5,2015-03-03
Villanova,Creighton,76,72,0,4,2015-03-03
Rhode Island,Dayton,59,75,1,-16,2015-03-03
Youngstown State,Detroit,67,77,1,-10,2015-03-03
Texas A&M,Florida,62,66,1,-4,2015-03-03
Jacksonville,Florida Gulf Coast,63,81,1,-18,2015-03-03
Kentucky,Georgia,72,64,0,8,2015-03-03
UNC,Georgia Tech,81,49,0,32,2015-03-03
Loyola (MD),Holy Cross,45,62,1,-17,2015-03-03
Wright State,UIC,57,60,1,-3,2015-03-03
Iowa,Indiana,77,63,0,14,2015-03-03
West Virginia,Kansas,69,76,1,-7,2015-03-03
Akron,Miami (OH),63,70,1,-7,2015-03-03
Auburn,Missouri,61,63,1,-2,2015-03-03
Army,Navy,52,56,1,-4,2015-03-03
Omaha,North Dakota,80,78,0,2,2015-03-03
Stetson,North Florida,67,81,1,-14,2015-03-03
Western Michigan,Northern Illinois,63,65,1,-2,2015-03-03
Lipscomb,Northern Kentucky,76,73,0,3,2015-03-03
Michigan,Northwestern,78,82,1,-4,2015-03-03
Maryland,Rutgers,60,50,0,10,2015-03-03
Kennesaw State,USC Upstate,54,90,1,-36,2015-03-03
Maine,Albany (NY),66,83,1,-17,2015-03-04
Sacred Heart,Bryant,85,91,1,-6,2015-03-04
Gardner-Webb,Campbell,72,64,0,8,2015-03-04
Wake Forest,Duke,51,94,1,-43,2015-03-04
SIU-Edwardsville,Eastern Illinois,66,78,1,-12,2015-03-04
Duquesne,Fordham,81,66,0,15,2015-03-04
Air Force,Fresno State,66,68,1,-2,2015-03-04
George Washington,George Mason,67,51,0,16,2015-03-04
UCSB,Hawaii,98,90,0,8,2015-03-04
Nebraska,Illinois,57,69,1,-12,2015-03-04
UNC Asheville,Liberty,80,70,0,10,2015-03-04
Presbyterian,Longwood,61,65,1,-4,2015-03-04
Tennessee,LSU,78,63,0,15,2015-03-04
Notre Dame,Louisville,71,59,0,12,2015-03-04
St. John's (NY),Marquette,67,51,0,16,2015-03-04
Richmond,UMass,56,53,0,3,2015-03-04
Purdue,Michigan State,66,72,1,-6,2015-03-04
Southeast Missouri State,Morehead State,74,79,1,-5,2015-03-04
Saint Francis (PA),Mount St. Mary's,73,58,0,15,2015-03-04
Colorado State,Nevada,78,62,0,16,2015-03-04
San Diego State,UNLV,60,58,0,2,2015-03-04
Hartford,New Hampshire,63,67,1,-4,2015-03-04
Howard,NJIT,62,71,1,-9,2015-03-04
TCU,Oklahoma State,70,82,1,-12,2015-03-04
Oregon,Oregon State,65,62,0,3,2015-03-04
Ohio State,Penn State,77,67,0,10,2015-03-04
Miami (FL),Pitt,67,63,0,4,2015-03-04
Wagner,Robert Morris,68,91,1,-23,2015-03-04
La Salle,St. Joseph's,50,55,1,-5,2015-03-04
St. Bonaventure,Saint Louis,64,48,0,16,2015-03-04
Boise State,San Jose State,68,51,0,17,2015-03-04
Providence,Seton Hall,79,66,0,13,2015-03-04
UCF,South Florida,45,74,1,-29,2015-03-04
LIU-Brooklyn,St. Francis (NY),70,79,1,-9,2015-03-04
Binghamton,Stony Brook,57,62,1,-5,2015-03-04
New Mexico State,Texas-Rio Grande Valley,69,48,0,21,2015-03-04
Houston,Tulane,68,63,0,5,2015-03-04
Cincinnati,Tulsa,56,47,0,9,2015-03-04
USC,UCLA,74,85,1,-11,2015-03-04
Mississippi State,Vanderbilt,56,66,1,-10,2015-03-04
UMBC,Vermont,39,66,1,-27,2015-03-04
Utah State,Wyoming,53,76,1,-23,2015-03-04
Texas State,Appalachian State,64,67,1,-3,2015-03-05
California,Arizona,60,99,1,-39,2015-03-05
Stanford,Arizona State,62,67,1,-5,2015-03-05
South Alabama,Arkansas State,81,76,0,5,2015-03-05
Eastern Illinois,Belmont,64,97,1,-33,2015-03-05
South Carolina State,Bethune-Cookman,62,72,1,-10,2015-03-05
Drake,Bradley,50,52,1,-2,2015-03-05
Holy Cross,Bucknell,83,90,1,-7,2015-03-05
UC-Riverside,UC-Davis,59,61,1,-2,2015-03-05
Cal State Fullerton,UC-Irvine,62,68,1,-6,2015-03-05
Western Kentucky,Charlotte,88,84,0,4,2015-03-05
Navy,Colgate,62,72,1,-10,2015-03-05
Memphis,UConn,54,53,0,1,2015-03-05
Delaware State,Coppin State,104,92,0,12,2015-03-05
VCU,Davidson,55,82,1,-27,2015-03-05
Temple,East Carolina,70,56,0,14,2015-03-05
St. Peter's,Fairfield,63,33,0,30,2015-03-05
Savannah State,Florida A&M,57,64,1,-7,2015-03-05
Alabama-Birmingham,Florida Atlantic,59,62,1,-3,2015-03-05
USC Upstate,Florida Gulf Coast,63,62,0,1,2015-03-05
Middle Tennessee,Florida International,54,59,1,-5,2015-03-05
Texas-Arlington,Georgia Southern,64,76,1,-12,2015-03-05
Alabama State,Grambling,78,46,0,32,2015-03-05
Norfolk State,Hampton,80,69,0,11,2015-03-05
Eastern Washington,Idaho State,85,81,0,4,2015-03-05
Abilene Christian,Incarnate Word,52,64,1,-12,2015-03-05
Alabama A&M,Jackson State,54,72,1,-18,2015-03-05
Boston University,Lafayette,64,89,1,-25,2015-03-05
Sam Houston State,Lamar,67,61,0,6,2015-03-05
American,Lehigh,68,62,0,6,2015-03-05
Cal State Northridge,Long Beach State,58,69,1,-11,2015-03-05
Little Rock,Louisiana,69,75,1,-6,2015-03-05
Georgia State,Louisiana-Monroe,58,50,0,8,2015-03-05
Southern Miss,Louisiana Tech,61,72,1,-11,2015-03-05
Quinnipiac,Marist,74,80,1,-6,2015-03-05
Morgan State,Maryland-Eastern Shore,76,89,1,-13,2015-03-05
Wisconsin,Minnesota,76,63,0,13,2015-03-05
Southern Illinois,Missouri State,55,48,0,7,2015-03-05
UT-Martin,Morehead State,65,76,1,-11,2015-03-05
Southeastern Louisiana,New Orleans,79,85,1,-6,2015-03-05
Central Arkansas,Nicholls State,70,77,1,-7,2015-03-05
North Carolina A&T,North Carolina Central,58,69,1,-11,2015-03-05
Lipscomb,North Florida,57,71,1,-14,2015-03-05
Portland State,Northern Arizona,51,58,1,-7,2015-03-05
Marshall,Old Dominion,50,67,1,-17,2015-03-05
Southern,Prairie View,77,73,0,4,2015-03-05
Niagara,Siena,54,71,1,-17,2015-03-05
Arkansas,South Carolina,78,74,0,4,2015-03-05
Sacramento State,Southern Utah,65,69,1,-4,2015-03-05
Northwestern State,Stephen F. Austin,66,92,1,-26,2015-03-05
Houston Baptist,Texas A&M-Corpus Christi,72,85,1,-13,2015-03-05
North Texas,UTEP,60,83,1,-23,2015-03-05
Rice,UTSA,76,74,0,2,2015-03-05
Alcorn State,Texas Southern,73,94,1,-21,2015-03-05
Colorado,Washington,64,47,0,17,2015-03-05
Utah,Washington State,67,59,0,8,2015-03-05
Idaho,Weber State,63,74,1,-11,2015-03-05
Northern Illinois,Ball State,71,67,0,4,2015-03-06
Texas Tech,Baylor,74,77,1,-3,2015-03-06
Eastern Kentucky,Belmont,52,53,1,-1,2015-03-06
Northern Iowa,Bradley,71,46,0,25,2015-03-06
Bowling Green State,Buffalo,75,77,1,-2,2015-03-06
Longwood,Charleston Southern,68,60,0,8,2015-03-06
Furman,Citadel,73,56,0,17,2015-03-06
Detroit,Cleveland State,53,70,1,-17,2015-03-06
UNC Asheville,Coastal Carolina,57,74,1,-17,2015-03-06
Drexel,College of Charleston,48,56,1,-8,2015-03-06
Brown,Dartmouth,69,75,1,-6,2015-03-06
Toledo,Eastern Michigan,59,85,1,-26,2015-03-06
Towson,Elon,69,74,1,-5,2015-03-06
Illinois State,Evansville,71,67,0,4,2015-03-06
High Point,Gardner-Webb,71,72,1,-1,2015-03-06
Yale,Harvard,62,52,0,10,2015-03-06
Oakland,UIC,69,72,1,-3,2015-03-06
Loyola (IL),Indiana State,81,53,0,28,2015-03-06
Akron,Kent State,77,79,1,-2,2015-03-06
Santa Clara,Loyola Marymount,85,54,0,31,2015-03-06
Arkansas-Pine Bluff,Mississippi Valley State,94,75,0,19,2015-03-06
Murray State,Morehead State,80,77,0,3,2015-03-06
Samford,UNC Greensboro,76,81,1,-5,2015-03-06
Miami (OH),Ohio,65,95,1,-30,2015-03-06
San Francisco,Pacific,62,58,0,4,2015-03-06
Columbia,Penn,46,54,1,-8,2015-03-06
Cornell,Princeton,53,66,1,-13,2015-03-06
Winthrop,Radford,67,66,0,1,2015-03-06
Wichita State,Southern Illinois,56,45,0,11,2015-03-06
Central Michigan,Western Michigan,62,74,1,-12,2015-03-06
Texas-Arlington,Appalachian State,60,72,1,-12,2015-03-07
Stanford,Arizona,69,91,1,-22,2015-03-07
California,Arizona State,70,74,1,-4,2015-03-07
LSU,Arkansas,81,78,0,3,2015-03-07
Louisiana,Arkansas State,81,57,0,24,2015-03-07
Georgia,Auburn,64,61,0,3,2015-03-07
Murray State,Belmont,87,88,1,-1,2015-03-07
Fresno State,Boise State,52,71,1,-19,2015-03-07
Wake Forest,Boston College,61,79,1,-18,2015-03-07
Santa Clara,BYU,76,78,1,-2,2015-03-07
Hawaii,Cal State Fullerton,91,70,0,21,2015-03-07
UC-Irvine,UC-Davis,61,80,1,-19,2015-03-07
Long Beach State,UC-Riverside,59,58,0,1,2015-03-07
Cal Poly,UCSB,56,64,1,-8,2015-03-07
Monmouth,Canisius,60,54,0,6,2015-03-07
Marshall,Charlotte,73,86,1,-13,2015-03-07
Furman,Chattanooga,69,67,0,2,2015-03-07
Gardner-Webb,Coastal Carolina,70,73,1,-3,2015-03-07
UNC Wilmington,College of Charleston,79,53,0,26,2015-03-07
Xavier,Creighton,74,73,0,1,2015-03-07
Yale,Dartmouth,58,59,1,-1,2015-03-07
Northeastern,Delaware,67,64,0,3,2015-03-07
North Dakota State,Denver,61,50,0,11,2015-03-07
Davidson,Duquesne,107,78,0,29,2015-03-07
Western Carolina,ETSU,67,61,0,6,2015-03-07
William & Mary,Elon,72,59,0,13,2015-03-07
Middle Tennessee,Florida Atlantic,77,54,0,23,2015-03-07
Alabama-Birmingham,Florida International,66,70,1,-4,2015-03-07
Pitt,Florida State,52,61,1,-9,2015-03-07
UMass,George Washington,65,87,1,-22,2015-03-07
Seton Hall,Georgetown,67,73,1,-6,2015-03-07
Georgia Southern,Georgia State,55,72,1,-17,2015-03-07
San Francisco,Gonzaga,72,81,1,-9,2015-03-07
Alabama A&M,Grambling,70,66,0,4,2015-03-07
Seattle,Grand Canyon,70,83,1,-13,2015-03-07
UIC,Green Bay,56,70,1,-14,2015-03-07
Brown,Harvard,62,72,1,-10,2015-03-07
James Madison,Hofstra,57,74,1,-17,2015-03-07
Incarnate Word,Houston Baptist,77,78,1,-1,2015-03-07
Idaho,Idaho State,65,67,1,-2,2015-03-07
Wichita State,Illinois State,62,65,1,-3,2015-03-07
Michigan State,Indiana,74,72,0,2,2015-03-07
Siena,Iona,71,74,1,-3,2015-03-07
Northwestern,Iowa,52,69,1,-17,2015-03-07
Alabama State,Jackson State,62,42,0,20,2015-03-07
Florida,Kentucky,50,67,1,-17,2015-03-07
Dayton,La Salle,53,55,1,-2,2015-03-07
Winthrop,Longwood,71,58,0,13,2015-03-07
Texas State,Louisiana-Monroe,53,56,1,-3,2015-03-07
Virginia,Louisville,57,59,1,-2,2015-03-07
Northern Iowa,Loyola (IL),63,49,0,14,2015-03-07
Marist,Manhattan,58,74,1,-16,2015-03-07
DePaul,Marquette,48,58,1,-10,2015-03-07
VMI,Mercer,61,89,1,-28,2015-03-07
Rutgers,Michigan,69,79,1,-10,2015-03-07
Vanderbilt,Ole Miss,86,77,0,9,2015-03-07
Missouri,Mississippi State,43,52,1,-9,2015-03-07
Montana,Montana State,70,54,0,16,2015-03-07
Wyoming,New Mexico,49,52,1,-3,2015-03-07
Chicago State,New Mexico State,57,61,1,-4,2015-03-07
Duke,UNC,84,77,0,7,2015-03-07
Wofford,UNC Greensboro,70,52,0,18,2015-03-07
Syracuse,NC State,57,71,1,-14,2015-03-07
Sacramento State,Northern Arizona,68,70,1,-2,2015-03-07
North Dakota,Northern Colorado,71,72,1,-1,2015-03-07
New Orleans,Northwestern State,78,88,1,-10,2015-03-07
Clemson,Notre Dame,67,81,1,-14,2015-03-07
Kansas,Oklahoma,73,75,1,-2,2015-03-07
Western Kentucky,Old Dominion,52,75,1,-23,2015-03-07
Cornell,Penn,72,79,1,-7,2015-03-07
San Diego,Pepperdine,47,50,1,-3,2015-03-07
Saint Mary's,Portland,52,69,1,-17,2015-03-07
Alcorn State,Prairie View,80,83,1,-3,2015-03-07
Columbia,Princeton,83,85,1,-2,2015-03-07
Butler,Providence,68,64,0,4,2015-03-07
Illinois,Purdue,58,63,1,-5,2015-03-07
St. Joseph's,Rhode Island,68,78,1,-10,2015-03-07
Saint Louis,Richmond,51,67,1,-16,2015-03-07
St. Peter's,Rider,68,59,0,9,2015-03-07
Bryant,Robert Morris,53,66,1,-13,2015-03-07
Nevada,San Diego State,43,67,1,-24,2015-03-07
UNLV,San Jose State,71,58,0,13,2015-03-07
Troy,South Alabama,93,96,1,-3,2015-03-07
Western Illinois,South Dakota State,50,87,1,-37,2015-03-07
Tulane,South Florida,67,63,0,4,2015-03-07
Nicholls State,Southeastern Louisiana,75,69,0,6,2015-03-07
Portland State,Southern Utah,86,73,0,13,2015-03-07
Fordham,St. Bonaventure,52,66,1,-14,2015-03-07
Saint Francis (PA),St. Francis (NY),48,62,1,-14,2015-03-07
Sam Houston State,Stephen F. Austin,55,64,1,-9,2015-03-07
UConn,Temple,63,75,1,-12,2015-03-07
South Carolina,Tennessee,60,49,0,11,2015-03-07
Kansas State,Texas,49,62,1,-13,2015-03-07
Alabama,Texas A&M,61,60,0,1,2015-03-07
Abilene Christian,Texas A&M-Corpus Christi,27,58,1,-31,2015-03-07
Iowa State,TCU,89,76,0,13,2015-03-07
Rice,UTEP,65,68,1,-3,2015-03-07
UMKC,Texas-Rio Grande Valley,51,53,1,-2,2015-03-07
North Texas,UTSA,68,69,1,-1,2015-03-07
Southern,Texas Southern,78,88,1,-10,2015-03-07
Colorado State,Utah State,75,70,0,5,2015-03-07
Cal State Bakersfield,Utah Valley,69,74,1,-5,2015-03-07
Cleveland State,Valparaiso,55,60,1,-5,2015-03-07
St. John's (NY),Villanova,68,105,1,-37,2015-03-07
George Mason,VCU,60,71,1,-11,2015-03-07
Miami (FL),Virginia Tech,82,61,0,21,2015-03-07
Utah,Washington,68,77,1,-9,2015-03-07
Colorado,Washington State,91,96,1,-5,2015-03-07
Eastern Washington,Weber State,79,71,0,8,2015-03-07
Oklahoma State,West Virginia,72,81,1,-9,2015-03-07
New Hampshire,Albany (NY),58,60,1,-2,2015-03-08
Lafayette,Bucknell,80,74,0,6,2015-03-08
Memphis,Cincinnati,65,77,1,-12,2015-03-08
Winthrop,Coastal Carolina,70,81,1,-11,2015-03-08
American,Colgate,73,62,0,11,2015-03-08
Mercer,Furman,49,52,1,-3,2015-03-08
William & Mary,Hofstra,92,91,0,1,2015-03-08
East Carolina,Houston,54,72,1,-18,2015-03-08
Northern Iowa,Illinois State,69,60,0,9,2015-03-08
Monmouth,Iona,77,95,1,-18,2015-03-08
South Dakota,Purdue-Fort Wayne,82,73,0,9,2015-03-08
Oral Roberts,IUPUI,58,56,0,2,2015-03-08
St. Peter's,Manhattan,48,65,1,-17,2015-03-08
Central Arkansas,McNeese State,68,70,1,-2,2015-03-08
Penn State,Minnesota,79,76,0,3,2015-03-08
Maryland,Nebraska,64,61,0,3,2015-03-08
Northeastern,UNC Wilmington,78,71,0,7,2015-03-08
USC Upstate,North Florida,57,63,1,-6,2015-03-08
Wisconsin,Ohio State,72,48,0,24,2015-03-08
Tulsa,SMU,62,67,1,-5,2015-03-08
Stony Brook,Vermont,79,77,0,2,2015-03-08
Wofford,Western Carolina,73,61,0,12,2015-03-08
Northern Illinois,Akron,52,76,1,-24,2015-03-09
Ball State,Bowling Green State,75,88,1,-13,2015-03-09
Portland,BYU,70,84,1,-14,2015-03-09
Savannah State,Delaware State,58,64,1,-6,2015-03-09
Miami (OH),Eastern Michigan,61,62,1,-1,2015-03-09
Wofford,Furman,67,64,0,3,2015-03-09
Pepperdine,Gonzaga,61,79,1,-18,2015-03-09
Morgan State,Hampton,71,91,1,-20,2015-03-09
Manhattan,Iona,79,69,0,10,2015-03-09
Oral Roberts,North Dakota State,56,60,1,-4,2015-03-09
William & Mary,Northeastern,61,72,1,-11,2015-03-09
South Dakota State,South Dakota,78,65,0,13,2015-03-09
Ohio,Western Michigan,74,82,1,-8,2015-03-09
Grambling,Alcorn State,52,66,1,-14,2015-03-10
Coppin State,Bethune-Cookman,64,60,0,4,2015-03-10
Georgia Tech,Boston College,65,66,1,-1,2015-03-10
Gonzaga,BYU,91,75,0,16,2015-03-10
South Carolina State,North Carolina A&T,63,54,0,9,2015-03-10
South Dakota State,North Dakota State,56,57,1,-1,2015-03-10
Princeton,Penn,73,52,0,21,2015-03-10
Robert Morris,St. Francis (NY),66,63,0,3,2015-03-10
Green Bay,Valparaiso,44,54,1,-10,2015-03-10
Wake Forest,Virginia Tech,80,81,1,-1,2015-03-10
New Mexico,Air Force,61,68,1,-7,2015-03-11
Western Michigan,Akron,45,58,1,-13,2015-03-11
Mississippi Valley State,Alabama State,81,93,1,-12,2015-03-11
Texas Southern,Alcorn State,95,74,0,21,2015-03-11
USC,Arizona State,67,64,0,3,2015-03-11
Mississippi State,Auburn,68,74,1,-6,2015-03-11
UNC,Boston College,81,63,0,18,2015-03-11
Eastern Michigan,Bowling Green State,73,67,0,6,2015-03-11
Washington State,California,59,84,1,-25,2015-03-11
Middle Tennessee,Charlotte,63,60,0,3,2015-03-11
Florida State,Clemson,76,73,0,3,2015-03-11
Oregon State,Colorado,71,78,1,-7,2015-03-11
North Carolina Central,Coppin State,91,43,0,48,2015-03-11
DePaul,Creighton,63,78,1,-15,2015-03-11
Saint Louis,Duquesne,55,61,1,-6,2015-03-11
UTSA,Florida International,54,57,1,-3,2015-03-11
George Mason,Fordham,65,71,1,-6,2015-03-11
TCU,Kansas State,67,65,0,2,2015-03-11
American,Lafayette,63,65,1,-2,2015-03-11
Seton Hall,Marquette,56,78,1,-22,2015-03-11
Western Kentucky,Marshall,59,45,0,14,2015-03-11
Southeastern Louisiana,McNeese State,60,62,1,-2,2015-03-11
Virginia Tech,Miami (FL),49,59,1,-10,2015-03-11
Rutgers,Minnesota,68,80,1,-12,2015-03-11
South Carolina,Missouri,63,54,0,9,2015-03-11
Penn State,Nebraska,68,65,0,3,2015-03-11
Nevada,UNLV,46,67,1,-21,2015-03-11
Nicholls State,New Orleans,73,82,1,-9,2015-03-11
South Carolina State,Norfolk State,54,68,1,-14,2015-03-11
Pitt,NC State,70,81,1,-11,2015-03-11
Rice,North Texas,82,54,0,28,2015-03-11
Washington,Stanford,69,71,1,-2,2015-03-11
Texas Tech,Texas,53,65,1,-12,2015-03-11
Boise State,Air Force,80,68,0,12,2015-03-12
Kent State,Akron,51,53,1,-2,2015-03-12
Florida,Alabama,69,61,0,8,2015-03-12
Southern,Alabama A&M,64,60,0,4,2015-03-12
Western Kentucky,Alabama-Birmingham,52,53,1,-1,2015-03-12
California,Arizona,51,73,1,-22,2015-03-12
South Alabama,Little Rock,57,55,0,2,2015-03-12
Texas A&M,Auburn,59,66,1,-7,2015-03-12
West Virginia,Baylor,70,80,1,-10,2015-03-12
Xavier,Butler,67,61,0,6,2015-03-12
UCSB,Cal Poly,54,50,0,4,2015-03-12
Utah Valley,Cal State Bakersfield,40,55,1,-15,2015-03-12
UC-Davis,Cal State Northridge,71,67,0,4,2015-03-12
UC-Riverside,UC-Irvine,54,63,1,-9,2015-03-12
East Carolina,UCF,81,80,0,1,2015-03-12
Seattle,Chicago State,49,45,0,4,2015-03-12
Oregon,Colorado,93,85,0,8,2015-03-12
Fresno State,Colorado State,59,71,1,-12,2015-03-12
South Florida,UConn,43,69,1,-26,2015-03-12
Georgetown,Creighton,60,55,0,5,2015-03-12
Howard,Delaware State,60,65,1,-5,2015-03-12
NC State,Duke,53,77,1,-24,2015-03-12
George Washington,Duquesne,73,55,0,18,2015-03-12
Toledo,Eastern Michigan,78,67,0,11,2015-03-12
Idaho,Eastern Washington,83,91,1,-8,2015-03-12
UTEP,Florida International,83,71,0,12,2015-03-12
Virginia,Florida State,58,44,0,14,2015-03-12
VCU,Fordham,63,57,0,6,2015-03-12
Maryland-Eastern Shore,Hampton,71,76,1,-5,2015-03-12
Long Beach State,Hawaii,72,79,1,-7,2015-03-12
Tulane,Houston,60,66,1,-6,2015-03-12
Michigan,Illinois,73,55,0,18,2015-03-12
Northwestern,Indiana,56,71,1,-15,2015-03-12
Penn State,Iowa,67,58,0,9,2015-03-12
Texas,Iowa State,67,69,1,-2,2015-03-12
Prairie View,Jackson State,62,56,0,6,2015-03-12
TCU,Kansas,59,64,1,-5,2015-03-12
UMass,La Salle,69,76,1,-7,2015-03-12
Rice,Louisiana Tech,64,70,1,-6,2015-03-12
UNC,Louisville,70,60,0,10,2015-03-12
Villanova,Marquette,84,49,0,35,2015-03-12
Northwestern State,McNeese State,96,89,0,7,2015-03-12
Notre Dame,Miami (FL),70,63,0,7,2015-03-12
Old Dominion,Middle Tennessee,52,59,1,-7,2015-03-12
Ohio State,Minnesota,79,73,0,6,2015-03-12
South Carolina,Ole Miss,60,58,0,2,2015-03-12
Texas-Rio Grande Valley,UMKC,61,70,1,-9,2015-03-12
Weber State,Montana,73,76,1,-3,2015-03-12
San Diego State,UNLV,67,64,0,3,2015-03-12
Texas A&M-Corpus Christi,New Orleans,61,58,0,3,2015-03-12
Northern Colorado,Northern Arizona,57,63,1,-6,2015-03-12
Oklahoma State,Oklahoma,49,64,1,-15,2015-03-12
Sacramento State,Portland State,70,60,0,10,2015-03-12
St. John's (NY),Providence,57,74,1,-17,2015-03-12
St. Bonaventure,St. Joseph's,60,49,0,11,2015-03-12
UCLA,USC,96,70,0,26,2015-03-12
Utah,Stanford,80,56,0,24,2015-03-12
Vanderbilt,Tennessee,61,67,1,-6,2015-03-12
Texas State,Texas-Arlington,68,62,0,6,2015-03-12
Wyoming,Utah State,67,65,0,2,2015-03-12
Buffalo,Akron,68,59,0,9,2015-03-13
Louisiana Tech,Alabama-Birmingham,62,72,1,-10,2015-03-13
Southern,Alabama State,68,66,0,2,2015-03-13
UCLA,Arizona,64,70,1,-6,2015-03-13
Tennessee,Arkansas,72,80,1,-8,2015-03-13
LSU,Auburn,70,73,1,-3,2015-03-13
Kansas,Baylor,62,52,0,10,2015-03-13
Wyoming,Boise State,71,66,0,5,2015-03-13
New Mexico State,Cal State Bakersfield,57,53,0,4,2015-03-13
Hawaii,UC-Davis,65,58,0,7,2015-03-13
UCSB,UC-Irvine,63,72,1,-9,2015-03-13
Toledo,Central Michigan,66,75,1,-9,2015-03-13
UConn,Cincinnati,57,54,0,3,2015-03-13
San Diego State,Colorado State,56,43,0,13,2015-03-13
La Salle,Davidson,66,67,1,-1,2015-03-13
St. Bonaventure,Dayton,71,75,1,-4,2015-03-13
North Carolina Central,Delaware State,57,63,1,-6,2015-03-13
Notre Dame,Duke,74,64,0,10,2015-03-13
SMU,East Carolina,74,68,0,6,2015-03-13
Sacramento State,Eastern Washington,83,91,1,-8,2015-03-13
Kentucky,Florida,64,49,0,15,2015-03-13
Rhode Island,George Washington,71,58,0,13,2015-03-13
Xavier,Georgetown,65,63,0,2,2015-03-13
South Carolina,Georgia,62,74,1,-12,2015-03-13
Norfolk State,Hampton,64,75,1,-11,2015-03-13
Tulsa,Houston,59,51,0,8,2015-03-13
Maryland,Indiana,75,69,0,6,2015-03-13
Oklahoma,Iowa State,65,67,1,-2,2015-03-13
Texas State,Louisiana,43,53,1,-10,2015-03-13
South Alabama,Louisiana-Monroe,59,77,1,-18,2015-03-13
Temple,Memphis,80,75,0,5,2015-03-13
Wisconsin,Michigan,71,60,0,11,2015-03-13
Ohio State,Michigan State,67,76,1,-9,2015-03-13
UTEP,Middle Tennessee,50,53,1,-3,2015-03-13
Seattle,UMKC,69,63,0,6,2015-03-13
Northern Arizona,Montana,59,61,1,-2,2015-03-13
Virginia,UNC,67,71,1,-4,2015-03-13
Stephen F. Austin,Northwestern State,91,79,0,12,2015-03-13
Utah,Oregon,64,67,1,-3,2015-03-13
Purdue,Penn State,64,59,0,5,2015-03-13
Texas Southern,Prairie View,90,77,0,13,2015-03-13
Villanova,Providence,63,61,0,2,2015-03-13
VCU,Richmond,70,67,0,3,2015-03-13
Texas A&M-Corpus Christi,Sam Houston State,67,70,1,-3,2015-03-13
Middle Tennessee,Alabama-Birmingham,60,73,1,-13,2015-03-14
Stony Brook,Albany (NY),50,51,1,-1,2015-03-14
Oregon,Arizona,52,80,1,-28,2015-03-14
Georgia,Arkansas,49,60,1,-11,2015-03-14
Kentucky,Auburn,91,67,0,24,2015-03-14
Central Michigan,Buffalo,84,89,1,-5,2015-03-14
Hawaii,UC-Irvine,58,67,1,-9,2015-03-14
Tulsa,UConn,42,47,1,-5,2015-03-14
VCU,Davidson,93,73,0,20,2015-03-14
Rhode Island,Dayton,52,56,1,-4,2015-03-14
Hampton,Delaware State,82,61,0,21,2015-03-14
Louisiana-Monroe,Georgia Southern,43,44,1,-1,2015-03-14
Louisiana,Georgia State,79,83,1,-4,2015-03-14
Yale,Harvard,51,53,1,-2,2015-03-14
Kansas,Iowa State,66,70,1,-4,2015-03-14
Michigan State,Maryland,62,58,0,4,2015-03-14
Eastern Washington,Montana,69,65,0,4,2015-03-14
Seattle,New Mexico State,61,80,1,-19,2015-03-14
Notre Dame,UNC,90,82,0,8,2015-03-14
Wisconsin,Purdue,71,51,0,20,2015-03-14
Stephen F. Austin,Sam Houston State,83,70,0,13,2015-03-14
Wyoming,San Diego State,45,43,0,2,2015-03-14
Texas Southern,Southern,62,58,0,4,2015-03-14
Temple,SMU,56,69,1,-13,2015-03-14
Xavier,Villanova,52,69,1,-17,2015-03-14
Kentucky,Arkansas,78,63,0,15,2015-03-15
SMU,UConn,62,54,0,8,2015-03-15
VCU,Dayton,71,65,0,6,2015-03-15
Georgia State,Georgia Southern,38,36,0,2,2015-03-15
Wisconsin,Michigan State,80,69,0,11,2015-03-15
New Hampshire,NJIT,77,84,1,-7,2015-03-16
Illinois,Alabama,58,79,1,-21,2015-03-17
Ole Miss,BYU,94,90,0,4,2015-03-17
Norfolk State,Eastern Kentucky,75,81,1,-6,2015-03-17
Manhattan,Hampton,64,74,1,-10,2015-03-17
Louisiana,Incarnate Word,83,68,0,15,2015-03-17
Central Michigan,Louisiana Tech,79,89,1,-10,2015-03-17
Rider,Loyola (IL),59,62,1,-3,2015-03-17
North Carolina Central,Miami (FL),71,75,1,-4,2015-03-17
UTEP,Murray State,66,81,1,-15,2015-03-17
Eastern Illinois,Oakland,97,91,0,6,2015-03-17
George Washington,Pitt,60,54,0,6,2015-03-17
Iona,Rhode Island,75,88,1,-13,2015-03-17
Bowling Green State,Saint Francis (PA),67,64,0,3,2015-03-17
James Madison,USC Upstate,72,73,1,-1,2015-03-17
UC-Davis,Stanford,64,77,1,-13,2015-03-17
Montana,Texas A&M,64,81,1,-17,2015-03-17
William & Mary,Tulsa,67,70,1,-3,2015-03-17
Dayton,Boise State,56,55,0,1,2015-03-18
Dartmouth,Canisius,72,87,1,-15,2015-03-18
Gardner-Webb,Colorado,78,87,1,-9,2015-03-18
South Dakota State,Colorado State,86,76,0,10,2015-03-18
Arizona State,UConn,68,61,0,7,2015-03-18
Radford,Delaware State,78,57,0,21,2015-03-18
Purdue-Fort Wayne,Evansville,77,82,1,-5,2015-03-18
Texas A&M-Corpus Christi,Florida Gulf Coast,75,69,0,6,2015-03-18
Northern Arizona,Grand Canyon,75,70,0,5,2015-03-18
Maryland-Eastern Shore,High Point,64,70,1,-6,2015-03-18
Vermont,Hofstra,85,81,0,4,2015-03-18
Green Bay,Illinois State,56,69,1,-13,2015-03-18
Eastern Michigan,Louisiana-Monroe,67,71,1,-4,2015-03-18
Stony Brook,Mercer,70,72,1,-2,2015-03-18
Kent State,Middle Tennessee,68,56,0,12,2015-03-18
Robert Morris,North Florida,81,77,0,4,2015-03-18
Charleston Southern,Old Dominion,56,65,1,-9,2015-03-18
UCSB,Oral Roberts,87,91,1,-4,2015-03-18
Sacramento State,Portland,73,66,0,7,2015-03-18
St. Francis (NY),Richmond,74,84,1,-10,2015-03-18
Vanderbilt,Saint Mary's,75,64,0,11,2015-03-18
UNC Wilmington,Sam Houston State,71,87,1,-16,2015-03-18
Pepperdine,Seattle,45,62,1,-17,2015-03-18
Bucknell,Temple,67,73,1,-6,2015-03-18
Cleveland State,Western Michigan,86,57,0,29,2015-03-18
Iowa State,Alabama-Birmingham,59,60,1,-1,2015-03-19
Texas Southern,Arizona,72,93,1,-21,2015-03-19
Wofford,Arkansas,53,56,1,-3,2015-03-19
Georgia State,Baylor,57,56,0,1,2015-03-19
Texas,Butler,48,56,1,-8,2015-03-19
Purdue,Cincinnati,65,66,1,-1,2015-03-19
Georgetown,Eastern Washington,84,74,0,10,2015-03-19
Kentucky,Hampton,79,56,0,23,2015-03-19
UNC,Harvard,67,65,0,2,2015-03-19
Villanova,Lafayette,93,52,0,41,2015-03-19
NC State,LSU,66,65,0,1,2015-03-19
Xavier,Ole Miss,76,57,0,19,2015-03-19
Notre Dame,Northeastern,69,65,0,4,2015-03-19
UT-Martin,Northwestern State,104,79,0,25,2015-03-19
VCU,Ohio State,72,75,1,-3,2015-03-19
UCLA,SMU,60,59,0,1,2015-03-19
Utah,Stephen F. Austin,57,50,0,7,2015-03-19
Oklahoma,Albany (NY),69,60,0,9,2015-03-20
Virginia,Belmont,79,67,0,12,2015-03-20
West Virginia,Buffalo,68,62,0,6,2015-03-20
Louisville,UC-Irvine,57,55,0,2,2015-03-20
Wisconsin,Coastal Carolina,86,72,0,14,2015-03-20
Iowa,Davidson,83,52,0,31,2015-03-20
Providence,Dayton,53,66,1,-13,2015-03-20
Robert Morris,Duke,56,85,1,-29,2015-03-20
High Point,Eastern Kentucky,65,66,1,-1,2015-03-20
Michigan State,Georgia,70,63,0,7,2015-03-20
North Dakota State,Gonzaga,76,86,1,-10,2015-03-20
Wichita State,Indiana,81,76,0,5,2015-03-20
New Mexico State,Kansas,56,75,1,-19,2015-03-20
Valparaiso,Maryland,62,65,1,-3,2015-03-20
Wyoming,Northern Iowa,54,71,1,-17,2015-03-20
Oregon,Oklahoma State,79,73,0,6,2015-03-20
St. John's (NY),San Diego State,64,76,1,-12,2015-03-20
South Dakota State,Vanderbilt,77,92,1,-15,2015-03-20
UCLA,Alabama-Birmingham,92,75,0,17,2015-03-21
Ohio State,Arizona,58,73,1,-15,2015-03-21
UNC,Arkansas,87,78,0,9,2015-03-21
Canisius,Bowling Green State,82,59,0,23,2015-03-21
Notre Dame,Butler,67,64,0,3,2015-03-21
Kentucky,Cincinnati,64,51,0,13,2015-03-21
Utah,Georgetown,75,64,0,11,2015-03-21
Xavier,Georgia State,75,67,0,8,2015-03-21
Alabama,Miami (FL),66,73,1,-7,2015-03-21
Villanova,NC State,68,71,1,-3,2015-03-21
Northern Arizona,Sacramento State,78,73,0,5,2015-03-21
Louisiana,Sam Houston State,71,70,0,1,2015-03-21
UT-Martin,USC Upstate,60,49,0,11,2015-03-21
Oklahoma,Dayton,72,66,0,6,2015-03-22
San Diego State,Duke,49,68,1,-19,2015-03-22
Iowa,Gonzaga,68,87,1,-19,2015-03-22
Wichita State,Kansas,78,65,0,13,2015-03-22
Northern Iowa,Louisville,53,66,1,-13,2015-03-22
West Virginia,Maryland,69,59,0,10,2015-03-22
Virginia,Michigan State,54,60,1,-6,2015-03-22
Wisconsin,Oregon,72,65,0,7,2015-03-22
Arizona State,Richmond,70,76,1,-6,2015-03-22
Rhode Island,Stanford,65,74,1,-9,2015-03-22
George Washington,Temple,77,90,1,-13,2015-03-22
Evansville,Eastern Illinois,83,68,0,15,2015-03-23
Oral Roberts,Loyola (IL),78,86,1,-8,2015-03-23
Louisiana-Monroe,Mercer,71,69,0,2,2015-03-23
Cleveland State,NJIT,77,80,1,-3,2015-03-23
Illinois State,Old Dominion,49,50,1,-1,2015-03-23
Colorado,Seattle,65,72,1,-7,2015-03-23
Louisiana Tech,Texas A&M,84,72,0,12,2015-03-23
Kent State,Texas A&M-Corpus Christi,69,65,0,4,2015-03-23
Murray State,Tulsa,83,62,0,21,2015-03-23
Radford,Vermont,71,78,1,-7,2015-03-23
Miami (FL),Richmond,63,61,0,2,2015-03-24
Vanderbilt,Stanford,75,78,1,-3,2015-03-24
UT-Martin,Eastern Kentucky,70,69,0,1,2015-03-25
Vermont,Louisiana-Monroe,65,71,1,-6,2015-03-25
Seattle,Loyola (IL),48,63,1,-15,2015-03-25
Murray State,Old Dominion,69,72,1,-3,2015-03-25
Louisiana Tech,Temple,59,77,1,-18,2015-03-25
Xavier,Arizona,60,68,1,-8,2015-03-26
West Virginia,Kentucky,39,78,1,-39,2015-03-26
Evansville,Louisiana,89,82,0,7,2015-03-26
Wisconsin,UNC,79,72,0,7,2015-03-26
Wichita State,Notre Dame,70,81,1,-11,2015-03-26
Utah,Duke,57,63,1,-6,2015-03-27
UCLA,Gonzaga,62,74,1,-12,2015-03-27
NC State,Louisville,65,75,1,-10,2015-03-27
Oklahoma,Michigan State,58,62,1,-4,2015-03-27
Kent State,Northern Arizona,73,74,1,-1,2015-03-27
Wisconsin,Arizona,85,78,0,7,2015-03-28
Notre Dame,Kentucky,66,68,1,-2,2015-03-28
Canisius,NJIT,73,78,1,-5,2015-03-28
Gonzaga,Duke,52,66,1,-14,2015-03-29
Michigan State,Louisville,76,70,0,6,2015-03-29
Louisiana-Monroe,Loyola (IL),58,65,1,-7,2015-03-30
UT-Martin,Evansville,66,79,1,-13,2015-03-31
Temple,Miami (FL),57,60,1,-3,2015-03-31
NJIT,Northern Arizona,61,68,1,-7,2015-03-31
Stanford,Old Dominion,67,60,0,7,2015-03-31
Loyola (IL),Louisiana-Monroe,63,62,0,1,2015-04-01
Northern Arizona,Evansville,65,71,1,-6,2015-04-02
Stanford,Miami (FL),66,64,0,2,2015-04-02
Michigan State,Duke,61,81,1,-20,2015-04-04
Wisconsin,Kentucky,71,64,0,7,2015-04-04
Wisconsin,Duke,63,68,1,-5,2015-04-06
