Road,Home,Road_score,Home_score,Home_w,margin,Date
Schreiner,Abilene Christian,59,73,1,-14,2016-11-11
McPherson,Air Force,71,88,1,-17,2016-11-11
Coastal Carolina,Alabama,53,70,1,-17,2016-11-11
Arkansas-Pine Bluff,Alabama-Birmingham,66,86,1,-20,2016-11-11
Portland State,Arizona State,70,88,1,-18,2016-11-11
Purdue-Fort Wayne,Arkansas,83,92,1,-9,2016-11-11
North Florida,Auburn,66,83,1,-17,2016-11-11
Oral Roberts,Baylor,61,76,1,-15,2016-11-11
Cornell,Binghamton,62,68,1,-6,2016-11-11
Nicholls State,Boston College,79,73,0,6,2016-11-11
Illinois-Springfield,Bradley,55,70,1,-15,2016-11-11
Manhattan,Bucknell,64,76,1,-12,2016-11-11
Cal Tech,Cal State Fullerton,28,77,1,-49,2016-11-11
Pomona-Pitzer,Cal State Northridge,72,96,1,-24,2016-11-11
South Dakota State,California,53,82,1,-29,2016-11-11
Tennessee State,UC-Davis,78,64,0,14,2016-11-11
Utah State,UC-Irvine,72,56,0,16,2016-11-11
Hartford,Central Connecticut,60,75,1,-15,2016-11-11
Indiana-Kokomo,Central Michigan,53,117,1,-64,2016-11-11
Newberry,Charlotte,88,101,1,-13,2016-11-11
Brown,Cincinnati,55,84,1,-29,2016-11-11
Georgia,Clemson,64,74,1,-10,2016-11-11
Citadel,College of Charleston,68,81,1,-13,2016-11-11
Sacramento State,Colorado,53,90,1,-37,2016-11-11
Wagner,UConn,67,58,0,9,2016-11-11
UMKC,Creighton,82,89,1,-7,2016-11-11
Austin Peay,Dayton,68,96,1,-28,2016-11-11
Goldey-Beacom,Delaware,56,64,1,-8,2016-11-11
Clarks Summit,Delaware State,56,103,1,-47,2016-11-11
Adrian,Detroit,69,99,1,-30,2016-11-11
South Dakota,Drake,79,74,0,5,2016-11-11
Marist,Duke,49,94,1,-45,2016-11-11
Loyola (MD),Duquesne,60,65,1,-5,2016-11-11
Grambling,East Carolina,57,72,1,-15,2016-11-11
Fordham,ETSU,59,96,1,-37,2016-11-11
St. Francis (IL),Eastern Illinois,41,83,1,-42,2016-11-11
IUPUI,Eastern Kentucky,87,97,1,-10,2016-11-11
Linfield,Eastern Washington,47,70,1,-23,2016-11-11
Peace,Elon,68,101,1,-33,2016-11-11
Sacred Heart,Fairfield,63,85,1,-22,2016-11-11
Florida Gulf Coast,Florida,59,80,1,-21,2016-11-11
Texas State,Florida Atlantic,61,57,0,4,2016-11-11
Florida Memorial,Florida International,57,76,1,-19,2016-11-11
UTSA,Fresno State,66,69,1,-3,2016-11-11
Maryland-Eastern Shore,George Washington,71,75,1,-4,2016-11-11
Thomas University,Georgia State,69,111,1,-42,2016-11-11
Tennessee Tech,Georgia Tech,55,70,1,-15,2016-11-11
Utah Valley,Gonzaga,69,92,1,-23,2016-11-11
Rider,Hampton,67,56,0,11,2016-11-11
SIU-Edwardsville,Hawaii,69,68,0,1,2016-11-11
Coppin State,Hofstra,72,74,1,-2,2016-11-11
Morgan State,Houston,52,93,1,-41,2016-11-11
Southeast Missouri State,Illinois,62,81,1,-19,2016-11-11
Kennesaw State,Iowa,74,91,1,-17,2016-11-11
Savannah State,Iowa State,71,113,1,-42,2016-11-11
Xavier (LA),Jackson State,54,66,1,-12,2016-11-11
Indiana,Kansas,103,99,0,4,2016-11-11
Western Illinois,Kansas State,55,82,1,-27,2016-11-11
Stephen F. Austin,Kentucky,64,87,1,-23,2016-11-11
Howard Payne,Lamar,47,90,1,-43,2016-11-11
Cairn,Liberty,53,81,1,-28,2016-11-11
Sewanee,Lipscomb,53,96,1,-43,2016-11-11
Cal State Los Angeles,Long Beach State,59,95,1,-36,2016-11-11
John Jay,LIU-Brooklyn,40,78,1,-38,2016-11-11
Centenary (LA),Louisiana-Monroe,63,96,1,-33,2016-11-11
Evansville,Louisville,47,78,1,-31,2016-11-11
Alcorn State,Loyola (IL),44,69,1,-25,2016-11-11
Vanguard,Loyola Marymount,51,99,1,-48,2016-11-11
Vanderbilt,Marquette,71,95,1,-24,2016-11-11
American,Maryland,56,62,1,-6,2016-11-11
Hood,UMBC,61,92,1,-31,2016-11-11
UMass-Lowell,UMass,76,90,1,-14,2016-11-11
Brewton-Parker,Mercer,53,87,1,-34,2016-11-11
Western Carolina,Miami (FL),43,92,1,-49,2016-11-11
Muskingum,Miami (OH),57,84,1,-27,2016-11-11
Howard,Michigan,58,76,1,-18,2016-11-11
Arizona,Michigan State,65,63,0,2,2016-11-11
Milligan,Middle Tennessee,64,102,1,-38,2016-11-11
Milwaukee Engineering,Milwaukee,58,88,1,-30,2016-11-11
Louisiana,Minnesota,74,86,1,-12,2016-11-11
UT-Martin,Ole Miss,83,86,1,-3,2016-11-11
Norfolk State,Mississippi State,74,78,1,-4,2016-11-11
Alabama A&M,Missouri State,62,96,1,-34,2016-11-11
Drexel,Monmouth,65,78,1,-13,2016-11-11
Kentucky Christian,Morehead State,41,106,1,-65,2016-11-11
Illinois State,Murray State,70,73,1,-3,2016-11-11
Ohio State,Navy,78,68,0,10,2016-11-11
South Alabama,UNLV,76,68,0,8,2016-11-11
Lesley,New Hampshire,60,85,1,-25,2016-11-11
Idaho State,New Mexico,70,81,1,-11,2016-11-11
Arizona Christian,New Mexico State,52,100,1,-48,2016-11-11
LaGrange,New Orleans,67,103,1,-36,2016-11-11
Buffalo,Niagara,76,66,0,10,2016-11-11
Sarah Lawrence,NJIT,38,100,1,-62,2016-11-11
Greensboro,North Carolina A&T,50,67,1,-17,2016-11-11
Virginia,UNC Greensboro,76,51,0,25,2016-11-11
Georgia Southern,NC State,79,81,1,-2,2016-11-11
Claflin,UNC Wilmington,64,110,1,-46,2016-11-11
Crown College,North Dakota,48,98,1,-50,2016-11-11
Arkansas State,North Dakota State,66,76,1,-10,2016-11-11
Sul Ross State,North Texas,77,85,1,-8,2016-11-11
Boston University,Northeastern,77,87,1,-10,2016-11-11
Indiana State,Northern Illinois,78,80,1,-2,2016-11-11
Earlham,Northern Kentucky,56,96,1,-40,2016-11-11
Mississippi Valley State,Northwestern,63,94,1,-31,2016-11-11
Bowling Green State,Oakland,70,78,1,-8,2016-11-11
Campbell,Oklahoma State,65,102,1,-37,2016-11-11
James Madison,Old Dominion,55,62,1,-7,2016-11-11
Army,Oregon,77,91,1,-14,2016-11-11
Prairie View,Oregon State,58,78,1,-20,2016-11-11
Albany (NY),Penn State,87,81,0,6,2016-11-11
Cal Poly,Pepperdine,68,77,1,-9,2016-11-11
Eastern Michigan,Pitt,90,93,1,-3,2016-11-11
UC-Riverside,Portland,55,71,1,-16,2016-11-11
Furman,Presbyterian,71,73,1,-2,2016-11-11
McNeese State,Purdue,65,109,1,-44,2016-11-11
Dartmouth,Rhode Island,61,84,1,-23,2016-11-11
VMI,Richmond,69,72,1,-3,2016-11-11
Penn,Robert Morris,67,50,0,17,2016-11-11
Molloy,Rutgers,57,86,1,-29,2016-11-11
Ball State,Saint Louis,85,64,0,21,2016-11-11
Nevada,Saint Mary's,63,81,1,-18,2016-11-11
San Diego,San Diego State,59,69,1,-10,2016-11-11
UIC,San Francisco,80,82,1,-2,2016-11-11
Northern Arizona,Santa Clara,64,67,1,-3,2016-11-11
Pacific Lutheran,Seattle,65,76,1,-11,2016-11-11
Fairleigh Dickinson,Seton Hall,70,91,1,-21,2016-11-11
Louisiana Tech,South Carolina,76,85,1,-9,2016-11-11
Florida A&M,South Florida,73,84,1,-11,2016-11-11
Millsaps,Southeastern Louisiana,39,85,1,-46,2016-11-11
Montana,USC,61,75,1,-14,2016-11-11
Wright State,Southern Illinois,85,81,0,4,2016-11-11
Gardner-Webb,SMU,44,72,1,-28,2016-11-11
Tougaloo,Southern Miss,96,101,1,-5,2016-11-11
Bethune-Cookman,St. John's (NY),53,100,1,-47,2016-11-11
Harvard,Stanford,70,80,1,-10,2016-11-11
Webber,Stetson,62,78,1,-16,2016-11-11
Columbia,Stony Brook,73,66,0,7,2016-11-11
Colgate,Syracuse,55,83,1,-28,2016-11-11
La Salle,Temple,92,97,1,-5,2016-11-11
Chattanooga,Tennessee,82,69,0,13,2016-11-11
Incarnate Word,Texas,73,78,1,-5,2016-11-11
Northwestern State,Texas A&M,44,72,1,-28,2016-11-11
Our Lady of the Lake,Texas A&M-Corpus Christi,100,115,1,-15,2016-11-11
St. Thomas (TX),TCU,64,82,1,-18,2016-11-11
Houston Baptist,Texas Tech,67,93,1,-26,2016-11-11
Toccoa Falls,Troy,76,135,1,-59,2016-11-11
UNC,Tulane,95,75,0,20,2016-11-11
Jacksonville State,Tulsa,84,73,0,11,2016-11-11
Pacific,UCLA,80,119,1,-39,2016-11-11
Southern Utah,Valparaiso,65,79,1,-14,2016-11-11
Lafayette,Villanova,48,88,1,-40,2016-11-11
UNC Asheville,VCU,65,80,1,-15,2016-11-11
Maine,Virginia Tech,67,80,1,-13,2016-11-11
Radford,Wake Forest,59,80,1,-21,2016-11-11
Montana State,Washington State,65,69,1,-4,2016-11-11
Antelope Valley,Weber State,65,128,1,-63,2016-11-11
Mount St. Mary's,West Virginia,59,87,1,-28,2016-11-11
Marygrove,Western Michigan,74,90,1,-16,2016-11-11
South Carolina State,Wichita State,39,85,1,-46,2016-11-11
Central Arkansas,Wisconsin,47,79,1,-32,2016-11-11
Western State,Wyoming,49,88,1,-39,2016-11-11
Lehigh,Xavier,81,84,1,-3,2016-11-11
Central Baptist,Little Rock,65,97,1,-32,2016-11-12
Northwest University,Boise State,46,85,1,-39,2016-11-12
Northern Colorado,Butler,52,89,1,-37,2016-11-12
San Diego Christian,Cal State Bakersfield,54,96,1,-42,2016-11-12
Omaha,UCSB,74,60,0,14,2016-11-12
Illinois Tech,Chicago State,89,97,1,-8,2016-11-12
Kent State,Cleveland State,79,74,0,5,2016-11-12
Appalachian State,Davidson,74,86,1,-12,2016-11-12
Jacksonville,Denver,92,84,0,8,2016-11-12
Grand Canyon,Duke,61,96,1,-35,2016-11-12
Charleston Southern,Florida State,67,88,1,-21,2016-11-12
Towson,George Mason,67,61,0,6,2016-11-12
USC Upstate,Georgetown,60,105,1,-45,2016-11-12
Northland,Green Bay,49,84,1,-35,2016-11-12
Averett,High Point,41,74,1,-33,2016-11-12
Corban,Idaho,67,90,1,-23,2016-11-12
Wofford,LSU,69,91,1,-22,2016-11-12
North Carolina Central,Marshall,69,81,1,-12,2016-11-12
Tennessee State,Northern Arizona,69,65,0,4,2016-11-12
Coe,Northern Iowa,37,74,1,-37,2016-11-12
Bryant,Notre Dame,64,89,1,-25,2016-11-12
Southern,Ohio,67,77,1,-10,2016-11-12
Vermont,Quinnipiac,94,70,0,24,2016-11-12
Toledo,St. Joseph's,76,77,1,-1,2016-11-12
LeTourneau,Sam Houston State,57,104,1,-47,2016-11-12
West Coast Baptist,San Jose State,70,109,1,-39,2016-11-12
UC-Davis,Santa Clara,63,58,0,5,2016-11-12
Saint Francis (PA),St. Bonaventure,82,92,1,-10,2016-11-12
Texas Southern,Texas-Arlington,82,89,1,-7,2016-11-12
Louisiana College,UTEP,54,88,1,-34,2016-11-12
Northwest Nazarene,Utah,37,81,1,-44,2016-11-12
Trinity Christian,Valparaiso,75,89,1,-14,2016-11-12
Alabama State,Western Kentucky,66,79,1,-13,2016-11-12
Bridgewater (VA),William & Mary,44,96,1,-52,2016-11-12
Ferrum,Winthrop,47,66,1,-19,2016-11-12
Akron,Youngstown State,82,90,1,-8,2016-11-12
Cal Poly,Arizona State,74,96,1,-22,2016-11-13
Delaware,Bradley,63,49,0,14,2016-11-13
Niagara,Brown,79,88,1,-9,2016-11-13
Portland State,Cal State Fullerton,100,106,1,-6,2016-11-13
Northern Arizona,UC-Davis,76,89,1,-13,2016-11-13
Bristol University,UC-Riverside,45,81,1,-36,2016-11-13
Johnson University,Citadel,84,146,1,-62,2016-11-13
New Mexico State,Colorado State,61,64,1,-3,2016-11-13
Texas Southern,Delaware State,74,61,0,13,2016-11-13
Robert Morris,DePaul,72,78,1,-6,2016-11-13
Mercer,Florida,54,76,1,-22,2016-11-13
SIU-Edwardsville,Florida Atlantic,77,68,0,9,2016-11-13
Texas State,Hawaii,68,74,1,-6,2016-11-13
Northern Kentucky,Illinois,64,79,1,-15,2016-11-13
Savannah State,Iowa,84,116,1,-32,2016-11-13
Kenyon,Purdue-Fort Wayne,60,117,1,-57,2016-11-13
Rice,James Madison,94,70,0,24,2016-11-13
Canisius,Kentucky,69,93,1,-24,2016-11-13
Maine,Longwood,80,58,0,22,2016-11-13
Indiana-Northwest,Loyola (IL),51,100,1,-49,2016-11-13
UMBC,Maryland-Eastern Shore,77,73,0,4,2016-11-13
IUPUI,Michigan,65,77,1,-12,2016-11-13
Alabama A&M,Missouri,44,99,1,-55,2016-11-13
Jacksonville State,Missouri State,65,91,1,-26,2016-11-13
Lipscomb,Morehead State,75,89,1,-14,2016-11-13
Washington College,Navy,47,74,1,-27,2016-11-13
Sacramento State,Nebraska,61,83,1,-22,2016-11-13
Shenandoah,Norfolk State,58,78,1,-20,2016-11-13
Chattanooga,UNC,57,97,1,-40,2016-11-13
St. Francis (NY),NC State,61,86,1,-25,2016-11-13
Minnesota-Morris,North Dakota State,62,92,1,-30,2016-11-13
Northwestern State,Oklahoma,61,97,1,-36,2016-11-13
UTSA,Oregon State,64,72,1,-8,2016-11-13
Duquesne,Penn State,74,82,1,-8,2016-11-13
Drexel,Rutgers,66,87,1,-21,2016-11-13
Tennessee State,Santa Clara,69,61,0,8,2016-11-13
Central Connecticut,Seton Hall,58,82,1,-24,2016-11-13
Cornell,Siena,78,89,1,-11,2016-11-13
Holy Cross,South Carolina,49,81,1,-32,2016-11-13
Bowling Green State,South Dakota,72,78,1,-6,2016-11-13
Hannibal-LaGrange,Southeast Missouri State,54,86,1,-32,2016-11-13
Omaha,USC,72,82,1,-10,2016-11-13
Eastern Michigan,SMU,64,91,1,-27,2016-11-13
Texas-Rio Grande Valley,UT-Martin,80,88,1,-8,2016-11-13
Cal State Northridge,UCLA,87,102,1,-15,2016-11-13
Bucknell,Wake Forest,74,94,1,-20,2016-11-13
Yale,Washington,98,90,0,8,2016-11-13
Hiwassee,Western Carolina,47,87,1,-40,2016-11-13
Oak Hills,Western Illinois,48,95,1,-47,2016-11-13
Long Beach State,Wichita State,55,92,1,-37,2016-11-13
Jacksonville,Air Force,68,86,1,-18,2016-11-14
Furman,Alabama-Birmingham,84,74,0,10,2016-11-14
Southern Illinois,Arkansas,65,90,1,-25,2016-11-14
University of the Ozarks,Little Rock,61,100,1,-39,2016-11-14
Ecclesia,Arkansas-Pine Bluff,47,83,1,-36,2016-11-14
Central Baptist,Arkansas State,57,100,1,-43,2016-11-14
Georgia State,Auburn,65,83,1,-18,2016-11-14
Oakland City,Austin Peay,67,107,1,-40,2016-11-14
Princeton,BYU,73,82,1,-9,2016-11-14
South Dakota State,UC-Irvine,58,73,1,-15,2016-11-14
Nicholls State,UCF,56,80,1,-24,2016-11-14
Albany (NY),Cincinnati,51,74,1,-23,2016-11-14
College of Charleston,Coastal Carolina,71,64,0,7,2016-11-14
Seattle,Colorado,55,67,1,-12,2016-11-14
Northeastern,UConn,64,61,0,3,2016-11-14
North Carolina A&T,East Carolina,51,61,1,-10,2016-11-14
Detroit,ETSU,78,107,1,-29,2016-11-14
UNC Wilmington,Eastern Kentucky,78,69,0,9,2016-11-14
Charlotte,Elon,100,95,0,5,2016-11-14
Alcorn State,Evansville,59,82,1,-23,2016-11-14
NYIT,Fordham,75,101,1,-26,2016-11-14
Prairie View,Fresno State,84,78,0,6,2016-11-14
UNC Asheville,Georgia,46,60,1,-14,2016-11-14
Coastal Georgia,Georgia Southern,43,92,1,-49,2016-11-14
Southern,Georgia Tech,62,77,1,-15,2016-11-14
San Diego State,Gonzaga,48,69,1,-21,2016-11-14
Florida Atlantic,Hawaii,63,64,1,-1,2016-11-14
Mount St. Mary's,Iowa State,55,73,1,-18,2016-11-14
Brewton-Parker,Kennesaw State,74,80,1,-6,2016-11-14
William & Mary,Louisville,58,91,1,-33,2016-11-14
Eureka,Loyola (IL),59,97,1,-38,2016-11-14
Millersville,Loyola (MD),66,79,1,-13,2016-11-14
Howard,Marquette,49,81,1,-32,2016-11-14
Wagner,UMass-Lowell,76,87,1,-11,2016-11-14
Texas-Rio Grande Valley,Memphis,75,94,1,-19,2016-11-14
Texas-Arlington,Minnesota,67,84,1,-17,2016-11-14
UMass,Ole Miss,88,90,1,-2,2016-11-14
Wyoming,Montana,73,72,0,1,2016-11-14
Louisiana,Montana State,83,84,1,-1,2016-11-14
Loyola Marymount,Nevada,64,79,1,-15,2016-11-14
Houston Baptist,New Mexico,79,95,1,-16,2016-11-14
Presbyterian,UNC Greensboro,42,61,1,-19,2016-11-14
Edward Waters,North Florida,73,109,1,-36,2016-11-14
Roosevelt,Northern Illinois,55,99,1,-44,2016-11-14
Eastern Washington,Northwestern,72,86,1,-14,2016-11-14
Western Michigan,Oakland,60,77,1,-17,2016-11-14
Sam Houston State,Ohio,75,96,1,-21,2016-11-14
North Carolina Central,Ohio State,63,69,1,-6,2016-11-14
Central Arkansas,Oklahoma State,90,102,1,-12,2016-11-14
Rogers State,Oral Roberts,76,87,1,-11,2016-11-14
Green Bay,Pacific,58,76,1,-18,2016-11-14
Gardner-Webb,Pitt,80,99,1,-19,2016-11-14
Vermont,Providence,58,80,1,-22,2016-11-14
Villanova,Purdue,79,76,0,3,2016-11-14
Marist,Rhode Island,65,107,1,-42,2016-11-14
Old Dominion,Richmond,64,61,0,3,2016-11-14
Columbia,St. Joseph's,65,85,1,-20,2016-11-14
Southern Utah,Saint Louis,76,88,1,-12,2016-11-14
Lafayette,St. Peter's,61,57,0,4,2016-11-14
Samford,San Diego,83,65,0,18,2016-11-14
Blue Mountain College,South Alabama,35,88,1,-53,2016-11-14
St. Andrews,South Carolina State,76,93,1,-17,2016-11-14
Mars Hill,USC Upstate,66,91,1,-25,2016-11-14
Texas State,SIU-Edwardsville,86,58,0,28,2016-11-14
Binghamton,St. John's (NY),61,77,1,-16,2016-11-14
Florida International,Stetson,67,82,1,-15,2016-11-14
New Hampshire,Temple,57,52,0,5,2016-11-14
Central Michigan,Tennessee Tech,86,74,0,12,2016-11-14
Louisiana-Monroe,Texas,59,80,1,-21,2016-11-14
American,Texas A&M,53,76,1,-23,2016-11-14
Alabama State,TCU,62,98,1,-36,2016-11-14
Eastern Illinois,Troy,67,70,1,-3,2016-11-14
Southeastern Louisiana,Tulane,76,93,1,-17,2016-11-14
NJIT,Utah State,84,93,1,-9,2016-11-14
Coppin State,Valparaiso,58,78,1,-20,2016-11-14
Mississippi Valley State,West Virginia,66,107,1,-41,2016-11-14
Buffalo,Xavier,53,86,1,-33,2016-11-14
Johnson & Wales,Air Force,62,105,1,-43,2016-11-15
Dayton,Alabama,77,72,0,5,2016-11-15
Cal State Bakersfield,Arizona,66,78,1,-12,2016-11-15
Mt. St. Mary (NY),Army,53,91,1,-38,2016-11-15
Indiana State,Ball State,80,74,0,6,2016-11-15
Oregon,Baylor,49,66,1,-17,2016-11-15
Maryland-Eastern Shore,Boston College,57,73,1,-16,2016-11-15
Salve Regina,Bryant,61,88,1,-27,2016-11-15
Bridgewater (VA),Campbell,45,101,1,-56,2016-11-15
Columbia International,Charleston Southern,53,90,1,-37,2016-11-15
Truett-McConnell,Citadel,90,119,1,-29,2016-11-15
Canisius,Cleveland State,64,67,1,-3,2016-11-15
Wisconsin,Creighton,67,79,1,-12,2016-11-15
Fairfield,Dartmouth,79,62,0,17,2016-11-15
Rochester (MI),Eastern Michigan,63,78,1,-15,2016-11-15
Fairleigh Dickinson-Florham,Fairleigh Dickinson,48,96,1,-48,2016-11-15
Trinity Baptist,Florida A&M,62,94,1,-32,2016-11-15
Iona,Florida State,78,99,1,-21,2016-11-15
Lebanon Valley,George Mason,65,90,1,-25,2016-11-15
Siena,George Washington,75,77,1,-2,2016-11-15
Maryland,Georgetown,76,75,0,1,2016-11-15
Niagara,Hartford,78,82,1,-4,2016-11-15
McKendree,Illinois,65,112,1,-47,2016-11-15
St. Edward's,Incarnate Word,90,93,1,-3,2016-11-15
Duke,Kansas,75,77,1,-2,2016-11-15
Omaha,Kansas State,68,81,1,-13,2016-11-15
Delaware,La Salle,68,74,1,-6,2016-11-15
VCU,Liberty,64,59,0,5,2016-11-15
Piedmont,Lipscomb,70,99,1,-29,2016-11-15
Southern Miss,LSU,61,78,1,-17,2016-11-15
Winthrop,Manhattan,94,81,0,13,2016-11-15
Louisiana College,McNeese State,85,75,0,10,2016-11-15
Kentucky,Michigan State,69,48,0,21,2016-11-15
Murray State,Middle Tennessee,81,87,1,-6,2016-11-15
Drake,UMKC,62,68,1,-6,2016-11-15
Towson,Morgan State,78,72,0,6,2016-11-15
Mary,Nebraska,38,70,1,-32,2016-11-15
Elizabeth City State,Norfolk State,55,91,1,-36,2016-11-15
Long Beach State,UNC,67,93,1,-26,2016-11-15
Mayville State,North Dakota,66,94,1,-28,2016-11-15
Grand Canyon,Penn State,76,85,1,-9,2016-11-15
Weber State,Pepperdine,68,69,1,-1,2016-11-15
Hofstra,Sacred Heart,86,90,1,-4,2016-11-15
Portland,San Jose State,79,66,0,13,2016-11-15
Monmouth,South Carolina,69,70,1,-1,2016-11-15
Cal State Northridge,Stanford,69,96,1,-27,2016-11-15
Longwood,Stephen F. Austin,60,66,1,-6,2016-11-15
Holy Cross,Syracuse,46,90,1,-44,2016-11-15
Appalachian State,Tennessee,94,103,1,-9,2016-11-15
Cumberland,UT-Martin,64,95,1,-31,2016-11-15
North Texas,Texas Tech,43,70,1,-27,2016-11-15
Youngstown State,Toledo,98,103,1,-5,2016-11-15
Concordia (OR),Utah,53,96,1,-43,2016-11-15
Belmont,Vanderbilt,66,80,1,-14,2016-11-15
St. Francis (NY),Virginia,32,72,1,-40,2016-11-15
Southern Virginia,VMI,47,78,1,-31,2016-11-15
High Point,Virginia Tech,73,99,1,-26,2016-11-15
Central Washington,Washington State,76,81,1,-5,2016-11-15
Allen,Wofford,77,117,1,-40,2016-11-15
Miami (OH),Wright State,87,89,1,-2,2016-11-15
SUNY-Oneonta,Albany (NY),56,97,1,-41,2016-11-16
Kennesaw State,Bethune-Cookman,72,75,1,-3,2016-11-16
Central Connecticut,Binghamton,70,72,1,-2,2016-11-16
Robert Morris,Bucknell,62,75,1,-13,2016-11-16
Northwestern,Butler,68,70,1,-2,2016-11-16
UC-Irvine,California,65,75,1,-10,2016-11-16
San Francisco,UCSB,75,63,0,12,2016-11-16
Hiwassee,Chattanooga,54,102,1,-48,2016-11-16
Coppin State,Coastal Carolina,59,89,1,-30,2016-11-16
Fort Lewis,Colorado State,75,84,1,-9,2016-11-16
Colgate,Cornell,67,63,0,4,2016-11-16
Saint Francis (PA),Duquesne,75,89,1,-14,2016-11-16
Texas-Arlington,Florida Gulf Coast,72,85,1,-13,2016-11-16
Rider,Hartford,84,68,0,16,2016-11-16
UTSA,UIC,78,86,1,-8,2016-11-16
Purdue-Fort Wayne,Illinois State,57,75,1,-18,2016-11-16
UMass-Lowell,Indiana,78,100,1,-22,2016-11-16
Mississippi Valley State,Kent State,63,93,1,-30,2016-11-16
Loyola (MD),LIU-Brooklyn,61,65,1,-4,2016-11-16
Alabama State,Louisiana Tech,56,87,1,-31,2016-11-16
Vermont,Marist,76,72,0,4,2016-11-16
Morehead State,Marshall,77,85,1,-8,2016-11-16
Delaware State,UMBC,68,90,1,-22,2016-11-16
Milwaukee,Memphis,54,68,1,-14,2016-11-16
Mount St. Mary's,Minnesota,56,80,1,-24,2016-11-16
Rocky Mountain,Montana State,76,93,1,-17,2016-11-16
UC-Riverside,UNLV,62,74,1,-12,2016-11-16
Samford,New Mexico State,48,58,1,-10,2016-11-16
Miami (FL),North Florida,94,56,0,38,2016-11-16
Colorado Christian,Northern Colorado,73,94,1,-21,2016-11-16
Idaho,Northern Illinois,49,63,1,-14,2016-11-16
Seattle,Notre Dame,49,92,1,-43,2016-11-16
New Orleans,Oklahoma State,72,117,1,-45,2016-11-16
Lamar,Oregon State,63,60,0,3,2016-11-16
Central Pennsylvania College,Radford,69,91,1,-22,2016-11-16
Brown,Rhode Island,72,79,1,-7,2016-11-16
Texas Southern,Rice,71,68,0,3,2016-11-16
Prairie View,Saint Mary's,72,110,1,-38,2016-11-16
San Diego Christian,San Diego State,58,81,1,-23,2016-11-16
Presentation College,South Dakota,60,99,1,-39,2016-11-16
Wayne State (NE),South Dakota State,72,80,1,-8,2016-11-16
Jackson State,Southeastern Louisiana,71,84,1,-13,2016-11-16
Missouri Southern State,Southern Illinois,64,85,1,-21,2016-11-16
Texas A&M-Corpus Christi,Texas-Rio Grande Valley,94,72,0,22,2016-11-16
Bristol University,Utah State,53,96,1,-43,2016-11-16
Idaho State,Utah Valley,73,82,1,-9,2016-11-16
North Carolina Central,Western Carolina,67,59,0,8,2016-11-16
Southeast Missouri State,Western Illinois,74,71,0,3,2016-11-16
Jacksonville State,Western Kentucky,67,74,1,-7,2016-11-16
Tulsa,Wichita State,53,80,1,-27,2016-11-16
American,Akron,62,72,1,-10,2016-11-17
Troy,Alabama-Birmingham,51,74,1,-23,2016-11-17
Warren Wilson,Appalachian State,51,119,1,-68,2016-11-17
Northern Iowa,Arizona State,82,63,0,19,2016-11-17
Eastern Kentucky,Auburn,64,85,1,-21,2016-11-17
Coppin State,BYU,59,96,1,-37,2016-11-17
Nazareth,Buffalo,38,85,1,-47,2016-11-17
Cal St Dominguez Hills,Cal Poly,64,75,1,-11,2016-11-17
Holy Names,UC-Davis,75,89,1,-14,2016-11-17
Mississippi State,UCF,61,86,1,-25,2016-11-17
Marygrove,Central Michigan,58,107,1,-49,2016-11-17
East Carolina,Charlotte,64,76,1,-12,2016-11-17
Boise State,College of Charleston,47,60,1,-13,2016-11-17
Louisiana-Monroe,Colorado,70,89,1,-19,2016-11-17
Clemson,Davidson,95,78,0,17,2016-11-17
Rutgers,DePaul,66,59,0,7,2016-11-17
Johnson University,Florida A&M,91,100,1,-9,2016-11-17
Arkansas-Pine Bluff,George Washington,41,61,1,-20,2016-11-17
Arkansas State,Georgetown,78,72,0,6,2016-11-17
Furman,Georgia,78,84,1,-6,2016-11-17
North Carolina A&T,Grambling,55,59,1,-4,2016-11-17
Chowan,Hampton,69,70,1,-1,2016-11-17
Fisher College,Harvard,51,78,1,-27,2016-11-17
Seton Hall,Iowa,91,83,0,8,2016-11-17
NJIT,Lafayette,83,84,1,-1,2016-11-17
Panhandle State,Louisiana,47,117,1,-70,2016-11-17
Long Beach State,Louisville,56,88,1,-32,2016-11-17
UConn,Loyola Marymount,65,62,0,3,2016-11-17
Michigan,Marquette,79,61,0,18,2016-11-17
St. Mary's (MD),Maryland,45,93,1,-48,2016-11-17
Temple,UMass,67,70,1,-3,2016-11-17
Xavier,Missouri,83,82,0,1,2016-11-17
Fontbonne,Missouri State,27,100,1,-73,2016-11-17
Wilmington (DE),Morgan State,73,88,1,-15,2016-11-17
Abilene Christian,New Hampshire,65,57,0,8,2016-11-17
Mississippi College,Nicholls State,55,86,1,-31,2016-11-17
Benedictine,Northern Arizona,63,91,1,-28,2016-11-17
Providence,Ohio State,67,72,1,-5,2016-11-17
Tulane,Oklahoma,70,89,1,-19,2016-11-17
Valparaiso,Oregon,54,76,1,-22,2016-11-17
Life Pacific,Pepperdine,79,85,1,-6,2016-11-17
George Fox,Portland State,81,113,1,-32,2016-11-17
Antelope Valley,Sacramento State,60,82,1,-22,2016-11-17
Eastern Illinois,Saint Louis,69,74,1,-5,2016-11-17
Southern,Sam Houston State,83,91,1,-8,2016-11-17
Denver,San Jose State,74,69,0,5,2016-11-17
Middle Georgia State,Savannah State,93,101,1,-8,2016-11-17
UNC Asheville,USC Upstate,73,57,0,16,2016-11-17
Doane College,South Dakota,46,80,1,-34,2016-11-17
Elon,South Florida,74,61,0,13,2016-11-17
Pitt,SMU,67,76,1,-9,2016-11-17
Florida,St. Bonaventure,73,66,0,7,2016-11-17
Weber State,Stanford,49,67,1,-18,2016-11-17
Alabama A&M,Tennessee Tech,61,95,1,-34,2016-11-17
Eastern Washington,Texas,52,85,1,-33,2016-11-17
Wake Forest,UTEP,103,81,0,22,2016-11-17
San Diego,UCLA,68,88,1,-20,2016-11-17
Western Michigan,Villanova,65,76,1,-11,2016-11-17
Cal State Fullerton,Washington,88,104,1,-16,2016-11-17
Chicago State,Wisconsin,51,69,1,-18,2016-11-17
Lehigh,Yale,81,89,1,-8,2016-11-17
Ball State,Alabama,59,77,1,-18,2016-11-18
Selma University,Alcorn State,48,93,1,-45,2016-11-18
Sacred Heart,Arizona,65,95,1,-30,2016-11-18
Texas-Arlington,Arkansas,67,71,1,-4,2016-11-18
Idaho,Little Rock,65,57,0,8,2016-11-18
Florida Gulf Coast,Baylor,72,81,1,-9,2016-11-18
Trinity (FL),Bethune-Cookman,52,82,1,-30,2016-11-18
Mississippi State,Boise State,80,68,0,12,2016-11-18
Northeastern,Boston University,63,65,1,-2,2016-11-18
Southeast Missouri State,Bradley,78,84,1,-6,2016-11-18
UCF,College of Charleston,60,40,0,20,2016-11-18
Washington State,Creighton,77,103,1,-26,2016-11-18
Hartford,Drexel,73,87,1,-14,2016-11-18
Canisius,Duquesne,78,77,0,1,2016-11-18
Gardner-Webb,Eastern Michigan,68,76,1,-8,2016-11-18
Winthrop,Florida State,86,100,1,-14,2016-11-18
Fairleigh Dickinson,Fordham,55,68,1,-13,2016-11-18
Mount St. Mary's,George Mason,78,76,0,2,2016-11-18
Ohio,Georgia Tech,67,61,0,6,2016-11-18
Bryant,Gonzaga,70,109,1,-39,2016-11-18
UNC,Hawaii,83,68,0,15,2016-11-18
UNC Greensboro,High Point,57,63,1,-6,2016-11-18
Dallas Christian,Houston Baptist,54,98,1,-44,2016-11-18
Detroit,Illinois,69,89,1,-20,2016-11-18
Howard,IUPUI,55,77,1,-22,2016-11-18
Youngstown State,Jacksonville,54,79,1,-25,2016-11-18
Siena,Kansas,65,86,1,-21,2016-11-18
Hiram,Kent State,55,111,1,-56,2016-11-18
St. Peter's,Lipscomb,90,77,0,13,2016-11-18
Salem International,Longwood,74,87,1,-13,2016-11-18
North Florida,LSU,70,78,1,-8,2016-11-18
St. Joseph's,Loyola (IL),71,57,0,14,2016-11-18
Hofstra,Manhattan,68,80,1,-12,2016-11-18
Pitt,Marquette,78,75,0,3,2016-11-18
Delaware,Miami (OH),68,66,0,2,2016-11-18
Mississippi Valley State,Michigan State,53,100,1,-47,2016-11-18
St. John's (NY),Minnesota,86,92,1,-6,2016-11-18
Davidson,Missouri,70,55,0,15,2016-11-18
James Madison,Montana State,73,80,1,-7,2016-11-18
Oregon State,Nevada,58,83,1,-25,2016-11-18
New Mexico State,New Mexico,59,72,1,-13,2016-11-18
Jackson State,North Carolina Central,75,84,1,-9,2016-11-18
Montana,NC State,72,85,1,-13,2016-11-18
Navy,North Dakota State,59,66,1,-7,2016-11-18
Austin Peay,Northern Kentucky,77,69,0,8,2016-11-18
LeTourneau,Northwestern State,87,92,1,-5,2016-11-18
Loyola (MD),Notre Dame,48,83,1,-35,2016-11-18
Goshen,Oakland,59,102,1,-43,2016-11-18
Northern Iowa,Oklahoma,73,67,0,6,2016-11-18
Ole Miss,Oral Roberts,95,88,0,7,2016-11-18
Lewis & Clark,Portland,52,98,1,-46,2016-11-18
Georgia State,Purdue,56,64,1,-8,2016-11-18
Florida International,South Alabama,64,69,1,-5,2016-11-18
South Carolina State,South Carolina,50,92,1,-42,2016-11-18
Southern Illinois,SIU-Edwardsville,101,83,0,18,2016-11-18
Michigan,SMU,76,54,0,22,2016-11-18
Union (TN),Southern Miss,44,60,1,-16,2016-11-18
Bethesda University (CA),Southern Utah,92,108,1,-16,2016-11-18
Northeastern State,Stephen F. Austin,70,75,1,-5,2016-11-18
Citadel,Stetson,116,112,0,4,2016-11-18
Monmouth,Syracuse,50,71,1,-21,2016-11-18
Cleveland State,UT-Martin,74,85,1,-11,2016-11-18
USC,Texas A&M,65,63,0,2,2016-11-18
Jacksonville State,TCU,60,79,1,-19,2016-11-18
Western Michigan,UTEP,75,85,1,-10,2016-11-18
Arizona State,Tulane,80,71,0,9,2016-11-18
Coppin State,Utah,51,94,1,-43,2016-11-18
Norfolk State,Vanderbilt,52,75,1,-23,2016-11-18
Binghamton,VCU,42,81,1,-39,2016-11-18
Villanova,Wake Forest,96,77,0,19,2016-11-18
Clemson,Xavier,77,83,1,-6,2016-11-18
Arkansas State,Army,60,57,0,3,2016-11-19
Western Kentucky,Belmont,69,90,1,-21,2016-11-19
Maine,Boston University,78,102,1,-24,2016-11-19
UMKC,Bowling Green State,71,69,0,2,2016-11-19
Coastal Carolina,BYU,65,81,1,-16,2016-11-19
Marist,Brown,87,79,0,8,2016-11-19
Bucknell,Butler,60,86,1,-26,2016-11-19
Bethesda University (CA),Cal Poly,52,69,1,-17,2016-11-19
UCSB,Cal State Bakersfield,70,77,1,-7,2016-11-19
Northern Illinois,Cal State Northridge,82,84,1,-2,2016-11-19
Pacific,UC-Irvine,65,72,1,-7,2016-11-19
Fresno Pacific,UC-Riverside,50,96,1,-46,2016-11-19
USC Upstate,Charleston Southern,79,77,0,2,2016-11-19
Central Arkansas,Chattanooga,64,75,1,-11,2016-11-19
Rhode Island,Cincinnati,76,71,0,5,2016-11-19
Saint Mary's,Dayton,61,57,0,4,2016-11-19
Northern Kentucky,Delaware,74,53,0,21,2016-11-19
Simpson,Drake,61,76,1,-15,2016-11-19
Penn State,Duke,68,78,1,-10,2016-11-19
Western Illinois,Eastern Illinois,64,73,1,-9,2016-11-19
Morehead State,Evansville,56,69,1,-13,2016-11-19
Lipscomb,Fairleigh Dickinson,72,90,1,-18,2016-11-19
St. Peter's,Fordham,41,63,1,-22,2016-11-19
Lamar,Fresno State,64,83,1,-19,2016-11-19
Trinity Baptist,Furman,53,102,1,-49,2016-11-19
Albany (NY),Grand Canyon,77,82,1,-5,2016-11-19
Murray State,Green Bay,93,77,0,16,2016-11-19
Navy,High Point,62,69,1,-7,2016-11-19
Gardner-Webb,Howard,94,78,0,16,2016-11-19
Trinity Christian,UIC,66,102,1,-36,2016-11-19
Liberty,Indiana,48,87,1,-39,2016-11-19
Missouri-St. Louis,Indiana State,55,96,1,-41,2016-11-19
UMass-Lowell,Purdue-Fort Wayne,81,94,1,-13,2016-11-19
Eastern Michigan,IUPUI,71,83,1,-12,2016-11-19
Florida International,Jacksonville,75,78,1,-3,2016-11-19
Texas Southern,La Salle,77,76,0,1,2016-11-19
Northeastern,LIU-Brooklyn,74,78,1,-4,2016-11-19
Western Carolina,Marshall,63,98,1,-35,2016-11-19
Kennesaw State,UMBC,85,93,1,-8,2016-11-19
Savannah State,Memphis,86,99,1,-13,2016-11-19
Penn,Miami (FL),62,74,1,-12,2016-11-19
Austin Peay,Miami (OH),70,76,1,-6,2016-11-19
Tennessee State,Middle Tennessee,74,63,0,11,2016-11-19
Campbell,Morgan State,66,82,1,-16,2016-11-19
Louisiana Tech,Nebraska,54,65,1,-11,2016-11-19
Rice,Omaha,100,87,0,13,2016-11-19
Cal State Fullerton,UNLV,68,77,1,-9,2016-11-19
Colgate,NJIT,68,74,1,-6,2016-11-19
North Dakota State,UNC Greensboro,54,65,1,-11,2016-11-19
Chicago State,Oakland,79,107,1,-28,2016-11-19
Loyola (IL),Oral Roberts,78,53,0,25,2016-11-19
Grambling,Providence,54,71,1,-17,2016-11-19
Chatham,Saint Francis (PA),59,119,1,-60,2016-11-19
Northern Colorado,Santa Clara,72,88,1,-16,2016-11-19
Youngstown State,South Alabama,75,84,1,-9,2016-11-19
Rider,South Florida,65,70,1,-5,2016-11-19
Prairie View,UTSA,59,69,1,-10,2016-11-19
Eastern Kentucky,Texas Tech,71,90,1,-19,2016-11-19
New Orleans,Tulsa,68,77,1,-9,2016-11-19
Idaho State,Utah State,51,85,1,-34,2016-11-19
Benedictine,Utah Valley,52,86,1,-34,2016-11-19
Lyndon State,Vermont,20,79,1,-59,2016-11-19
VMI,Virginia Tech,72,88,1,-16,2016-11-19
Fairfield,Wagner,70,64,0,6,2016-11-19
Montana,Washington State,63,87,1,-24,2016-11-19
Presbyterian,William & Mary,59,89,1,-30,2016-11-19
Toledo,Wright State,82,78,0,4,2016-11-19
South Dakota State,Wyoming,67,77,1,-10,2016-11-19
Florida A&M,Air Force,62,87,1,-25,2016-11-20
Radford,Akron,41,88,1,-47,2016-11-20
Brown,Albany (NY),76,80,1,-4,2016-11-20
Davidson,Arizona State,68,60,0,8,2016-11-20
Central Arkansas,Army,81,76,0,5,2016-11-20
Western Michigan,Boise State,70,91,1,-21,2016-11-20
Stony Brook,Boston College,75,82,1,-7,2016-11-20
LIU-Brooklyn,Boston University,69,86,1,-17,2016-11-20
Green Bay,Bowling Green State,77,61,0,16,2016-11-20
Villanova,UCF,67,57,0,10,2016-11-20
Arkansas State,Chattanooga,73,67,0,6,2016-11-20
Wake Forest,College of Charleston,78,61,0,17,2016-11-20
NC State,Creighton,94,112,1,-18,2016-11-20
Austin Peay,Delaware,76,75,0,1,2016-11-20
Milwaukee,DePaul,59,77,1,-18,2016-11-20
Rhode Island,Duke,65,75,1,-10,2016-11-20
Stetson,East Carolina,50,73,1,-23,2016-11-20
Edward Waters,Florida Atlantic,64,98,1,-34,2016-11-20
Youngstown State,Florida International,78,73,0,5,2016-11-20
Detroit,Florida State,71,100,1,-29,2016-11-20
Lipscomb,Fordham,69,85,1,-16,2016-11-20
North Dakota State,High Point,70,44,0,26,2016-11-20
UMass,Holy Cross,68,60,0,8,2016-11-20
Texas-Rio Grande Valley,Iowa,67,95,1,-28,2016-11-20
Citadel,Iowa State,63,130,1,-67,2016-11-20
Hampton,Kansas State,67,89,1,-22,2016-11-20
Duquesne,Kentucky,59,93,1,-34,2016-11-20
Cornell,Lafayette,82,75,0,7,2016-11-20
Princeton,Lehigh,67,76,1,-9,2016-11-20
Northeastern,Maine,80,72,0,8,2016-11-20
Grand Canyon,Marist,84,72,0,12,2016-11-20
Towson,Maryland,66,71,1,-5,2016-11-20
Southern-New Orleans,McNeese State,73,96,1,-23,2016-11-20
Georgia Southern,Mercer,67,80,1,-13,2016-11-20
Northern Kentucky,Miami (OH),79,70,0,9,2016-11-20
Florida Gulf Coast,Michigan State,77,78,1,-1,2016-11-20
St. Joseph's,Ole Miss,68,81,1,-13,2016-11-20
UTEP,Mississippi State,54,61,1,-7,2016-11-20
Murray State,UMKC,74,85,1,-11,2016-11-20
UNC Greensboro,Navy,72,59,0,13,2016-11-20
Iona,Nevada,76,91,1,-15,2016-11-20
Bethune-Cookman,New Mexico State,73,89,1,-16,2016-11-20
Siena,UNC Asheville,80,92,1,-12,2016-11-20
ETSU,UNC Wilmington,59,68,1,-9,2016-11-20
Presentation College,North Dakota,63,101,1,-38,2016-11-20
Drexel,North Texas,83,62,0,21,2016-11-20
Xavier,Northern Iowa,67,59,0,8,2016-11-20
Clemson,Oklahoma,64,70,1,-6,2016-11-20
Cincinnati,Penn State,71,50,0,21,2016-11-20
Robert Morris,Richmond,69,81,1,-12,2016-11-20
Niagara,Rutgers,65,78,1,-13,2016-11-20
Fairleigh Dickinson,St. Peter's,58,84,1,-26,2016-11-20
Nicholls State,San Diego,72,81,1,-9,2016-11-20
Jacksonville,South Alabama,58,71,1,-13,2016-11-20
Colorado State,Stanford,49,56,1,-7,2016-11-20
Manhattan,Temple,67,88,1,-21,2016-11-20
Sam Houston State,Tennessee Tech,78,71,0,7,2016-11-20
Missouri,Tulane,67,62,0,5,2016-11-20
Long Beach State,UCLA,77,114,1,-37,2016-11-20
Yale,Virginia,38,62,1,-24,2016-11-20
Northern Arizona,Washington,58,92,1,-34,2016-11-20
New Hampshire,West Virginia,41,100,1,-59,2016-11-20
Maryland-Eastern Shore,Wichita State,79,116,1,-37,2016-11-20
Valparaiso,Alabama,68,60,0,8,2016-11-21
Kansas,Alabama-Birmingham,83,63,0,20,2016-11-21
Northern Colorado,Arizona,55,71,1,-16,2016-11-21
Blue Mountain College,Arkansas-Pine Bluff,77,74,0,3,2016-11-21
Murray State,Bowling Green State,77,78,1,-1,2016-11-21
Hofstra,Bradley,92,90,0,2,2016-11-21
Saint Louis,BYU,62,92,1,-30,2016-11-21
Norfolk State,Butler,55,91,1,-36,2016-11-21
Samford,Campbell,66,53,0,13,2016-11-21
UT-Martin,Canisius,72,69,0,3,2016-11-21
UNC,Chaminade,104,61,0,43,2016-11-21
Notre Dame,Colorado,89,83,0,6,2016-11-21
Oklahoma State,UConn,98,90,0,8,2016-11-21
Ball State,Coppin State,79,77,0,2,2016-11-21
Ole Miss,Creighton,77,86,1,-9,2016-11-21
Troy,Eastern Illinois,67,71,1,-4,2016-11-21
Bryant,Eastern Washington,77,81,1,-4,2016-11-21
Belmont,Florida,61,78,1,-17,2016-11-21
Georgia,George Washington,81,73,0,8,2016-11-21
George Mason,Houston,56,93,1,-37,2016-11-21
South Dakota State,Idaho,89,96,1,-7,2016-11-21
Winthrop,Illinois,84,80,0,4,2016-11-21
Howard Payne,Incarnate Word,61,91,1,-30,2016-11-21
Texas Southern,James Madison,67,56,0,11,2016-11-21
UMass-Lowell,Liberty,77,84,1,-7,2016-11-21
Delaware State,Louisiana,82,83,1,-1,2016-11-21
LIU-Brooklyn,Maine,71,66,0,5,2016-11-21
Jackson State,Marshall,61,71,1,-10,2016-11-21
Green Bay,UMKC,95,77,0,18,2016-11-21
Oral Roberts,Montana,47,68,1,-21,2016-11-21
St. Joseph's,NC State,63,73,1,-10,2016-11-21
Texas,Northwestern,58,77,1,-19,2016-11-21
Western Carolina,Ohio State,38,66,1,-28,2016-11-21
Georgetown,Oregon,65,61,0,4,2016-11-21
Central Michigan,Pepperdine,88,77,0,11,2016-11-21
St. Francis (NY),Providence,48,64,1,-16,2016-11-21
Columbia,Quinnipiac,86,78,0,8,2016-11-21
Montana State,Rice,78,83,1,-5,2016-11-21
UC-Davis,Sacramento State,81,72,0,9,2016-11-21
California,San Diego State,65,77,1,-12,2016-11-21
Sacred Heart,Santa Clara,74,84,1,-10,2016-11-21
Fort Valley State,Savannah State,101,118,1,-17,2016-11-21
Louisiana-Monroe,Seattle,75,81,1,-6,2016-11-21
Kent State,South Dakota,77,80,1,-3,2016-11-21
Xavier (LA),Southeastern Louisiana,72,89,1,-17,2016-11-21
Mount St. Mary's,Southern Illinois,63,73,1,-10,2016-11-21
Alabama A&M,Southern Miss,55,63,1,-8,2016-11-21
Coastal Carolina,Southern Utah,83,68,0,15,2016-11-21
Little Rock,St. Bonaventure,68,65,0,3,2016-11-21
St. Francis (IL),Texas-Arlington,67,88,1,-21,2016-11-21
Illinois State,TCU,71,80,1,-9,2016-11-21
Texas A&M-Corpus Christi,Texas State,73,69,0,4,2016-11-21
Bucknell,Vanderbilt,75,72,0,3,2016-11-21
Wofford,Vermont,59,60,1,-1,2016-11-21
Loyola (IL),Washington State,88,79,0,9,2016-11-21
Tennessee,Wisconsin,62,74,1,-12,2016-11-21
Ohio Dominican,Wright State,54,109,1,-55,2016-11-21
Charleston Southern,Abilene Christian,66,65,0,1,2016-11-22
Stetson,Air Force,72,85,1,-13,2016-11-22
Georgia Southern,Akron,67,75,1,-8,2016-11-22
Blue Mountain College,Alcorn State,57,83,1,-26,2016-11-22
Wagner,American,73,65,0,8,2016-11-22
SIU-Edwardsville,Arkansas State,57,75,1,-18,2016-11-22
Binghamton,Ave Maria,95,77,0,18,2016-11-22
Towson,Boston College,70,80,1,-10,2016-11-22
Western New England,Boston University,54,91,1,-37,2016-11-22
Wofford,Bradley,62,70,1,-8,2016-11-22
Louisiana-Monroe,Bryant,57,64,1,-7,2016-11-22
Fresno State,Cal State Bakersfield,63,71,1,-8,2016-11-22
Penn,Central Connecticut,87,65,0,22,2016-11-22
St. Bonaventure,Central Michigan,102,71,0,31,2016-11-22
UConn,Chaminade,93,82,0,11,2016-11-22
USC Upstate,Charlotte,108,103,0,5,2016-11-22
East-West,Chicago State,75,103,1,-28,2016-11-22
Texas,Colorado,54,68,1,-14,2016-11-22
Florida A&M,East Carolina,62,82,1,-20,2016-11-22
Idaho State,Eastern Kentucky,82,91,1,-9,2016-11-22
Seattle,Eastern Washington,76,80,1,-4,2016-11-22
South Florida,Florida Atlantic,62,78,1,-16,2016-11-22
UNC Asheville,Furman,64,58,0,6,2016-11-22
Toccoa Falls,Gardner-Webb,53,103,1,-50,2016-11-22
Kent State,George Mason,75,79,1,-4,2016-11-22
Alabama-Birmingham,George Washington,81,74,0,7,2016-11-22
Wisconsin,Georgetown,73,57,0,16,2016-11-22
Kansas,Georgia,65,54,0,11,2016-11-22
Sam Houston State,Georgia Tech,73,81,1,-8,2016-11-22
Holy Cross,Harvard,63,52,0,11,2016-11-22
Hawaii-Hilo,Hawaii,55,86,1,-31,2016-11-22
Vermont,Hofstra,87,73,0,14,2016-11-22
South Dakota,Houston,58,85,1,-27,2016-11-22
Ecclesia,Houston Baptist,80,116,1,-36,2016-11-22
Indiana,Purdue-Fort Wayne,68,71,1,-3,2016-11-22
Dalton State,Jacksonville State,50,81,1,-31,2016-11-22
Robert Morris,Kansas State,40,61,1,-21,2016-11-22
Alabama State,Kennesaw State,72,79,1,-7,2016-11-22
UTSA,Lamar,58,78,1,-20,2016-11-22
IUPUI,Marquette,79,104,1,-25,2016-11-22
Stony Brook,Maryland,63,77,1,-14,2016-11-22
McNeese State,Memphis,65,104,1,-39,2016-11-22
Radford,Mercer,47,58,1,-11,2016-11-22
Toledo,Middle Tennessee,70,80,1,-10,2016-11-22
Arkansas,Minnesota,71,85,1,-14,2016-11-22
UMass-Lowell,Mississippi Valley State,76,71,0,5,2016-11-22
Cornell,Monmouth,61,76,1,-15,2016-11-22
Buena Vista,Omaha,65,112,1,-47,2016-11-22
Northern Arizona,UNLV,71,110,1,-39,2016-11-22
Nicholls State,New Mexico State,74,86,1,-12,2016-11-22
Georgia State,NJIT,74,53,0,21,2016-11-22
Oklahoma State,UNC,75,107,1,-32,2016-11-22
Waldorf,North Dakota State,52,83,1,-31,2016-11-22
Florida National University,North Florida,66,112,1,-46,2016-11-22
Louisiana State-Alexandria,Northwestern State,69,82,1,-13,2016-11-22
Northwestern,Notre Dame,66,70,1,-4,2016-11-22
Tennessee,Oregon,65,69,1,-4,2016-11-22
Wyoming,Pacific,65,73,1,-8,2016-11-22
Little Rock,Pepperdine,65,66,1,-1,2016-11-22
Yale,Pitt,70,75,1,-5,2016-11-22
Jarvis Christian,Prairie View,69,84,1,-15,2016-11-22
VMI,Presbyterian,67,77,1,-10,2016-11-22
Hampton,Richmond,52,65,1,-13,2016-11-22
San Jose State,Saint Mary's,64,81,1,-17,2016-11-22
Bethune-Cookman,San Diego,91,96,1,-5,2016-11-22
Texas-Rio Grande Valley,Southeast Missouri State,72,83,1,-11,2016-11-22
Tennessee Tech,Southern,68,80,1,-12,2016-11-22
New Orleans,USC,54,88,1,-34,2016-11-22
UCSB,SMU,57,84,1,-27,2016-11-22
South Carolina State,Syracuse,59,101,1,-42,2016-11-22
Auburn,Texas Tech,67,65,0,2,2016-11-22
Oregon State,Tulsa,64,75,1,-11,2016-11-22
Purdue,Utah State,85,64,0,21,2016-11-22
Grambling,Virginia,34,90,1,-56,2016-11-22
Long Beach State,Washington,88,94,1,-6,2016-11-22
North Carolina A&T,Western Kentucky,56,77,1,-21,2016-11-22
Westminster,Youngstown State,67,97,1,-30,2016-11-22
Saint Louis,Alabama,57,62,1,-5,2016-11-23
Buffalo,Alaska-Anchorage,85,79,0,6,2016-11-23
Citadel,Arizona State,110,127,1,-17,2016-11-23
Valparaiso,BYU,92,89,0,3,2016-11-23
Morgan State,Brown,75,81,1,-6,2016-11-23
Tennessee State,Canisius,72,58,0,14,2016-11-23
Little Rock,Central Michigan,91,79,0,12,2016-11-23
Tennessee,Chaminade,95,81,0,14,2016-11-23
Samford,Cincinnati,55,70,1,-15,2016-11-23
Maryland-Eastern Shore,Colorado State,65,76,1,-11,2016-11-23
Army,Columbia,88,83,0,5,2016-11-23
Oregon,UConn,79,69,0,10,2016-11-23
Utah Valley,Denver,88,85,0,3,2016-11-23
Missouri State,DePaul,66,68,1,-2,2016-11-23
William & Mary,Duke,67,88,1,-21,2016-11-23
UT-Martin,Duquesne,66,63,0,3,2016-11-23
Georgia State,Eastern Kentucky,82,65,0,17,2016-11-23
Madonna,Eastern Michigan,60,97,1,-37,2016-11-23
UIC,Elon,80,91,1,-11,2016-11-23
Binghamton,Florida Gulf Coast,53,69,1,-16,2016-11-23
Ave Maria,Florida International,72,89,1,-17,2016-11-23
Rider,Fordham,62,73,1,-11,2016-11-23
Bradley,George Mason,66,77,1,-11,2016-11-23
Appalachian State,Hartford,70,61,0,9,2016-11-23
Vermont,Houston,71,72,1,-1,2016-11-23
NJIT,Idaho State,71,67,0,4,2016-11-23
Trinity Baptist,Jacksonville,52,97,1,-45,2016-11-23
Louisiana,James Madison,82,70,0,12,2016-11-23
Wofford,Kent State,59,66,1,-7,2016-11-23
Cleveland State,Kentucky,70,101,1,-31,2016-11-23
Princeton,Lafayette,71,55,0,16,2016-11-23
Mississippi Valley State,Liberty,55,70,1,-15,2016-11-23
Wichita State,LSU,82,47,0,35,2016-11-23
Oklahoma Baptist,Louisiana Tech,63,79,1,-16,2016-11-23
Fairfield,Loyola (MD),66,81,1,-15,2016-11-23
UMBC,Navy,66,78,1,-12,2016-11-23
Oakland,Nevada,78,82,1,-4,2016-11-23
Detroit,New Hampshire,70,86,1,-16,2016-11-23
Drexel,Niagara,74,93,1,-19,2016-11-23
Wisconsin,UNC,56,71,1,-15,2016-11-23
Cal Poly,Northern Illinois,68,64,0,4,2016-11-23
Jackson State,Ohio State,47,78,1,-31,2016-11-23
Georgetown,Oklahoma State,70,97,1,-27,2016-11-23
Louisville,Old Dominion,68,62,0,6,2016-11-23
Colgate,Penn State,59,72,1,-13,2016-11-23
St. Bonaventure,Pepperdine,89,63,0,26,2016-11-23
Auburn,Purdue,71,96,1,-25,2016-11-23
Delaware State,Rice,58,80,1,-22,2016-11-23
North Texas,Rutgers,53,66,1,-13,2016-11-23
Longwood,Saint Francis (PA),72,87,1,-15,2016-11-23
Troy,San Francisco,67,79,1,-12,2016-11-23
Arkansas-Pine Bluff,Siena,43,66,1,-23,2016-11-23
Michigan,South Carolina,46,61,1,-15,2016-11-23
Hofstra,South Dakota,65,57,0,8,2016-11-23
Ball State,Southern Utah,94,83,0,11,2016-11-23
Michigan State,St. John's (NY),73,62,0,11,2016-11-23
Jarvis Christian,Texas A&M-Corpus Christi,61,84,1,-23,2016-11-23
Mount St. Mary's,Texas-Arlington,71,80,1,-9,2016-11-23
Southeastern Louisiana,UTEP,72,56,0,16,2016-11-23
Texas Tech,Utah State,75,51,0,24,2016-11-23
College of Charleston,Villanova,47,63,1,-16,2016-11-23
Baylor,VCU,71,63,0,8,2016-11-23
Coastal Carolina,Wake Forest,74,86,1,-12,2016-11-23
Crown College,Western Illinois,53,91,1,-38,2016-11-23
Santa Clara,Arizona,61,69,1,-8,2016-11-24
Michigan State,Baylor,58,73,1,-15,2016-11-24
Long Beach State,Binghamton,64,72,1,-8,2016-11-24
Norfolk State,Bucknell,58,84,1,-26,2016-11-24
Texas A&M,Cal State Northridge,95,73,0,22,2016-11-24
Seton Hall,Florida,76,81,1,-5,2016-11-24
Temple,Florida State,89,86,0,3,2016-11-24
Drake,Iona,53,64,1,-11,2016-11-24
Indiana State,Iowa State,71,73,1,-2,2016-11-24
Stanford,Miami (FL),53,67,1,-14,2016-11-24
Montana,Ole Miss,81,86,1,-5,2016-11-24
Dayton,Nebraska,78,80,1,-2,2016-11-24
LSU,Old Dominion,66,60,0,6,2016-11-24
Gonzaga,Quinnipiac,82,62,0,20,2016-11-24
Northern Colorado,Sacred Heart,81,59,0,22,2016-11-24
Portland,UCLA,77,99,1,-22,2016-11-24
Butler,Vanderbilt,76,66,0,10,2016-11-24
St. John's (NY),VCU,69,75,1,-6,2016-11-24
New Mexico,Virginia Tech,72,92,1,-20,2016-11-24
UC-Davis,Weber State,58,86,1,-28,2016-11-24
Illinois,West Virginia,57,89,1,-32,2016-11-24
Louisville,Wichita State,62,52,0,10,2016-11-24
Akron,Air Force,84,75,0,9,2016-11-25
Oakland,Alaska-Anchorage,71,65,0,6,2016-11-25
Butler,Arizona,69,65,0,4,2016-11-25
Nicholls State,Bethune-Cookman,76,69,0,7,2016-11-25
Presbyterian,Boise State,56,82,1,-26,2016-11-25
Northern Colorado,Bucknell,63,75,1,-12,2016-11-25
Nevada,Buffalo,67,62,0,5,2016-11-25
UIC,Cal Poly,84,71,0,13,2016-11-25
Jacksonville State,Cal State Fullerton,61,38,0,23,2016-11-25
Wyoming,California,61,71,1,-10,2016-11-25
Drake,UC-Davis,58,64,1,-6,2016-11-25
High Point,Clemson,74,83,1,-9,2016-11-25
Southeastern Louisiana,Colorado State,59,67,1,-8,2016-11-25
Mercer,East Carolina,70,66,0,4,2016-11-25
Toledo,Evansville,83,79,0,4,2016-11-25
Gonzaga,Florida,77,72,0,5,2016-11-25
Georgia Southern,Florida A&M,83,72,0,11,2016-11-25
Long Beach State,Florida Gulf Coast,67,68,1,-1,2016-11-25
Hiwassee,Furman,48,98,1,-50,2016-11-25
Gardner-Webb,Georgia,59,77,1,-18,2016-11-25
Coppin State,Grand Canyon,37,70,1,-33,2016-11-25
Troy,Hawaii,65,63,0,2,2016-11-25
Madaille,Hofstra,56,89,1,-33,2016-11-25
South Carolina State,Holy Cross,57,73,1,-16,2016-11-25
Florida State,Illinois,72,61,0,11,2016-11-25
Virginia,Iowa,74,41,0,33,2016-11-25
UNC Asheville,Kansas,57,95,1,-38,2016-11-25
Boston College,Kansas State,54,72,1,-18,2016-11-25
UT-Martin,Kentucky,76,111,1,-35,2016-11-25
VCU,LSU,85,74,0,11,2016-11-25
Baylor,Louisville,66,63,0,3,2016-11-25
Portland State,Loyola Marymount,62,78,1,-16,2016-11-25
Richmond,Maryland,82,88,1,-6,2016-11-25
Providence,Memphis,60,51,0,9,2016-11-25
Iowa State,Miami (FL),73,56,0,17,2016-11-25
ETSU,Milwaukee,86,62,0,24,2016-11-25
Southern Illinois,Minnesota,45,57,1,-12,2016-11-25
Lehigh,Mississippi State,87,73,0,14,2016-11-25
Arkansas-Monticello,UMKC,82,97,1,-15,2016-11-25
TCU,UNLV,63,59,0,4,2016-11-25
Cal State Northridge,New Mexico,89,105,1,-16,2016-11-25
Florida College,New Orleans,63,90,1,-27,2016-11-25
Sacred Heart,Norfolk State,61,59,0,2,2016-11-25
Belmont Abbey,UNC Greensboro,54,90,1,-36,2016-11-25
Middle Tennessee,UNC Wilmington,68,63,0,5,2016-11-25
North Florida,North Dakota,76,75,0,1,2016-11-25
Niagara,North Texas,71,80,1,-9,2016-11-25
Alabama State,Northern Arizona,57,71,1,-14,2016-11-25
Elon,Northern Illinois,85,80,0,5,2016-11-25
Bryant,Northwestern,66,86,1,-20,2016-11-25
Tennessee Tech,Ohio,57,68,1,-11,2016-11-25
Marshall,Ohio State,70,111,1,-41,2016-11-25
Abilene Christian,Oklahoma,64,72,1,-8,2016-11-25
St. John's (NY),Old Dominion,55,63,1,-8,2016-11-25
Fresno State,Oregon State,63,58,0,5,2016-11-25
Morehead State,Pitt,63,76,1,-13,2016-11-25
Dayton,Portland,84,74,0,10,2016-11-25
Lamar,Prairie View,91,83,0,8,2016-11-25
Rowan,Princeton,46,108,1,-62,2016-11-25
Belmont,Rhode Island,73,82,1,-9,2016-11-25
Hampton,Robert Morris,48,62,1,-14,2016-11-25
Hartford,Rutgers,75,77,1,-2,2016-11-25
Idaho,Sam Houston State,62,69,1,-7,2016-11-25
Vanderbilt,Santa Clara,76,66,0,10,2016-11-25
Quinnipiac,Seton Hall,79,90,1,-11,2016-11-25
UC-Irvine,South Dakota State,63,52,0,11,2016-11-25
SMU,USC,73,78,1,-5,2016-11-25
Savannah State,St. Francis (NY),91,97,1,-6,2016-11-25
Indiana State,Stanford,62,65,1,-3,2016-11-25
Radford,Stetson,80,66,0,14,2016-11-25
Grambling,Texas-Rio Grande Valley,93,101,1,-8,2016-11-25
Texas State,UTSA,48,63,1,-15,2016-11-25
Idaho State,Texas Tech,58,91,1,-33,2016-11-25
Stony Brook,Towson,63,88,1,-25,2016-11-25
Nebraska,UCLA,71,82,1,-11,2016-11-25
UC-Riverside,Utah,67,85,1,-18,2016-11-25
Texas A&M,Virginia Tech,68,65,0,3,2016-11-25
Western Kentucky,Washington,47,86,1,-39,2016-11-25
Iona,Weber State,76,54,0,22,2016-11-25
Temple,West Virginia,81,77,0,4,2016-11-25
Michigan State,Wichita State,77,72,0,5,2016-11-25
Cal State Bakersfield,Wright State,64,68,1,-4,2016-11-25
East Carolina,Air Force,70,63,0,7,2016-11-26
Mercer,Akron,63,65,1,-2,2016-11-26
Cal State Fullerton,Alabama State,67,76,1,-9,2016-11-26
Drake,Alaska-Anchorage,69,74,1,-5,2016-11-26
Saint Francis (PA),American,69,62,0,7,2016-11-26
Spalding,Austin Peay,63,82,1,-19,2016-11-26
Morgan State,Bowling Green State,58,90,1,-32,2016-11-26
Utah Valley,BYU,114,101,0,13,2016-11-26
Weber State,Buffalo,72,74,1,-2,2016-11-26
North Florida,Cal State Bakersfield,54,77,1,-23,2016-11-26
Oakland,UC-Davis,79,66,0,13,2016-11-26
Milwaukee,UC-Irvine,54,37,0,17,2016-11-26
Seattle,UCF,51,67,1,-16,2016-11-26
Toccoa Falls,Charleston Southern,54,101,1,-47,2016-11-26
Lipscomb,Cincinnati,68,91,1,-23,2016-11-26
Colgate,Columbia,78,81,1,-3,2016-11-26
Loyola (MD),Creighton,52,82,1,-30,2016-11-26
Marist,Dartmouth,75,69,0,6,2016-11-26
Charlotte,Davidson,57,79,1,-22,2016-11-26
Manhattan,Detroit,84,81,0,3,2016-11-26
Appalachian State,Duke,58,93,1,-35,2016-11-26
South Dakota State,ETSU,59,71,1,-12,2016-11-26
South Alabama,Eastern Illinois,62,72,1,-10,2016-11-26
Berea,Eastern Kentucky,64,92,1,-28,2016-11-26
Omaha,Eastern Michigan,77,94,1,-17,2016-11-26
Denver,Eastern Washington,80,85,1,-5,2016-11-26
Cal Poly,Elon,66,72,1,-6,2016-11-26
UNC Wilmington,Evansville,65,62,0,3,2016-11-26
Army,Fairfield,74,75,1,-1,2016-11-26
Stetson,Florida A&M,98,90,0,8,2016-11-26
Texas-Arlington,Fordham,67,63,0,4,2016-11-26
James Madison,George Mason,77,80,1,-3,2016-11-26
Penn State,George Washington,74,68,0,6,2016-11-26
Tulane,Georgia Tech,68,82,1,-14,2016-11-26
Savannah State,Grambling,104,110,1,-6,2016-11-26
Central Michigan,Green Bay,89,77,0,12,2016-11-26
Cornell,Houston,53,83,1,-30,2016-11-26
Rice,Incarnate Word,87,79,0,8,2016-11-26
Mississippi Valley State,Purdue-Fort Wayne,54,79,1,-25,2016-11-26
Western Carolina,Jackson State,58,47,0,11,2016-11-26
Chattanooga,Kennesaw State,88,71,0,17,2016-11-26
Maine-Presque Isle,Maine,45,96,1,-51,2016-11-26
Houston Baptist,Marquette,79,101,1,-22,2016-11-26
Kansas State,Maryland,68,69,1,-1,2016-11-26
Harvard,UMass,66,70,1,-4,2016-11-26
LIU-Brooklyn,UMass-Lowell,82,78,0,4,2016-11-26
Louisiana State-Alexandria,McNeese State,78,80,1,-2,2016-11-26
Iowa,Memphis,92,100,1,-8,2016-11-26
Western Illinois,Miami (OH),72,81,1,-9,2016-11-26
Mount St. Mary's,Michigan,47,64,1,-17,2016-11-26
Northwestern State,Missouri,60,84,1,-24,2016-11-26
South Carolina State,Monmouth,62,86,1,-24,2016-11-26
Delaware State,Montana State,66,91,1,-25,2016-11-26
Alabama A&M,Murray State,54,91,1,-37,2016-11-26
Penn,Navy,68,70,1,-2,2016-11-26
Iona,Nevada,75,73,0,2,2016-11-26
Western Kentucky,UNLV,61,71,1,-10,2016-11-26
Jacksonville,North Carolina A&T,66,49,0,17,2016-11-26
Loyola (IL),NC State,77,79,1,-2,2016-11-26
Jacksonville State,Northern Arizona,76,63,0,13,2016-11-26
UIC,Northern Illinois,81,92,1,-11,2016-11-26
North Carolina Central,Northern Kentucky,82,74,0,8,2016-11-26
Chicago State,Notre Dame,60,91,1,-31,2016-11-26
Virginia,Providence,63,52,0,11,2016-11-26
NJIT,Purdue,68,79,1,-11,2016-11-26
Georgia Southern,Radford,65,64,0,1,2016-11-26
Boston College,Richmond,54,67,1,-13,2016-11-26
Bethune-Cookman,Samford,65,93,1,-28,2016-11-26
New Mexico State,San Diego,56,51,0,5,2016-11-26
Sacramento State,San Francisco,59,77,1,-18,2016-11-26
IUPUI,SIU-Edwardsville,58,61,1,-3,2016-11-26
Life Pacific,Southern Utah,56,101,1,-45,2016-11-26
Hampton,Stony Brook,66,76,1,-10,2016-11-26
South Carolina,Syracuse,64,50,0,14,2016-11-26
Reinhardt,Tennessee State,64,96,1,-32,2016-11-26
Washington,TCU,80,93,1,-13,2016-11-26
St. Francis (NY),Texas-Rio Grande Valley,61,71,1,-10,2016-11-26
Middle Tennessee,Toledo,73,70,0,3,2016-11-26
Robert Morris,Towson,67,66,0,1,2016-11-26
Yale,Vermont,65,67,1,-2,2016-11-26
Campbell,VMI,67,53,0,14,2016-11-26
Rider,Wagner,70,67,0,3,2016-11-26
Central Arkansas,Western Michigan,63,80,1,-17,2016-11-26
Liberty,William & Mary,70,79,1,-9,2016-11-26
North Dakota,Wright State,79,83,1,-4,2016-11-26
Northern Iowa,Xavier,42,64,1,-22,2016-11-26
Canisius,Youngstown State,90,84,0,6,2016-11-26
Howard Payne,Abilene Christian,55,71,1,-16,2016-11-27
Siena,Albany (NY),72,81,1,-9,2016-11-27
Lehigh,Arkansas State,89,97,1,-8,2016-11-27
Southeastern Louisiana,California,55,67,1,-12,2016-11-27
ETSU,UC-Irvine,72,66,0,6,2016-11-27
USC Upstate,College of Charleston,60,72,1,-12,2016-11-27
Wofford,Colorado,60,75,1,-15,2016-11-27
Alcorn State,Colorado State,58,80,1,-22,2016-11-27
New Mexico,Dayton,57,64,1,-7,2016-11-27
Bryn Athyn,Delaware,51,84,1,-33,2016-11-27
La Salle,Drexel,89,78,0,11,2016-11-27
Cleveland State,Duquesne,71,78,1,-7,2016-11-27
San Francisco,Eastern Washington,90,96,1,-6,2016-11-27
Miami (FL),Florida,56,65,1,-9,2016-11-27
Binghamton,Florida International,57,74,1,-17,2016-11-27
Howard,Georgetown,72,85,1,-13,2016-11-27
Iowa State,Gonzaga,71,73,1,-2,2016-11-27
Arkansas-Pine Bluff,Hawaii,44,64,1,-20,2016-11-27
Monmouth,Holy Cross,80,77,0,3,2016-11-27
Ferris State,Illinois State,67,81,1,-14,2016-11-27
Mississippi Valley State,Indiana,52,85,1,-33,2016-11-27
Texas Southern,Louisiana,73,84,1,-11,2016-11-27
Maryland-Eastern Shore,Louisiana Tech,53,74,1,-21,2016-11-27
Evansville,Middle Tennessee,55,66,1,-11,2016-11-27
North Dakota State,Missouri State,50,64,1,-14,2016-11-27
Virginia Tech,Nebraska,66,53,0,13,2016-11-27
Toledo,UNC Wilmington,77,102,1,-25,2016-11-27
Cal State Bakersfield,North Dakota,55,57,1,-2,2016-11-27
Hartford,North Texas,78,81,1,-3,2016-11-27
Kent State,Northeastern,70,73,1,-3,2016-11-27
Portland State,Pepperdine,91,85,0,6,2016-11-27
Cal State Northridge,Portland,78,96,1,-18,2016-11-27
Indiana State,Quinnipiac,77,80,1,-3,2016-11-27
Denver,Sacramento State,72,61,0,11,2016-11-27
Alabama-Birmingham,Saint Mary's,63,76,1,-13,2016-11-27
Nicholls State,Samford,106,103,0,3,2016-11-27
Stanford,Seton Hall,66,52,0,14,2016-11-27
Montana,South Dakota,67,72,1,-5,2016-11-27
Milwaukee,South Dakota State,58,81,1,-23,2016-11-27
UCSB,USC,72,96,1,-24,2016-11-27
Texas A&M,UCLA,67,74,1,-7,2016-11-27
Ball State,Valparaiso,73,79,1,-6,2016-11-27
San Jose State,Washington State,88,76,0,12,2016-11-27
New Hampshire,Winthrop,65,60,0,5,2016-11-27
Prairie View,Wisconsin,50,95,1,-45,2016-11-27
North Florida,Wright State,67,75,1,-8,2016-11-27
Kentucky,Arizona State,115,69,0,46,2016-11-28
Mount St. Mary's,Arkansas,76,89,1,-13,2016-11-28
Bryant,Brown,90,91,1,-1,2016-11-28
Allen,Campbell,60,92,1,-32,2016-11-28
Appalachian State,Charlotte,72,80,1,-8,2016-11-28
Presbyterian,Citadel,83,97,1,-14,2016-11-28
Chestnut Hill,Coppin State,76,73,0,3,2016-11-28
Minnesota,Florida State,67,75,1,-8,2016-11-28
Jarvis Christian,Grambling,56,102,1,-46,2016-11-28
SIU-Edwardsville,Grand Canyon,76,64,0,12,2016-11-28
Siena Heights,Purdue-Fort Wayne,59,107,1,-48,2016-11-28
Dartmouth,Longwood,80,86,1,-6,2016-11-28
Stephen F. Austin,Louisiana-Monroe,72,77,1,-5,2016-11-28
Northwestern State,Mississippi State,59,65,1,-6,2016-11-28
North Carolina Central,Missouri,62,52,0,10,2016-11-28
Southeast Missouri State,UMKC,75,86,1,-11,2016-11-28
Arizona Christian,Montana State,73,93,1,-20,2016-11-28
High Point,Morgan State,62,61,0,1,2016-11-28
Wake Forest,Northwestern,58,65,1,-7,2016-11-28
Tulsa,Oral Roberts,79,65,0,14,2016-11-28
Boise State,Oregon,63,68,1,-5,2016-11-28
Southern Oregon,Oregon State,59,84,1,-25,2016-11-28
Boston University,St. Peter's,67,80,1,-13,2016-11-28
Savannah State,San Diego State,67,100,1,-33,2016-11-28
Kennesaw State,South Florida,69,71,1,-2,2016-11-28
Hiwassee,Tennessee Tech,47,80,1,-33,2016-11-28
Butler,Utah,68,59,0,9,2016-11-28
Manhattan,West Virginia,61,108,1,-47,2016-11-28
Charleston Southern,Alabama,46,76,1,-30,2016-11-29
Alabama A&M,Alabama-Birmingham,45,75,1,-30,2016-11-29
Jacksonville State,Alabama State,72,69,0,3,2016-11-29
Western Illinois,American,50,57,1,-7,2016-11-29
USC Upstate,Auburn,83,90,1,-7,2016-11-29
Indiana-Kokomo,Ball State,52,92,1,-40,2016-11-29
Lipscomb,Belmont,62,64,1,-2,2016-11-29
Notre Dame (CA),Bowling Green State,60,86,1,-26,2016-11-29
Little Rock,Central Arkansas,89,87,0,2,2016-11-29
William & Mary,Central Michigan,81,91,1,-10,2016-11-29
Chattanooga,Coastal Carolina,68,52,0,16,2016-11-29
Union (NY),Colgate,68,91,1,-23,2016-11-29
Hofstra,Columbia,88,86,0,2,2016-11-29
Buffalo,Creighton,72,93,1,-21,2016-11-29
Michigan State,Duke,69,78,1,-9,2016-11-29
Hampton,East Carolina,48,68,1,-20,2016-11-29
Bradley,Eastern Illinois,87,83,0,4,2016-11-29
Ave Maria,Florida Gulf Coast,60,120,1,-60,2016-11-29
Coker,Gardner-Webb,54,102,1,-48,2016-11-29
George Washington,Harvard,77,74,0,3,2016-11-29
San Jose State,Idaho,58,49,0,9,2016-11-29
Lamar,Idaho State,60,77,1,-17,2016-11-29
NC State,Illinois,74,88,1,-14,2016-11-29
Long Beach State,Kansas,61,91,1,-30,2016-11-29
Central Pennsylvania College,Liberty,48,62,1,-14,2016-11-29
Houston,LSU,65,84,1,-19,2016-11-29
UMass-Lowell,Marist,69,81,1,-12,2016-11-29
Pitt,Maryland,73,59,0,14,2016-11-29
Davidson,Mercer,78,57,0,21,2016-11-29
Pacific,Nevada,67,77,1,-10,2016-11-29
Tulane,New Orleans,59,74,1,-15,2016-11-29
Brevard,UNC Asheville,50,68,1,-18,2016-11-29
North Carolina A&T,UNC Greensboro,66,86,1,-20,2016-11-29
Iowa,Notre Dame,78,92,1,-14,2016-11-29
Northern Colorado,Oklahoma,66,87,1,-21,2016-11-29
Georgia Tech,Penn State,60,67,1,-7,2016-11-29
Villanova,Penn,82,57,0,25,2016-11-29
Samford,Saint Louis,68,64,0,4,2016-11-29
Paul Quinn,Southern,79,91,1,-12,2016-11-29
Murray State,Southern Illinois,85,89,1,-4,2016-11-29
Delaware State,St. John's (NY),79,72,0,7,2016-11-29
Florida Atlantic,UT-Martin,81,82,1,-1,2016-11-29
Texas-Arlington,Texas,72,61,0,11,2016-11-29
Texas-Rio Grande Valley,Texas A&M-Corpus Christi,68,84,1,-16,2016-11-29
McNeese State,Texas State,68,80,1,-12,2016-11-29
Rhode Island,Valparaiso,62,65,1,-3,2016-11-29
Tennessee State,Vanderbilt,59,83,1,-24,2016-11-29
Princeton,VCU,70,81,1,-11,2016-11-29
Southern Nazarene,Wichita State,57,87,1,-30,2016-11-29
Syracuse,Wisconsin,60,77,1,-17,2016-11-29
Mars Hill,Wofford,76,79,1,-3,2016-11-29
North Dakota State,Xavier,55,85,1,-30,2016-11-29
Adrian,Akron,41,95,1,-54,2016-11-30
Holy Cross,Albany (NY),55,49,0,6,2016-11-30
Texas Southern,Arizona,63,85,1,-22,2016-11-30
Cleveland State,Arkansas State,51,78,1,-27,2016-11-30
Fairleigh Dickinson,Army,78,97,1,-19,2016-11-30
Purdue-Fort Wayne,Austin Peay,103,99,0,4,2016-11-30
Sam Houston State,Baylor,45,79,1,-34,2016-11-30
Mansfield,Binghamton,71,91,1,-20,2016-11-30
SMU,Boise State,62,71,1,-9,2016-11-30
Utah State,BYU,63,77,1,-14,2016-11-30
St. Francis (NY),Brown,71,81,1,-10,2016-11-30
Yale,Bryant,70,79,1,-9,2016-11-30
Richmond,Bucknell,68,73,1,-5,2016-11-30
Pacific Union,Cal State Bakersfield,46,79,1,-33,2016-11-30
Omaha,Cal State Fullerton,83,73,0,10,2016-11-30
Louisiana Tech,California,59,68,1,-9,2016-11-30
Stetson,UCF,45,81,1,-36,2016-11-30
James Madison,Charlotte,56,65,1,-9,2016-11-30
Nebraska,Clemson,58,60,1,-2,2016-11-30
Methodist,Coastal Carolina,59,88,1,-29,2016-11-30
Colorado State,Colorado,72,58,0,14,2016-11-30
Boston University,UConn,49,51,1,-2,2016-11-30
Northeastern,Cornell,77,80,1,-3,2016-11-30
Drake,DePaul,75,77,1,-2,2016-11-30
Eastern Michigan,Detroit,87,61,0,26,2016-11-30
UMBC,Duquesne,81,72,0,9,2016-11-30
Western Kentucky,Eastern Kentucky,59,78,1,-19,2016-11-30
Florida International,Elon,81,84,1,-3,2016-11-30
Wabash,Evansville,39,83,1,-44,2016-11-30
Kennesaw State,Florida A&M,76,74,0,2,2016-11-30
Sacred Heart,Fordham,71,70,0,1,2016-11-30
Menlo,Fresno State,67,80,1,-13,2016-11-30
Coppin State,Georgetown,44,96,1,-52,2016-11-30
Morehouse,Georgia,72,86,1,-14,2016-11-30
Wright State,Georgia State,74,81,1,-7,2016-11-30
LIU-Brooklyn,Hartford,75,68,0,7,2016-11-30
Chicago State,UIC,58,74,1,-16,2016-11-30
IUPUI,Illinois State,63,77,1,-14,2016-11-30
UNC,Indiana,67,76,1,-9,2016-11-30
Northern Illinois,Indiana State,52,63,1,-11,2016-11-30
Green Bay,Kansas State,61,80,1,-19,2016-11-30
Lehigh,La Salle,81,89,1,-8,2016-11-30
Drexel,Lafayette,74,70,0,4,2016-11-30
Purdue,Louisville,64,71,1,-7,2016-11-30
Norfolk State,Loyola (IL),62,75,1,-13,2016-11-30
Central Connecticut,Maine,82,61,0,21,2016-11-30
Western Carolina,Marquette,44,90,1,-46,2016-11-30
Ohio,Marshall,88,98,1,-10,2016-11-30
Wagner,UMass,55,62,1,-7,2016-11-30
Jackson State,Memphis,69,84,1,-15,2016-11-30
Rutgers,Miami (FL),61,73,1,-12,2016-11-30
Grambling,Miami (OH),76,78,1,-2,2016-11-30
Virginia Tech,Michigan,73,70,0,3,2016-11-30
Jacksonville,Milwaukee,67,72,1,-5,2016-11-30
Middle Tennessee,Ole Miss,77,62,0,15,2016-11-30
South Dakota,UMKC,82,84,1,-2,2016-11-30
Northern Kentucky,Morehead State,84,79,0,5,2016-11-30
Abilene Christian,New Mexico,55,64,1,-9,2016-11-30
Air Force,New Mexico State,70,78,1,-8,2016-11-30
Saint Francis (PA),NJIT,70,83,1,-13,2016-11-30
Texas College,North Texas,45,73,1,-28,2016-11-30
George Mason,Northern Iowa,54,50,0,4,2016-11-30
Rogers State,Oklahoma State,85,101,1,-16,2016-11-30
Dartmouth,Old Dominion,47,59,1,-12,2016-11-30
Western Oregon,Oregon,54,93,1,-39,2016-11-30
New Hampshire,Providence,62,76,1,-14,2016-11-30
VMI,Radford,67,74,1,-7,2016-11-30
Houston Baptist,Rice,77,90,1,-13,2016-11-30
Youngstown State,Robert Morris,75,74,0,1,2016-11-30
Temple,St. Joseph's,78,72,0,6,2016-11-30
USC,San Diego,76,55,0,21,2016-11-30
Alcorn State,San Francisco,65,78,1,-13,2016-11-30
UC-Irvine,Santa Clara,58,55,0,3,2016-11-30
Voorhees,South Carolina State,85,90,1,-5,2016-11-30
Minnesota-Crookston,South Dakota State,58,90,1,-32,2016-11-30
Maryland-Eastern Shore,Southeastern Louisiana,75,85,1,-10,2016-11-30
South Alabama,Southern Miss,78,55,0,23,2016-11-30
UNLV,Southern Utah,89,81,0,8,2016-11-30
Siena,St. Bonaventure,74,81,1,-7,2016-11-30
Saint Mary's,Stanford,66,51,0,15,2016-11-30
Loyola (MD),Stony Brook,71,70,0,1,2016-11-30
Washington,TCU,71,86,1,-15,2016-11-30
Incarnate Word,Texas Tech,48,69,1,-21,2016-11-30
Goucher,Towson,37,99,1,-62,2016-11-30
UC-Riverside,UCLA,56,98,1,-42,2016-11-30
Ohio State,Virginia,61,63,1,-2,2016-11-30
Utah Valley,Washington State,76,83,1,-7,2016-11-30
UNC Wilmington,Western Michigan,97,92,0,5,2016-11-30
Furman,Winthrop,57,58,1,-1,2016-11-30
Denver,Wyoming,70,82,1,-12,2016-11-30
Stephen F. Austin,Arkansas,62,78,1,-16,2016-12-01
UT-Martin,Arkansas-Pine Bluff,73,68,0,5,2016-12-01
UTSA,Cal Poly,47,59,1,-12,2016-12-01
Sonoma State,UCSB,51,75,1,-24,2016-12-01
Navy,College of Charleston,64,70,1,-6,2016-12-01
Lees-McRae,ETSU,80,85,1,-5,2016-12-01
Mississippi Valley State,Gonzaga,63,97,1,-34,2016-12-01
Cincinnati,Iowa State,55,54,0,1,2016-12-01
Tennessee Tech,Lipscomb,85,104,1,-19,2016-12-01
Nicholls State,Louisiana,69,101,1,-32,2016-12-01
Oregon State,Mississippi State,57,74,1,-17,2016-12-01
Southern Wesleyan,North Carolina Central,55,92,1,-37,2016-12-01
Florida,North Florida,91,60,0,31,2016-12-01
Louisiana State-Shreveport,Northwestern State,74,88,1,-14,2016-12-01
Oral Roberts,Oakland,64,92,1,-28,2016-12-01
Sacramento State,Pacific,58,74,1,-16,2016-12-01
Johnson & Wales (NC),Presbyterian,63,107,1,-44,2016-12-01
Monmouth,Quinnipiac,91,72,0,19,2016-12-01
Fairfield,Rider,76,67,0,9,2016-12-01
Georgia Southern,Savannah State,94,75,0,19,2016-12-01
Northwest University,Seattle,65,82,1,-17,2016-12-01
Columbia,Seton Hall,71,95,1,-24,2016-12-01
Vermont,South Carolina,50,68,1,-18,2016-12-01
Central Arkansas,Southeast Missouri State,63,87,1,-24,2016-12-01
Panhandle State,Texas State,44,75,1,-31,2016-12-01
South Florida,Troy,80,74,0,6,2016-12-01
Montana State,Utah,84,92,1,-8,2016-12-01
Colgate,Citadel,101,108,1,-7,2016-12-02
Delaware State,Delaware,49,64,1,-15,2016-12-02
SIU-Edwardsville,Indiana,60,83,1,-23,2016-12-02
Grambling,Kent State,57,86,1,-29,2016-12-02
Canisius,Manhattan,77,76,0,1,2016-12-02
Niagara,Marist,66,72,1,-6,2016-12-02
North Dakota State,North Carolina A&T,85,67,0,18,2016-12-02
Duquesne,Pitt,64,55,0,9,2016-12-02
Iona,St. Peter's,79,65,0,14,2016-12-02
Lamar,San Francisco,63,82,1,-19,2016-12-02
Campbell,USC Upstate,73,80,1,-7,2016-12-02
Cal State Bakersfield,SMU,43,49,1,-6,2016-12-02
Alabama,Texas,68,77,1,-9,2016-12-02
St. John's (NY),Tulane,95,75,0,20,2016-12-02
Missouri State,Air Force,70,83,1,-13,2016-12-03
Tennessee Tech,Alabama A&M,79,74,0,5,2016-12-03
Auburn,Alabama-Birmingham,74,70,0,4,2016-12-03
Western Carolina,Appalachian State,58,53,0,5,2016-12-03
Gonzaga,Arizona,69,62,0,7,2016-12-03
UNLV,Arizona State,73,97,1,-24,2016-12-03
Austin Peay,Arkansas,62,99,1,-37,2016-12-03
Tulsa,Little Rock,62,72,1,-10,2016-12-03
St. Francis (NY),Army,56,76,1,-20,2016-12-03
IUPUI,Ball State,73,62,0,11,2016-12-03
Xavier,Baylor,61,76,1,-15,2016-12-03
Dartmouth,Boston College,70,88,1,-18,2016-12-03
Nevada,Bradley,91,69,0,22,2016-12-03
Central Arkansas,Butler,58,82,1,-24,2016-12-03
Texas A&M-Corpus Christi,Cal Poly,70,82,1,-12,2016-12-03
Pacific,Cal State Fullerton,77,78,1,-1,2016-12-03
Idaho State,Cal State Northridge,76,79,1,-3,2016-12-03
Alcorn State,California,59,83,1,-24,2016-12-03
Brown,Central Connecticut,75,58,0,17,2016-12-03
Arkansas-Pine Bluff,Central Michigan,59,82,1,-23,2016-12-03
Abilene Christian,Charleston Southern,85,82,0,3,2016-12-03
Oregon State,Charlotte,66,69,1,-3,2016-12-03
Louisiana-Monroe,Chattanooga,52,79,1,-27,2016-12-03
USC Upstate,Citadel,92,97,1,-5,2016-12-03
Bethune-Cookman,Cleveland State,62,73,1,-11,2016-12-03
UNC Asheville,Coastal Carolina,79,77,0,2,2016-12-03
Campbell,Colgate,73,71,0,2,2016-12-03
Wichita State,Colorado State,82,67,0,15,2016-12-03
Akron,Creighton,70,82,1,-12,2016-12-03
Winthrop,Dayton,67,83,1,-16,2016-12-03
Fresno State,Drake,78,76,0,2,2016-12-03
Maine,Duke,55,94,1,-39,2016-12-03
North Carolina Central,East Carolina,56,69,1,-13,2016-12-03
Marshall,Eastern Kentucky,80,89,1,-9,2016-12-03
Boise State,Evansville,67,72,1,-5,2016-12-03
Southern,Florida A&M,83,71,0,12,2016-12-03
Hofstra,Florida Atlantic,88,80,0,8,2016-12-03
Navy,Furman,46,79,1,-33,2016-12-03
Mercer,George Mason,68,79,1,-11,2016-12-03
South Florida,George Washington,67,68,1,-1,2016-12-03
Louisville,Grand Canyon,79,70,0,9,2016-12-03
William & Mary,Hampton,69,79,1,-10,2016-12-03
Fordham,Harvard,52,64,1,-12,2016-12-03
Drexel,High Point,78,72,0,6,2016-12-03
Prairie View,Houston,61,105,1,-44,2016-12-03
American,Howard,54,71,1,-17,2016-12-03
UC-Davis,Idaho,66,68,1,-2,2016-12-03
New Mexico,Illinois State,74,79,1,-5,2016-12-03
LIU-Brooklyn,Incarnate Word,79,90,1,-11,2016-12-03
Omaha,Iowa,98,89,0,9,2016-12-03
Miami (OH),Purdue-Fort Wayne,71,87,1,-16,2016-12-03
Stanford,Kansas,74,89,1,-15,2016-12-03
UCLA,Kentucky,97,92,0,5,2016-12-03
Bucknell,La Salle,73,83,1,-10,2016-12-03
Robert Morris,Lehigh,58,64,1,-6,2016-12-03
Tennessee State,Lipscomb,72,71,0,1,2016-12-03
James Madison,Longwood,71,59,0,12,2016-12-03
Southeastern Louisiana,Louisiana Tech,59,88,1,-29,2016-12-03
San Diego State,Loyola (IL),59,65,1,-6,2016-12-03
Mount St. Mary's,Loyola (MD),57,64,1,-7,2016-12-03
Oklahoma State,Maryland,70,71,1,-1,2016-12-03
Messiah,UMBC,59,98,1,-39,2016-12-03
UCF,UMass,65,62,0,3,2016-12-03
NJIT,UMass-Lowell,75,74,0,1,2016-12-03
Louisiana,McNeese State,92,72,0,20,2016-12-03
Wofford,Miami (FL),57,74,1,-17,2016-12-03
Kennesaw State,Michigan,55,82,1,-27,2016-12-03
Oral Roberts,Michigan State,76,80,1,-4,2016-12-03
Vanderbilt,Minnesota,52,56,1,-4,2016-12-03
Memphis,Ole Miss,77,85,1,-8,2016-12-03
Western Kentucky,Missouri,56,59,1,-3,2016-12-03
Milwaukee,Montana,69,75,1,-6,2016-12-03
Detroit,Murray State,76,86,1,-10,2016-12-03
South Dakota,Nebraska,61,73,1,-12,2016-12-03
Holy Cross,New Hampshire,53,56,1,-3,2016-12-03
Long Beach State,New Mexico State,85,93,1,-8,2016-12-03
Northern Kentucky,Norfolk State,72,61,0,11,2016-12-03
Liberty,UNC Greensboro,65,72,1,-7,2016-12-03
Boston University,NC State,73,77,1,-4,2016-12-03
Pfeiffer,UNC Wilmington,113,126,1,-13,2016-12-03
Texas-Arlington,North Texas,77,61,0,16,2016-12-03
San Diego,Northern Arizona,80,65,0,15,2016-12-03
Northern New Mexico,Northern Colorado,73,97,1,-24,2016-12-03
DePaul,Northwestern,64,80,1,-16,2016-12-03
Southern Utah,Oakland,68,78,1,-10,2016-12-03
Bryant,Ohio,53,79,1,-26,2016-12-03
Fairleigh Dickinson,Ohio State,62,70,1,-8,2016-12-03
Savannah State,Oregon,59,128,1,-69,2016-12-03
Wright State,Penn State,50,72,1,-22,2016-12-03
Belmont,Pepperdine,85,77,0,8,2016-12-03
Colorado,Portland,76,63,0,13,2016-12-03
Texas-Rio Grande Valley,Portland State,74,87,1,-13,2016-12-03
Rhode Island,Providence,60,63,1,-3,2016-12-03
Morehead State,Purdue,56,90,1,-34,2016-12-03
Wake Forest,Richmond,75,67,0,8,2016-12-03
Morgan State,Rutgers,58,72,1,-14,2016-12-03
UC-Merced,Sacramento State,54,81,1,-27,2016-12-03
Hartford,Sacred Heart,87,79,0,8,2016-12-03
Binghamton,Saint Francis (PA),73,70,0,3,2016-12-03
Kansas State,Saint Louis,84,53,0,31,2016-12-03
Louisiana State-Shreveport,Sam Houston State,59,91,1,-32,2016-12-03
Santa Clara,San Jose State,40,55,1,-15,2016-12-03
Fairfield,Siena,73,80,1,-7,2016-12-03
Middle Tennessee,South Alabama,67,55,0,12,2016-12-03
UMKC,South Dakota State,68,77,1,-9,2016-12-03
BYU,USC,84,91,1,-7,2016-12-03
Texas Southern,Southern Illinois,70,74,1,-4,2016-12-03
Buffalo,St. Bonaventure,84,90,1,-6,2016-12-03
Centenary (LA),Stephen F. Austin,59,90,1,-31,2016-12-03
Florida College,Stetson,69,101,1,-32,2016-12-03
Northeastern,Stony Brook,75,77,1,-2,2016-12-03
North Florida,Syracuse,71,77,1,-6,2016-12-03
Penn,Temple,62,70,1,-8,2016-12-03
Georgia Tech,Tennessee,58,81,1,-23,2016-12-03
Arkansas State,TCU,54,77,1,-23,2016-12-03
Northwestern State,UTEP,79,67,0,12,2016-12-03
Rice,Texas Tech,84,85,1,-1,2016-12-03
Green Bay,Toledo,78,77,0,1,2016-12-03
Old Dominion,Towson,60,58,0,2,2016-12-03
Indiana State,Utah State,62,61,0,1,2016-12-03
UTSA,Utah Valley,71,75,1,-4,2016-12-03
St. Joseph's,Villanova,57,88,1,-31,2016-12-03
West Virginia,Virginia,66,57,0,9,2016-12-03
Illinois,VCU,64,46,0,18,2016-12-03
Gardner-Webb,VMI,86,68,0,18,2016-12-03
New Orleans,Washington State,70,54,0,16,2016-12-03
Denver,Weber State,57,55,0,2,2016-12-03
Chicago State,Western Illinois,83,76,0,7,2016-12-03
Oklahoma,Wisconsin,70,90,1,-20,2016-12-03
Northern Iowa,Wyoming,73,81,1,-8,2016-12-03
Albany (NY),Yale,55,59,1,-4,2016-12-03
Oberlin,Youngstown State,72,87,1,-15,2016-12-03
Bowling Green State,Cincinnati,56,85,1,-29,2016-12-04
Campbell,Citadel,97,91,0,6,2016-12-04
Coppin State,Clemson,43,85,1,-42,2016-12-04
USC Upstate,Colgate,71,65,0,6,2016-12-04
Davidson,College of Charleston,61,76,1,-15,2016-12-04
Limestone,ETSU,57,85,1,-28,2016-12-04
Florida State,George Washington,67,48,0,19,2016-12-04
Elon,Georgetown,74,77,1,-3,2016-12-04
Marquette,Georgia,89,79,0,10,2016-12-04
Florida Gulf Coast,Georgia Southern,85,82,0,3,2016-12-04
Eastern Illinois,UIC,90,76,0,14,2016-12-04
Southeast Missouri State,Indiana,55,83,1,-28,2016-12-04
Niagara,Iona,74,58,0,16,2016-12-04
Southern Miss,Jackson State,64,75,1,-11,2016-12-04
Georgia State,Mississippi State,60,82,1,-22,2016-12-04
Canisius,Monmouth,88,94,1,-6,2016-12-04
Radford,UNC,50,95,1,-45,2016-12-04
North Carolina A&T,Notre Dame,53,107,1,-54,2016-12-04
Marist,Quinnipiac,63,77,1,-14,2016-12-04
Manhattan,St. Peter's,70,84,1,-14,2016-12-04
Jacksonville State,Samford,77,81,1,-4,2016-12-04
Eastern Washington,Seattle,93,88,0,5,2016-12-04
Florida International,South Carolina,54,70,1,-16,2016-12-04
Delaware State,SMU,60,74,1,-14,2016-12-04
Boyce,UT-Martin,64,108,1,-44,2016-12-04
Crowley's Ridge,Tennessee Tech,51,98,1,-47,2016-12-04
Alabama State,Troy,65,83,1,-18,2016-12-04
Jacksonville,Bethune-Cookman,76,66,0,10,2016-12-05
Piedmont,Coastal Carolina,63,100,1,-37,2016-12-05
Tougaloo,Grambling,90,105,1,-15,2016-12-05
Stetson,Iowa,68,95,1,-27,2016-12-05
Omaha,Iowa State,47,91,1,-44,2016-12-05
Alcorn State,Louisiana Tech,65,98,1,-33,2016-12-05
Boise State,Loyola Marymount,80,79,0,1,2016-12-05
Central Pennsylvania College,Maryland-Eastern Shore,74,87,1,-13,2016-12-05
Milwaukee,Montana State,83,78,0,5,2016-12-05
Mars Hill,UNC Greensboro,56,108,1,-52,2016-12-05
Cal State Bakersfield,Northern Arizona,81,47,0,34,2016-12-05
Texas-Rio Grande Valley,Portland,89,90,1,-1,2016-12-05
Siena,Rider,69,71,1,-2,2016-12-05
Lafayette,St. Francis (NY),74,72,0,2,2016-12-05
Cal State Northridge,St. John's (NY),70,76,1,-6,2016-12-05
UConn,Syracuse,52,50,0,2,2016-12-05
Texas A&M-Corpus Christi,Texas A&M,69,86,1,-17,2016-12-05
Texas-Dallas,Texas-Arlington,49,99,1,-50,2016-12-05
Colorado Christian,Wyoming,60,67,1,-7,2016-12-05
New Hampshire,American,80,70,0,10,2016-12-06
UC-Irvine,Arizona,57,79,1,-22,2016-12-06
Purdue,Arizona State,97,64,0,33,2016-12-06
Houston,Arkansas,72,84,1,-12,2016-12-06
Bradley,Ball State,63,80,1,-17,2016-12-06
Green Bay,Central Michigan,97,107,1,-10,2016-12-06
Marshall,Chattanooga,85,96,1,-11,2016-12-06
Arkansas-Fort Smith,Colorado State,69,93,1,-24,2016-12-06
Saint Joseph's (IN),Dayton,59,91,1,-32,2016-12-06
Lamar,DePaul,61,80,1,-19,2016-12-06
Florida,Duke,74,84,1,-10,2016-12-06
UNC Asheville,Elon,78,67,0,11,2016-12-06
Bowling Green State,Evansville,66,69,1,-3,2016-12-06
Bucknell,Fairfield,75,64,0,11,2016-12-06
Southern Miss,Florida State,49,98,1,-49,2016-12-06
Northeastern,Harvard,80,86,1,-6,2016-12-06
St. Bonaventure,Hofstra,81,75,0,6,2016-12-06
IUPUI,Illinois,77,85,1,-8,2016-12-06
UMKC,Kansas,62,105,1,-43,2016-12-06
Prairie View,Kansas State,55,74,1,-19,2016-12-06
Furman,Liberty,61,58,0,3,2016-12-06
Belmont,Lipscomb,78,76,0,2,2016-12-06
Fresno State,Marquette,81,84,1,-3,2016-12-06
South Carolina State,Miami (FL),46,82,1,-36,2016-12-06
Texas,Michigan,50,53,1,-3,2016-12-06
Youngstown State,Michigan State,57,77,1,-20,2016-12-06
NJIT,Minnesota,68,74,1,-6,2016-12-06
Miami (OH),Missouri,55,81,1,-26,2016-12-06
Manhattan,Morgan State,82,85,1,-3,2016-12-06
Bryant,Navy,74,76,1,-2,2016-12-06
LIU-Brooklyn,North Carolina Central,56,79,1,-23,2016-12-06
Purdue-Fort Wayne,Notre Dame,72,87,1,-15,2016-12-06
Florida Atlantic,Ohio State,79,77,0,2,2016-12-06
California,Princeton,62,51,0,11,2016-12-06
Brown,Providence,57,95,1,-38,2016-12-06
Old Dominion,Rhode Island,39,51,1,-12,2016-12-06
Duquesne,Robert Morris,60,64,1,-4,2016-12-06
Central Connecticut,Rutgers,37,79,1,-42,2016-12-06
UMass-Lowell,Sacred Heart,82,91,1,-9,2016-12-06
San Francisco State,San Francisco,59,91,1,-32,2016-12-06
Hawaii,Seton Hall,57,68,1,-11,2016-12-06
Lehigh,Stony Brook,57,62,1,-5,2016-12-06
Presbyterian,Tennessee,50,90,1,-40,2016-12-06
Utah Valley,Utah,80,87,1,-7,2016-12-06
Great Falls,Utah State,51,84,1,-33,2016-12-06
High Point,Vanderbilt,63,90,1,-27,2016-12-06
La Salle,Villanova,79,89,1,-10,2016-12-06
East Carolina,Virginia,53,76,1,-23,2016-12-06
Monmouth,Wagner,81,71,0,10,2016-12-06
Charlotte,Wake Forest,74,91,1,-17,2016-12-06
Saint Louis,Wichita State,45,75,1,-30,2016-12-06
Greensboro,Winthrop,63,106,1,-43,2016-12-06
Virginia Wise,Wofford,56,116,1,-60,2016-12-06
Coppin State,Akron,63,87,1,-24,2016-12-07
Marist,Albany (NY),66,78,1,-12,2016-12-07
Air Force,Army,71,79,1,-8,2016-12-07
Harvard,Boston College,74,66,0,8,2016-12-07
Canisius,Boston University,87,77,0,10,2016-12-07
Weber State,BYU,66,77,1,-11,2016-12-07
Toccoa Falls,Citadel,94,144,1,-50,2016-12-07
Western Michigan,Cleveland State,62,85,1,-23,2016-12-07
Binghamton,Colgate,73,64,0,9,2016-12-07
Xavier,Colorado,66,68,1,-2,2016-12-07
Iona,Fairleigh Dickinson,90,73,0,17,2016-12-07
Hampton,Gardner-Webb,63,69,1,-6,2016-12-07
Washington,Gonzaga,71,98,1,-27,2016-12-07
San Diego State,Grand Canyon,72,76,1,-4,2016-12-07
St. Peter's,Houston Baptist,47,62,1,-15,2016-12-07
Texas Lutheran,Incarnate Word,71,78,1,-7,2016-12-07
Butler,Indiana State,71,72,1,-1,2016-12-07
Eastern Kentucky,Jacksonville,80,76,0,4,2016-12-07
Niagara,Kent State,72,100,1,-28,2016-12-07
Valparaiso,Kentucky,63,87,1,-24,2016-12-07
Pepperdine,Long Beach State,66,75,1,-9,2016-12-07
Loyola (LA),Louisiana,60,94,1,-34,2016-12-07
Southern Illinois,Louisville,51,74,1,-23,2016-12-07
Wright State,Loyola (IL),64,77,1,-13,2016-12-07
Holy Cross,Maine,53,55,1,-2,2016-12-07
Howard,Maryland,56,79,1,-23,2016-12-07
Oglethorpe,Mercer,41,98,1,-57,2016-12-07
San Jose State,Montana,62,81,1,-19,2016-12-07
UMBC,Mount St. Mary's,78,70,0,8,2016-12-07
Creighton,Nebraska,77,62,0,15,2016-12-07
UTEP,New Mexico,77,78,1,-1,2016-12-07
Davidson,UNC,74,83,1,-9,2016-12-07
North Dakota,North Dakota State,74,56,0,18,2016-12-07
South Dakota State,Northern Iowa,58,86,1,-28,2016-12-07
Eastern Illinois,Northern Kentucky,70,80,1,-10,2016-12-07
Oral Roberts,Oklahoma,66,92,1,-26,2016-12-07
George Mason,Penn State,85,66,0,19,2016-12-07
Lafayette,Penn,52,81,1,-29,2016-12-07
Buffalo,Pitt,79,84,1,-5,2016-12-07
Hawaii,Princeton,62,75,1,-13,2016-12-07
Hartford,Quinnipiac,79,99,1,-20,2016-12-07
Cal State Fullerton,San Diego,75,82,1,-7,2016-12-07
California,Seton Hall,57,60,1,-3,2016-12-07
Montana State,South Dakota,57,74,1,-17,2016-12-07
Missouri State,Southeast Missouri State,79,71,0,8,2016-12-07
Stetson,SIU-Edwardsville,80,72,0,8,2016-12-07
TCU,SMU,59,74,1,-15,2016-12-07
Mount Saint Vincent,St. Francis (NY),51,69,1,-18,2016-12-07
Alabama-Birmingham,Stephen F. Austin,84,73,0,11,2016-12-07
George Washington,Temple,66,63,0,3,2016-12-07
Denver,Texas A&M,58,80,1,-22,2016-12-07
Texas State,Texas-Rio Grande Valley,61,72,1,-11,2016-12-07
UTSA,Texas Tech,50,87,1,-37,2016-12-07
Detroit,Toledo,65,73,1,-8,2016-12-07
Loyola (MD),Towson,53,70,1,-17,2016-12-07
Southern,Tulane,75,84,1,-9,2016-12-07
Illinois State,Tulsa,68,70,1,-2,2016-12-07
Dartmouth,Vermont,58,73,1,-15,2016-12-07
Georgia Tech,VCU,76,73,0,3,2016-12-07
Maryland-Eastern Shore,Virginia Tech,59,75,1,-16,2016-12-07
Idaho,Washington State,48,61,1,-13,2016-12-07
Western Carolina,West Virginia,37,90,1,-53,2016-12-07
Idaho State,Wisconsin,44,78,1,-34,2016-12-07
Arkansas-Pine Bluff,Little Rock,52,67,1,-15,2016-12-08
Great Falls,Eastern Washington,76,103,1,-27,2016-12-08
Nicholls State,Florida State,63,118,1,-55,2016-12-08
Iowa State,Iowa,64,78,1,-14,2016-12-08
Southern Utah,Loyola Marymount,68,75,1,-7,2016-12-08
Pacific,UMass,48,72,1,-24,2016-12-08
Vanderbilt,Middle Tennessee,48,71,1,-23,2016-12-08
Delaware State,North Texas,40,73,1,-33,2016-12-08
Yale,Sacred Heart,66,52,0,14,2016-12-08
Texas-Arlington,Saint Mary's,65,51,0,14,2016-12-08
Fordham,St. John's (NY),62,90,1,-28,2016-12-08
Hartford,Boston College,65,63,0,2,2016-12-09
Emerson,Brown,58,90,1,-32,2016-12-09
Pomona-Pitzer,UC-Irvine,53,80,1,-27,2016-12-09
Longwood,Creighton,58,113,1,-55,2016-12-09
Siena,Florida Gulf Coast,69,73,1,-4,2016-12-09
Selma University,Grambling,53,103,1,-50,2016-12-09
Georgia Southern,Minnesota,49,86,1,-37,2016-12-09
Columbia,Navy,54,69,1,-15,2016-12-09
Wake Forest,UNC Greensboro,78,75,0,3,2016-12-09
St. Mary's (TX),Texas A&M-Corpus Christi,67,77,1,-10,2016-12-09
Northern New Mexico,Abilene Christian,69,90,1,-21,2016-12-10
Denver,Air Force,77,65,0,12,2016-12-10
Youngstown State,American,62,77,1,-15,2016-12-10
North Florida,Arkansas,76,91,1,-15,2016-12-10
Central Arkansas,Little Rock,59,70,1,-11,2016-12-10
Eastern Kentucky,Ball State,86,91,1,-5,2016-12-10
Florida College,Bethune-Cookman,79,81,1,-2,2016-12-10
Loyola (MD),Binghamton,90,85,0,5,2016-12-10
Detroit,Bowling Green State,61,74,1,-13,2016-12-10
Chicago State,Bradley,48,83,1,-35,2016-12-10
Colorado,BYU,71,79,1,-8,2016-12-10
Johnson & Wales (RI),Brown,59,89,1,-30,2016-12-10
New Hampshire,Bryant,86,73,0,13,2016-12-10
Coppin State,Buffalo,52,87,1,-35,2016-12-10
Cincinnati,Butler,65,75,1,-10,2016-12-10
Portland State,Cal State Bakersfield,79,81,1,-2,2016-12-10
Southern Utah,Cal State Fullerton,62,75,1,-13,2016-12-10
Loyola Marymount,Cal State Northridge,69,68,0,1,2016-12-10
UC-Davis,California,61,86,1,-25,2016-12-10
St. Francis (NY),Canisius,81,91,1,-10,2016-12-10
Maryland-Eastern Shore,UCF,58,76,1,-18,2016-12-10
Johnson & Wales (NC),Charleston Southern,53,100,1,-47,2016-12-10
Mercer,Clemson,47,90,1,-43,2016-12-10
North Carolina Central,Coastal Carolina,67,70,1,-3,2016-12-10
Albany (NY),Colgate,74,66,0,8,2016-12-10
Northern Colorado,Colorado State,64,81,1,-17,2016-12-10
Maine,Dartmouth,73,68,0,5,2016-12-10
ETSU,Dayton,61,75,1,-14,2016-12-10
Keystone,Delaware State,69,92,1,-23,2016-12-10
Temple,DePaul,74,65,0,9,2016-12-10
Jackson State,Drake,68,63,0,5,2016-12-10
Central Connecticut,Duquesne,67,70,1,-3,2016-12-10
Murray State,Evansville,46,78,1,-32,2016-12-10
Cal Poly,Fresno State,59,73,1,-14,2016-12-10
Furman,Gardner-Webb,68,65,0,3,2016-12-10
Howard,George Washington,62,79,1,-17,2016-12-10
La Salle,Georgetown,78,93,1,-15,2016-12-10
Georgia Southwestern,Georgia State,52,83,1,-31,2016-12-10
Akron,Gonzaga,43,61,1,-18,2016-12-10
UIC,Grand Canyon,69,73,1,-4,2016-12-10
Rhode Island,Houston,77,82,1,-5,2016-12-10
Central Michigan,Illinois,73,92,1,-19,2016-12-10
UT-Martin,Illinois State,57,74,1,-17,2016-12-10
Texas A&M-International,Incarnate Word,68,83,1,-15,2016-12-10
Houston Baptist,Indiana,61,103,1,-42,2016-12-10
Ohio,Iona,75,79,1,-4,2016-12-10
Austin Peay,Purdue-Fort Wayne,58,98,1,-40,2016-12-10
Nebraska,Kansas,72,89,1,-17,2016-12-10
Washington State,Kansas State,56,70,1,-14,2016-12-10
NJIT,Kent State,71,87,1,-16,2016-12-10
Austin College,Lamar,58,109,1,-51,2016-12-10
Princeton,Liberty,67,64,0,3,2016-12-10
Morehead State,Lipscomb,84,98,1,-14,2016-12-10
Louisiana Tech,Louisiana,83,91,1,-8,2016-12-10
Jacksonville State,Louisiana-Monroe,83,88,1,-5,2016-12-10
Texas Southern,Louisville,71,102,1,-31,2016-12-10
Milwaukee,Loyola (IL),56,72,1,-16,2016-12-10
Fordham,Manhattan,53,60,1,-7,2016-12-10
Jacksonville,Marist,85,64,0,21,2016-12-10
Wisconsin,Marquette,93,84,0,9,2016-12-10
Toledo,Marshall,105,111,1,-6,2016-12-10
St. Peter's,Maryland,56,66,1,-10,2016-12-10
Alabama-Birmingham,Memphis,55,62,1,-7,2016-12-10
IUPUI,Miami (OH),68,71,1,-3,2016-12-10
Tennessee Tech,Michigan State,63,71,1,-8,2016-12-10
Arizona,Missouri,79,60,0,19,2016-12-10
William Jewell,UMKC,71,93,1,-22,2016-12-10
Valparaiso,Missouri State,84,81,0,3,2016-12-10
Army,Monmouth,71,81,1,-10,2016-12-10
Wagner,Morgan State,68,66,0,2,2016-12-10
Lehigh,Mount St. Mary's,90,71,0,19,2016-12-10
Montana State,Omaha,91,97,1,-6,2016-12-10
Duke,UNLV,94,45,0,49,2016-12-10
New Mexico,New Mexico State,71,84,1,-13,2016-12-10
Norfolk State,Niagara,61,65,1,-4,2016-12-10
Warren Wilson,UNC Asheville,52,117,1,-65,2016-12-10
Tennessee State,NC State,55,67,1,-12,2016-12-10
North Dakota,Northern Iowa,70,78,1,-8,2016-12-10
Villanova,Notre Dame,74,66,0,8,2016-12-10
UConn,Ohio State,60,64,1,-4,2016-12-10
Wichita State,Oklahoma,76,73,0,3,2016-12-10
VCU,Old Dominion,67,64,0,3,2016-12-10
John Brown,Oral Roberts,63,95,1,-32,2016-12-10
Rider,Pacific,73,66,0,7,2016-12-10
George Mason,Penn,79,60,0,19,2016-12-10
Penn State,Pitt,73,81,1,-8,2016-12-10
UMass,Providence,69,75,1,-6,2016-12-10
Cleveland State,Purdue,53,77,1,-24,2016-12-10
Elon,Radford,56,68,1,-12,2016-12-10
Stephen F. Austin,Rice,63,70,1,-7,2016-12-10
UMBC,Richmond,75,78,1,-3,2016-12-10
Oakland,Robert Morris,74,53,0,21,2016-12-10
Miles,Samford,73,92,1,-19,2016-12-10
Arizona State,San Diego State,74,63,0,11,2016-12-10
Life Pacific,San Jose State,70,109,1,-39,2016-12-10
Cal State East Bay,Santa Clara,50,75,1,-25,2016-12-10
Great Falls,Seattle,49,90,1,-41,2016-12-10
Virginia Wise,USC Upstate,67,99,1,-32,2016-12-10
Sacramento State,South Dakota,56,72,1,-16,2016-12-10
Idaho,South Dakota State,77,80,1,-3,2016-12-10
Northern Kentucky,Southeast Missouri State,80,66,0,14,2016-12-10
Loyola (LA),Southern,69,64,0,5,2016-12-10
Sam Houston State,Southern Illinois,79,73,0,6,2016-12-10
Western State,SIU-Edwardsville,49,44,0,5,2016-12-10
Tulane,Southern Miss,71,64,0,7,2016-12-10
UNC Wilmington,St. Bonaventure,81,80,0,1,2016-12-10
South Alabama,Stetson,78,87,1,-9,2016-12-10
Rutgers,Stony Brook,71,66,0,5,2016-12-10
Boston University,Syracuse,77,99,1,-22,2016-12-10
Long Beach State,Texas,65,71,1,-6,2016-12-10
South Carolina State,Texas A&M,76,83,1,-7,2016-12-10
Wofford,TCU,63,72,1,-9,2016-12-10
SE Oklahoma St.,UTSA,69,88,1,-19,2016-12-10
Prairie View,Texas State,57,64,1,-7,2016-12-10
Fairleigh Dickinson,Towson,87,90,1,-3,2016-12-10
Alabama A&M,Troy,59,88,1,-29,2016-12-10
Oklahoma State,Tulsa,71,67,0,4,2016-12-10
Michigan,UCLA,84,102,1,-18,2016-12-10
Utah State,Utah Valley,80,79,0,1,2016-12-10
Northeastern,Vermont,59,57,0,2,2016-12-10
West Coast Baptist,Weber State,51,107,1,-56,2016-12-10
VMI,West Virginia,55,90,1,-35,2016-12-10
Eastern Illinois,Western Illinois,63,49,0,14,2016-12-10
James Madison,Western Michigan,67,74,1,-7,2016-12-10
Montana,Wyoming,83,85,1,-2,2016-12-10
Utah,Xavier,69,77,1,-8,2016-12-10
Montreat,Appalachian State,57,116,1,-59,2016-12-11
Anderson (SC),College of Charleston,45,59,1,-14,2016-12-11
Manhattanville,Columbia,42,84,1,-42,2016-12-11
St. Joseph's,Drexel,72,71,0,1,2016-12-11
Siena Heights,Eastern Michigan,55,117,1,-62,2016-12-11
Florida International,Florida Gulf Coast,63,82,1,-19,2016-12-11
Florida,Florida State,78,83,1,-5,2016-12-11
Ferrum,High Point,53,77,1,-24,2016-12-11
Quinnipiac,Holy Cross,57,75,1,-18,2016-12-11
Western Kentucky,Indiana State,77,59,0,18,2016-12-11
Hofstra,Kentucky,73,96,1,-23,2016-12-11
Sacred Heart,Lafayette,85,61,0,24,2016-12-11
St. John's (NY),LIU-Brooklyn,73,74,1,-1,2016-12-11
Northern Illinois,Minnesota,57,77,1,-20,2016-12-11
Thomas University,Nicholls State,63,95,1,-32,2016-12-11
Tennessee,UNC,71,73,1,-2,2016-12-11
New Orleans,Northwestern,49,83,1,-34,2016-12-11
Alabama,Oregon,56,65,1,-9,2016-12-11
Savannah State,Oregon State,93,90,0,3,2016-12-11
Chicago State,Saint Louis,43,45,1,-2,2016-12-11
UC-Irvine,Saint Mary's,53,84,1,-31,2016-12-11
UCSB,San Diego,68,77,1,-9,2016-12-11
Ecclesia,Southern,50,86,1,-36,2016-12-11
Pepperdine,USC,67,93,1,-26,2016-12-11
Ole Miss,Virginia Tech,75,80,1,-5,2016-12-11
Nevada,Washington,87,85,0,2,2016-12-11
Delaware,Yale,63,81,1,-18,2016-12-11
Auburn,Boston College,71,72,1,-1,2016-12-12
Albany (NY),Canisius,64,77,1,-13,2016-12-12
Penn,UCF,58,49,0,9,2016-12-12
Longwood,George Mason,60,97,1,-37,2016-12-12
Urbana,IUPUI,67,109,1,-42,2016-12-12
Saint Francis (PA),Lehigh,67,100,1,-33,2016-12-12
Blue Mountain College,Louisiana-Monroe,41,72,1,-31,2016-12-12
Jacksonville State,Maryland,66,92,1,-26,2016-12-12
Bethel (TN),Murray State,65,103,1,-38,2016-12-12
Alabama State,San Diego State,41,73,1,-32,2016-12-12
Arkansas-Pine Bluff,Seattle,58,63,1,-5,2016-12-12
South Carolina,Seton Hall,64,67,1,-3,2016-12-12
Bethune-Cookman,South Florida,73,79,1,-6,2016-12-12
Florida A&M,Southeastern Louisiana,69,108,1,-39,2016-12-12
North Florida,Texas-Rio Grande Valley,84,98,1,-14,2016-12-12
Texas Southern,Cincinnati,58,96,1,-38,2016-12-13
South Carolina State,Clemson,65,93,1,-28,2016-12-13
Morehead State,Eastern Washington,86,88,1,-2,2016-12-13
Georgia Southern,Florida Gulf Coast,72,59,0,13,2016-12-13
Dartmouth,Hartford,66,70,1,-4,2016-12-13
Stony Brook,Hofstra,58,96,1,-38,2016-12-13
North Carolina Central,LSU,66,70,1,-4,2016-12-13
Prairie View,Louisiana Tech,52,65,1,-13,2016-12-13
North Carolina A&T,UMass,59,65,1,-6,2016-12-13
Monmouth,Memphis,82,79,0,3,2016-12-13
Central Arkansas,Michigan,53,97,1,-44,2016-12-13
Montana,Oregon,67,81,1,-14,2016-12-13
New Hope Christian,Portland State,79,110,1,-31,2016-12-13
Sul Ross State,Sam Houston State,57,78,1,-21,2016-12-13
UC-Riverside,Santa Clara,53,77,1,-24,2016-12-13
Denver,South Alabama,64,51,0,13,2016-12-13
Presbyterian,USC Upstate,48,76,1,-28,2016-12-13
Tennessee Tech,Tennessee,68,74,1,-6,2016-12-13
New Mexico State,UTEP,79,68,0,11,2016-12-13
Temple,Villanova,57,78,1,-21,2016-12-13
Charleston Southern,VMI,83,88,1,-5,2016-12-13
Urbana,Wright State,34,85,1,-51,2016-12-13
Central Connecticut,Yale,59,90,1,-31,2016-12-13
Hillsdale,Abilene Christian,74,78,1,-4,2016-12-14
Grand Canyon,Arizona,54,64,1,-10,2016-12-14
Southern,Baylor,59,89,1,-30,2016-12-14
Middle Tennessee,Belmont,79,66,0,13,2016-12-14
UNC Wilmington,Campbell,96,75,0,21,2016-12-14
Tennessee Wesleyan,Chattanooga,65,107,1,-42,2016-12-14
UIC,DePaul,80,75,0,5,2016-12-14
Norfolk State,Evansville,66,85,1,-19,2016-12-14
Holy Names,Fresno State,54,88,1,-34,2016-12-14
Louisiana,Georgia,60,73,1,-13,2016-12-14
Alabama A&M,Georgia State,79,94,1,-15,2016-12-14
Jacksonville State,Howard,72,59,0,13,2016-12-14
NJIT,Iona,80,94,1,-14,2016-12-14
Averett,Longwood,67,86,1,-19,2016-12-14
LIU-Brooklyn,Minnesota,66,76,1,-10,2016-12-14
ETSU,Mississippi State,67,65,0,2,2016-12-14
Oral Roberts,Missouri State,76,86,1,-10,2016-12-14
UC-Irvine,Nevada,69,76,1,-7,2016-12-14
Incarnate Word,UNLV,64,92,1,-28,2016-12-14
Southern Wesleyan,UNC Greensboro,61,96,1,-35,2016-12-14
UC-Davis,North Dakota State,70,74,1,-4,2016-12-14
Little Rock,Northern Arizona,72,67,0,5,2016-12-14
Olivet Nazarene,Northern Illinois,69,95,1,-26,2016-12-14
Chicago State,Northwestern,64,68,1,-4,2016-12-14
Milwaukee,Ohio,69,71,1,-2,2016-12-14
Arkansas-Pine Bluff,Oklahoma State,66,102,1,-36,2016-12-14
Troy,Point,114,52,0,62,2016-12-14
St. Joseph's,Princeton,76,68,0,8,2016-12-14
Kennesaw State,Rider,79,81,1,-2,2016-12-14
Fairleigh Dickinson,Rutgers,69,82,1,-13,2016-12-14
Western Kentucky,Saint Mary's,51,73,1,-22,2016-12-14
Saint Louis,Southern Illinois,55,70,1,-15,2016-12-14
McNeese State,SMU,56,92,1,-36,2016-12-14
Arkansas State,UT-Martin,87,68,0,19,2016-12-14
Alabama State,Tennessee State,46,68,1,-22,2016-12-14
Nicholls State,Texas Tech,46,89,1,-43,2016-12-14
UCSB,UCLA,62,102,1,-40,2016-12-14
Green Bay,Wisconsin,59,73,1,-14,2016-12-14
Niagara,Youngstown State,97,101,1,-4,2016-12-14
USC Upstate,Alabama,61,78,1,-17,2016-12-15
Coastal Carolina,Auburn,72,117,1,-45,2016-12-15
Bethesda University (CA),Cal State Bakersfield,78,105,1,-27,2016-12-15
Goldey-Beacom,Coppin State,83,89,1,-6,2016-12-15
College of Charleston,East Carolina,53,35,0,18,2016-12-15
Georgia Southern,Florida International,75,68,0,7,2016-12-15
UCF,George Washington,59,74,1,-15,2016-12-15
Blue Mountain College,Jackson State,57,49,0,8,2016-12-15
Murray State,Ole Miss,73,78,1,-5,2016-12-15
Omaha,UMKC,80,75,0,5,2016-12-15
Appalachian State,NC State,64,97,1,-33,2016-12-15
Thomas University,North Florida,80,110,1,-30,2016-12-15
North Carolina A&T,Pacific,57,66,1,-9,2016-12-15
St. Edward's,Rice,64,93,1,-29,2016-12-15
Mississippi Valley State,Seattle,67,82,1,-15,2016-12-15
Lipscomb,Tennessee,77,92,1,-15,2016-12-15
Austin Peay,Wofford,77,96,1,-19,2016-12-15
Texas-Arlington,Bradley,56,51,0,5,2016-12-16
Bethesda University (CA),Cal State Northridge,100,95,0,5,2016-12-16
Arkansas State,Central Arkansas,89,77,0,12,2016-12-16
South Carolina State,Furman,69,67,0,2,2016-12-16
Warren Wilson,Gardner-Webb,45,95,1,-50,2016-12-16
North Carolina Wesleyan,High Point,61,79,1,-18,2016-12-16
Shenandoah,Howard,66,77,1,-11,2016-12-16
Montana Tech,Idaho State,46,76,1,-30,2016-12-16
Clarks Summit,Liberty,33,81,1,-48,2016-12-16
Florida Atlantic,Miami (FL),56,76,1,-20,2016-12-16
North Dakota State,North Dakota,87,70,0,17,2016-12-16
Long Beach State,Oregon State,71,67,0,4,2016-12-16
South Dakota,Portland,82,85,1,-3,2016-12-16
Drexel,Rider,82,90,1,-8,2016-12-16
Portland State,San Francisco,82,78,0,4,2016-12-16
Samford,South Alabama,82,79,0,3,2016-12-16
Cal State East Bay,Stanford,55,79,1,-24,2016-12-16
Lamar,Texas-Rio Grande Valley,81,95,1,-14,2016-12-16
Milligan,William & Mary,59,113,1,-54,2016-12-16
Marshall,Akron,88,99,1,-11,2016-12-17
St. Francis (NY),Albany (NY),60,87,1,-27,2016-12-17
James Madison,Appalachian State,61,73,1,-12,2016-12-17
Texas A&M,Arizona,63,67,1,-4,2016-12-17
New Mexico State,Arizona State,81,70,0,11,2016-12-17
Evansville,Austin Peay,77,69,0,8,2016-12-17
Jackson State,Baylor,57,82,1,-25,2016-12-17
Delaware State,Binghamton,66,85,1,-19,2016-12-17
Canisius,Buffalo,94,87,0,7,2016-12-17
Cal Poly,California,55,81,1,-26,2016-12-17
William Jessup,UC-Davis,64,87,1,-23,2016-12-17
Montana,UC-Riverside,71,63,0,8,2016-12-17
Fairleigh Dickinson,Cincinnati,68,119,1,-51,2016-12-17
Fort Hays State,Colorado,71,81,1,-10,2016-12-17
Kansas State,Colorado State,89,70,0,19,2016-12-17
Oral Roberts,Creighton,65,66,1,-1,2016-12-17
Kansas,Davidson,89,71,0,18,2016-12-17
Northern Colorado,Denver,70,73,1,-3,2016-12-17
Chicago State,DePaul,61,109,1,-48,2016-12-17
Western Kentucky,Detroit,79,85,1,-6,2016-12-17
Charlotte,Florida,46,87,1,-41,2016-12-17
Jacksonville,Florida A&M,75,72,0,3,2016-12-17
Northern Illinois,Florida International,60,53,0,7,2016-12-17
Manhattan,Florida State,67,83,1,-16,2016-12-17
Charleston Southern,Georgia,64,84,1,-20,2016-12-17
Mississippi Valley State,Grand Canyon,62,72,1,-10,2016-12-17
Winthrop,Hampton,86,79,0,7,2016-12-17
Texas-Rio Grande Valley,Houston,58,83,1,-25,2016-12-17
Arlington Baptist,Houston Baptist,77,103,1,-26,2016-12-17
Northwest Nazarene,Idaho,61,87,1,-26,2016-12-17
BYU,Illinois,73,75,1,-2,2016-12-17
Loyola (IL),UIC,81,75,0,6,2016-12-17
Butler,Indiana,83,78,0,5,2016-12-17
Drake,Iowa State,80,97,1,-17,2016-12-17
UNC,Kentucky,100,103,1,-3,2016-12-17
Florida Gulf Coast,La Salle,80,84,1,-4,2016-12-17
Texas Southern,LSU,80,88,1,-8,2016-12-17
Grambling,Louisiana Tech,55,89,1,-34,2016-12-17
Eastern Kentucky,Louisville,56,87,1,-31,2016-12-17
Incarnate Word,Loyola Marymount,90,91,1,-1,2016-12-17
Towson,UMBC,73,72,0,1,2016-12-17
Kennesaw State,UMass,77,95,1,-18,2016-12-17
North Carolina Central,McNeese State,74,66,0,8,2016-12-17
Maryland-Eastern Shore,Michigan,49,98,1,-49,2016-12-17
Western Illinois,Milwaukee,75,59,0,16,2016-12-17
Eastern Illinois,Missouri,67,64,0,3,2016-12-17
Southeast Missouri State,Missouri State,66,71,1,-5,2016-12-17
ETSU,Morehead State,78,68,0,10,2016-12-17
Arkansas-Pine Bluff,New Mexico,43,83,1,-40,2016-12-17
Louisiana,New Orleans,76,71,0,5,2016-12-17
St. Bonaventure,Niagara,79,69,0,10,2016-12-17
Western Carolina,UNC Asheville,57,59,1,-2,2016-12-17
Radford,UNC Wilmington,64,100,1,-36,2016-12-17
Iowa,Northern Iowa,69,46,0,23,2016-12-17
Dayton,Northwestern,64,67,1,-3,2016-12-17
Louisiana-Monroe,Northwestern State,64,68,1,-4,2016-12-17
Purdue,Notre Dame,86,81,0,5,2016-12-17
Cleveland State,Ohio,53,71,1,-18,2016-12-17
Memphis,Oklahoma,99,94,0,5,2016-12-17
UNLV,Oregon,63,83,1,-20,2016-12-17
Fresno State,Pacific,70,68,0,2,2016-12-17
Rice,Pitt,73,83,1,-10,2016-12-17
Coastal Georgia,Presbyterian,48,90,1,-42,2016-12-17
Wagner,Providence,54,76,1,-22,2016-12-17
Texas Tech,Richmond,79,72,0,7,2016-12-17
Abilene Christian,Sacramento State,86,88,1,-2,2016-12-17
Stony Brook,Saint Francis (PA),75,63,0,12,2016-12-17
SIU-Edwardsville,Saint Louis,58,72,1,-14,2016-12-17
North Texas,Sam Houston State,70,76,1,-6,2016-12-17
Bethesda University (CA),San Diego,89,105,1,-16,2016-12-17
Delaware,Seton Hall,68,81,1,-13,2016-12-17
Bucknell,Siena,68,71,1,-3,2016-12-17
Murray State,South Dakota State,84,88,1,-4,2016-12-17
South Carolina,South Florida,77,66,0,11,2016-12-17
Troy,USC,77,82,1,-5,2016-12-17
IUPUI,Southern Utah,101,81,0,20,2016-12-17
Georgetown,Syracuse,78,71,0,7,2016-12-17
NJIT,Temple,63,68,1,-5,2016-12-17
Bethune-Cookman,UT-Martin,72,97,1,-25,2016-12-17
Lipscomb,Tennessee Tech,81,79,0,2,2016-12-17
Arkansas,Texas,77,74,0,3,2016-12-17
Northern Arizona,UTEP,76,74,0,2,2016-12-17
Southeastern Louisiana,Toledo,56,78,1,-22,2016-12-17
Texas State,Tulsa,59,74,1,-15,2016-12-17
Ohio State,UCLA,73,86,1,-13,2016-12-17
Prairie View,Utah,60,92,1,-32,2016-12-17
Indiana State,Valparaiso,71,89,1,-18,2016-12-17
Chattanooga,Vanderbilt,74,76,1,-2,2016-12-17
Eastern Michigan,Vermont,74,82,1,-8,2016-12-17
Robert Morris,Virginia,39,79,1,-40,2016-12-17
Middle Tennessee,VCU,77,80,1,-3,2016-12-17
Citadel,Virginia Tech,71,113,1,-42,2016-12-17
Santa Clara,Washington State,68,69,1,-1,2016-12-17
Utah Valley,Weber State,85,93,1,-8,2016-12-17
UMKC,West Virginia,67,112,1,-45,2016-12-17
Oklahoma State,Wichita State,93,76,0,17,2016-12-17
Cornell,Wyoming,78,97,1,-19,2016-12-17
Wake Forest,Xavier,65,69,1,-4,2016-12-17
Clemson,Alabama,67,54,0,13,2016-12-18
Southern,Alabama-Birmingham,74,75,1,-1,2016-12-18
Mercer,Auburn,74,76,1,-2,2016-12-18
John Brown,Baylor,53,107,1,-54,2016-12-18
Idaho State,Boise State,59,82,1,-23,2016-12-18
Sacred Heart,Boston College,75,82,1,-7,2016-12-18
New Hampshire,Boston University,69,73,1,-4,2016-12-18
Miami (OH),UCF,73,80,1,-7,2016-12-18
North Florida,UConn,59,80,1,-21,2016-12-18
Kean,Drexel,44,84,1,-40,2016-12-18
Alcorn State,Georgia Tech,50,74,1,-24,2016-12-18
Central Pennsylvania College,Howard,60,67,1,-7,2016-12-18
St. Joseph's,Illinois State,72,81,1,-9,2016-12-18
Wright State,Kent State,68,63,0,5,2016-12-18
Dartmouth,LIU-Brooklyn,82,68,0,14,2016-12-18
Quinnipiac,Maine,85,75,0,10,2016-12-18
Central Connecticut,UMass-Lowell,69,86,1,-17,2016-12-18
Northeastern,Michigan State,81,73,0,8,2016-12-18
South Dakota,Montana State,80,68,0,12,2016-12-18
Gardner-Webb,Nebraska,70,62,0,8,2016-12-18
Cal State Fullerton,Omaha,96,102,1,-6,2016-12-18
Mobile,Nicholls State,66,83,1,-17,2016-12-18
Rider,North Carolina A&T,60,59,0,1,2016-12-18
Fairfield,NC State,78,99,1,-21,2016-12-18
Eastern Washington,Northern Kentucky,48,70,1,-22,2016-12-18
Georgia State,Old Dominion,46,58,1,-12,2016-12-18
Portland,Oregon State,53,45,0,8,2016-12-18
Holy Cross,Rhode Island,54,65,1,-11,2016-12-18
Fordham,Rutgers,53,68,1,-15,2016-12-18
Elon,St. Peter's,68,53,0,15,2016-12-18
Bowling Green State,San Jose State,76,77,1,-1,2016-12-18
Jacksonville State,USC Upstate,67,66,0,1,2016-12-18
Penn State,St. John's (NY),92,76,0,16,2016-12-18
Louisiana State-Shreveport,Stephen F. Austin,73,93,1,-20,2016-12-18
Purdue-Fort Wayne,Stetson,93,74,0,19,2016-12-18
Gonzaga,Tennessee,86,76,0,10,2016-12-18
UTSA,Texas A&M-Corpus Christi,69,73,1,-4,2016-12-18
Texas Southern,TCU,59,96,1,-37,2016-12-18
Western Michigan,Washington,86,92,1,-6,2016-12-18
Colorado,Air Force,75,68,0,7,2016-12-19
Maryland-Eastern Shore,American,58,61,1,-3,2016-12-19
Longwood,Ball State,45,61,1,-16,2016-12-19
Mount St. Mary's,Bucknell,65,81,1,-16,2016-12-19
Johnson & Wales (NC),Campbell,59,90,1,-31,2016-12-19
Lake Erie,Cleveland State,62,79,1,-17,2016-12-19
Wofford,Coastal Carolina,75,74,0,1,2016-12-19
Loyola Marymount,Colorado State,69,66,0,3,2016-12-19
Arkansas-Pine Bluff,Denver,52,74,1,-22,2016-12-19
Southeast Missouri State,DePaul,78,81,1,-3,2016-12-19
South Dakota State,Drake,83,75,0,8,2016-12-19
Tennessee State,Duke,55,65,1,-10,2016-12-19
Jackson State,Duquesne,62,74,1,-12,2016-12-19
Fontbonne,Eastern Illinois,49,101,1,-52,2016-12-19
Samford,Florida State,68,76,1,-8,2016-12-19
SIU-Edwardsville,Green Bay,92,94,1,-2,2016-12-19
Delaware State,Indiana,56,103,1,-47,2016-12-19
Florida Memorial,Jacksonville,63,81,1,-18,2016-12-19
Moravian,Lafayette,67,104,1,-37,2016-12-19
Liberty,Lamar,65,82,1,-17,2016-12-19
Master's,Long Beach State,78,97,1,-19,2016-12-19
College of Charleston,LSU,65,75,1,-10,2016-12-19
Saint Francis (PA),Marquette,65,78,1,-13,2016-12-19
West Virginia Wesleyan,Marshall,65,81,1,-16,2016-12-19
Citadel,UMBC,111,120,1,-9,2016-12-19
Belmont,Milwaukee,62,56,0,6,2016-12-19
Bradley,Ole Miss,49,66,1,-17,2016-12-19
Chicago State,Missouri State,46,66,1,-20,2016-12-19
Central Arkansas,Morehead State,85,111,1,-26,2016-12-19
Southern Illinois,UNLV,61,68,1,-7,2016-12-19
UC-Irvine,New Mexico State,79,85,1,-6,2016-12-19
Eastern Kentucky,Norfolk State,80,87,1,-7,2016-12-19
UNC Greensboro,UNC Asheville,75,73,0,2,2016-12-19
Colgate,Notre Dame,62,77,1,-15,2016-12-19
Little Rock,Oral Roberts,48,63,1,-15,2016-12-19
Western Illinois,Purdue,50,82,1,-32,2016-12-19
Northwestern State,Rice,93,100,1,-7,2016-12-19
Hillsdale,Sam Houston State,81,119,1,-38,2016-12-19
Abilene Christian,San Francisco,51,86,1,-35,2016-12-19
Southern Utah,Seattle,75,89,1,-14,2016-12-19
Spring Hill,South Alabama,50,71,1,-21,2016-12-19
Cornell,USC,67,79,1,-12,2016-12-19
Stanford,SMU,49,72,1,-23,2016-12-19
Mississippi State,Southern Miss,86,44,0,42,2016-12-19
Army,St. Bonaventure,83,92,1,-9,2016-12-19
Eastern Michigan,Syracuse,57,105,1,-48,2016-12-19
Furman,Tennessee Tech,68,62,0,6,2016-12-19
McNeese State,Tulane,70,63,0,7,2016-12-19
New Orleans,Utah State,66,76,1,-10,2016-12-19
High Point,Western Carolina,65,70,1,-5,2016-12-19
Savannah State,William & Mary,85,112,1,-27,2016-12-19
Troy,Wyoming,66,72,1,-6,2016-12-19
New Mexico,Arizona,46,77,1,-31,2016-12-20
Creighton,Arizona State,96,85,0,11,2016-12-20
North Dakota State,Arkansas,55,71,1,-16,2016-12-20
Lipscomb,Austin Peay,99,85,0,14,2016-12-20
Idaho State,BYU,58,84,1,-26,2016-12-20
Louisiana-Monroe,Coppin State,65,53,0,12,2016-12-20
Marist,Delaware,56,59,1,-3,2016-12-20
Georgia,Georgia Tech,60,43,0,17,2016-12-20
Alcorn State,Grand Canyon,53,63,1,-10,2016-12-20
Northern Arizona,UIC,65,75,1,-10,2016-12-20
North Dakota,Iowa,73,84,1,-11,2016-12-20
Mississippi Valley State,Iowa State,60,88,1,-28,2016-12-20
Richmond,James Madison,75,55,0,20,2016-12-20
Pepperdine,Louisiana,64,90,1,-26,2016-12-20
Florida Gulf Coast,Louisiana Tech,79,78,0,1,2016-12-20
Charlotte,Maryland,72,88,1,-16,2016-12-20
UT-Martin,UMKC,77,66,0,11,2016-12-20
Princeton,Monmouth,90,96,1,-6,2016-12-20
Southern,Nebraska,76,81,1,-5,2016-12-20
East Carolina,UNC Wilmington,71,81,1,-10,2016-12-20
Southeastern Louisiana,North Texas,65,71,1,-6,2016-12-20
UC-Riverside,Northern Colorado,61,77,1,-16,2016-12-20
IUPUI,Northwestern,65,87,1,-22,2016-12-20
Northeastern,Oakland,61,59,0,2,2016-12-20
Youngstown State,Ohio State,40,77,1,-37,2016-12-20
Fresno State,Oregon,63,75,1,-12,2016-12-20
Kennesaw State,Pacific,56,69,1,-13,2016-12-20
Portland State,Portland,77,75,0,2,2016-12-20
Maine,Providence,59,79,1,-20,2016-12-20
Texas A&M-Corpus Christi,Saint Mary's,46,67,1,-21,2016-12-20
Florida College,USC Upstate,59,91,1,-32,2016-12-20
Northern Illinois,South Florida,59,48,0,11,2016-12-20
Albany (NY),SMU,53,71,1,-18,2016-12-20
Manhattan,St. Francis (NY),61,54,0,7,2016-12-20
Howard Payne,Texas State,37,87,1,-50,2016-12-20
Loyola (IL),Toledo,70,74,1,-4,2016-12-20
Frostburg State,VMI,53,72,1,-19,2016-12-20
Charleston Southern,Virginia Tech,59,87,1,-28,2016-12-20
Cal Poly,Washington,61,77,1,-16,2016-12-20
Radford,West Virginia,57,84,1,-27,2016-12-20
Georgia Southern,Winthrop,84,86,1,-2,2016-12-20
Eastern Washington,Xavier,56,85,1,-29,2016-12-20
Arkansas State,Alabama,52,67,1,-15,2016-12-21
Hampton,Appalachian State,67,88,1,-21,2016-12-21
Binghamton,Army,60,71,1,-11,2016-12-21
Texas Southern,Baylor,63,89,1,-26,2016-12-21
Cal State Northridge,Boise State,62,79,1,-17,2016-12-21
Fairfield,Boston College,89,83,0,6,2016-12-21
Vermont,Butler,69,81,1,-12,2016-12-21
Virginia,California,56,52,0,4,2016-12-21
Akron,UC-Irvine,88,80,0,8,2016-12-21
Bethune-Cookman,UCF,41,71,1,-30,2016-12-21
Jacksonville State,Chattanooga,57,73,1,-16,2016-12-21
Jacksonville,Davidson,60,75,1,-15,2016-12-21
Vanderbilt,Dayton,63,68,1,-5,2016-12-21
Elon,Duke,61,72,1,-11,2016-12-21
Little Rock,Florida,71,94,1,-23,2016-12-21
Webber,Florida Atlantic,57,77,1,-20,2016-12-21
North Florida,Florida International,54,78,1,-24,2016-12-21
Central Connecticut,Fordham,60,83,1,-23,2016-12-21
South Dakota,Gonzaga,65,102,1,-37,2016-12-21
Liberty,Houston,54,77,1,-23,2016-12-21
Missouri,Illinois,66,75,1,-9,2016-12-21
Eastern Illinois,Indiana State,85,88,1,-3,2016-12-21
UCSB,Iona,57,73,1,-16,2016-12-21
Gardner-Webb,Kansas State,54,67,1,-13,2016-12-21
Arlington Baptist,Lamar,75,126,1,-51,2016-12-21
Niagara,LIU-Brooklyn,75,66,0,9,2016-12-21
Kentucky,Louisville,70,73,1,-3,2016-12-21
SIU-Edwardsville,Marquette,56,89,1,-33,2016-12-21
Boston University,UMass-Lowell,75,77,1,-2,2016-12-21
Incarnate Word,Memphis,71,95,1,-24,2016-12-21
Oakland,Michigan State,65,77,1,-12,2016-12-21
Georgia State,Middle Tennessee,64,56,0,8,2016-12-21
Central Michigan,Montana State,106,103,0,3,2016-12-21
Towson,Nevada,72,81,1,-9,2016-12-21
Daniel Webster,New Hampshire,26,89,1,-63,2016-12-21
Williams Baptist,New Orleans,74,91,1,-17,2016-12-21
Northern Iowa,UNC,42,85,1,-43,2016-12-21
Brescia,Northern Kentucky,73,97,1,-24,2016-12-21
Auburn,Oklahoma,74,70,0,4,2016-12-21
Kent State,Oregon State,50,69,1,-19,2016-12-21
Morgan State,Penn State,55,96,1,-41,2016-12-21
Omaha,Pitt,75,94,1,-19,2016-12-21
Norfolk State,Purdue,45,91,1,-46,2016-12-21
Drexel,Quinnipiac,91,74,0,17,2016-12-21
St. Thomas (TX),Rice,63,83,1,-20,2016-12-21
Buffalo,Robert Morris,71,74,1,-3,2016-12-21
Holy Cross,Sacred Heart,72,67,0,5,2016-12-21
Southern Utah,San Jose State,82,92,1,-10,2016-12-21
Clemson,South Carolina,62,60,0,2,2016-12-21
St. John's (NY),Syracuse,93,60,0,33,2016-12-21
Alabama-Birmingham,Texas,60,96,1,-36,2016-12-21
Saint Francis (PA),Texas A&M,58,81,1,-23,2016-12-21
Bradley,TCU,42,74,1,-32,2016-12-21
Maryland-Eastern Shore,UTEP,71,66,0,5,2016-12-21
Wayland Baptist,Texas-Rio Grande Valley,55,86,1,-31,2016-12-21
Utah Valley,UTSA,60,66,1,-6,2016-12-21
Longwood,Texas Tech,60,91,1,-31,2016-12-21
Western Michigan,UCLA,68,82,1,-14,2016-12-21
Weber State,Utah State,77,71,0,6,2016-12-21
American,Villanova,48,90,1,-42,2016-12-21
Sacramento State,Washington State,66,74,1,-8,2016-12-21
Ohio,Western Kentucky,66,67,1,-1,2016-12-21
UC-Davis,Air Force,67,77,1,-10,2016-12-22
Maryland-Eastern Shore,Akron,60,76,1,-16,2016-12-22
Rust,Alcorn State,68,83,1,-15,2016-12-22
Central Arkansas,Arizona State,62,98,1,-36,2016-12-22
Sam Houston State,Arkansas,56,90,1,-34,2016-12-22
Alabama State,Ball State,48,73,1,-25,2016-12-22
Cleveland State,Belmont,61,88,1,-27,2016-12-22
Alabama A&M,Bowling Green State,61,74,1,-13,2016-12-22
Cal State Bakersfield,BYU,71,81,1,-10,2016-12-22
Maine,Brown,77,82,1,-5,2016-12-22
Dartmouth,Bryant,75,69,0,6,2016-12-22
Princeton,Bucknell,72,70,0,2,2016-12-22
Portland,Cal State Fullerton,72,77,1,-5,2016-12-22
Stetson,Campbell,72,81,1,-9,2016-12-22
Southeast Missouri State,Chicago State,65,74,1,-9,2016-12-22
Marshall,Cincinnati,91,93,1,-2,2016-12-22
Eastern Washington,Colorado,68,76,1,-8,2016-12-22
Troy,Cornell,92,84,0,8,2016-12-22
UC-Riverside,Denver,55,73,1,-18,2016-12-22
Wyoming,DePaul,72,58,0,14,2016-12-22
Purdue-Fort Wayne,Detroit,93,86,0,7,2016-12-22
Mississippi Valley State,Drake,69,101,1,-32,2016-12-22
Colgate,Duquesne,57,70,1,-13,2016-12-22
Presbyterian,East Carolina,56,76,1,-20,2016-12-22
Tennessee,ETSU,72,68,0,4,2016-12-22
Marygrove,Eastern Michigan,48,101,1,-53,2016-12-22
Mt. St. Joseph,Evansville,55,68,1,-13,2016-12-22
Florida National University,Florida Gulf Coast,50,107,1,-57,2016-12-22
Prairie View,George Mason,59,75,1,-16,2016-12-22
UNC Greensboro,Georgetown,56,78,1,-22,2016-12-22
Fisk,Georgia Southern,58,106,1,-48,2016-12-22
Wofford,Georgia Tech,72,76,1,-4,2016-12-22
Arkansas-Pine Bluff,Grand Canyon,49,89,1,-40,2016-12-22
Saint Mary's (MN),Green Bay,59,108,1,-49,2016-12-22
Navy,Hartford,54,63,1,-9,2016-12-22
Illinois State,Hawaii,71,45,0,26,2016-12-22
Siena,Hofstra,64,84,1,-20,2016-12-22
Roosevelt,UIC,53,91,1,-38,2016-12-22
Austin Peay,Indiana,62,97,1,-35,2016-12-22
Towson,Iona,76,69,0,7,2016-12-22
Delaware State,Iowa,57,89,1,-32,2016-12-22
North Carolina A&T,Kennesaw State,60,68,1,-8,2016-12-22
Cabrini,Lehigh,72,93,1,-21,2016-12-22
Colorado State,Long Beach State,55,56,1,-1,2016-12-22
Louisiana State-Shreveport,Louisiana Tech,53,95,1,-42,2016-12-22
Texas-Arlington,Loyola Marymount,80,77,0,3,2016-12-22
Eastern Kentucky,Manhattan,54,81,1,-27,2016-12-22
Rider,UMass,67,78,1,-11,2016-12-22
La Salle,Mercer,98,96,0,2,2016-12-22
George Washington,Miami (FL),64,72,1,-8,2016-12-22
Tennessee Tech,Miami (OH),58,66,1,-8,2016-12-22
Furman,Michigan,62,68,1,-6,2016-12-22
South Alabama,Ole Miss,58,92,1,-34,2016-12-22
Morehead State,Mississippi State,76,85,1,-9,2016-12-22
Pepperdine,Montana,70,71,1,-1,2016-12-22
Coppin State,Mount St. Mary's,49,87,1,-38,2016-12-22
Wright State,Murray State,77,62,0,15,2016-12-22
UCSB,Nevada,66,67,1,-1,2016-12-22
Kansas,UNLV,71,53,0,18,2016-12-22
Dean,NJIT,50,92,1,-42,2016-12-22
McNeese State,NC State,57,89,1,-32,2016-12-22
San Diego,North Texas,69,68,0,1,2016-12-22
Houston Baptist,Northwestern,63,72,1,-9,2016-12-22
UNC Asheville,Ohio State,77,79,1,-2,2016-12-22
Texas A&M-Corpus Christi,Oklahoma State,70,92,1,-22,2016-12-22
Howard,Old Dominion,46,65,1,-19,2016-12-22
Walla Walla,Portland State,59,118,1,-59,2016-12-22
William & Mary,Rhode Island,62,73,1,-11,2016-12-22
Lafayette,St. Joseph's,63,92,1,-29,2016-12-22
Winthrop,Saint Louis,66,55,0,11,2016-12-22
South Carolina State,Saint Mary's,47,74,1,-27,2016-12-22
Florida A&M,Samford,63,83,1,-20,2016-12-22
Washington,Seattle,94,72,0,22,2016-12-22
Delaware,South Florida,53,81,1,-28,2016-12-22
Missouri State,USC,75,83,1,-8,2016-12-22
UT-Martin,Southern Illinois,70,78,1,-8,2016-12-22
San Diego State,Southern Miss,66,51,0,15,2016-12-22
Canisius,St. Bonaventure,106,101,0,5,2016-12-22
Idaho,Stanford,80,86,1,-6,2016-12-22
Tulsa,Stephen F. Austin,74,51,0,23,2016-12-22
Yale,Temple,77,83,1,-6,2016-12-22
UC-Irvine,UTEP,62,57,0,5,2016-12-22
San Francisco,Utah,89,86,0,3,2016-12-22
Santa Clara,Valparaiso,87,80,0,7,2016-12-22
Louisiana-Monroe,VCU,65,78,1,-13,2016-12-22
Staten Island,Wagner,42,94,1,-52,2016-12-22
LSU,Wake Forest,76,110,1,-34,2016-12-22
College of Charleston,Western Carolina,77,59,0,18,2016-12-22
South Dakota State,Wichita State,67,89,1,-22,2016-12-22
Providence,Boston College,67,79,1,-12,2016-12-23
Auburn,UConn,70,67,0,3,2016-12-23
Southeast Missouri State,Cornell,62,78,1,-16,2016-12-23
VMI,Dayton,56,92,1,-36,2016-12-23
Utah,Hawaii,66,52,0,14,2016-12-23
Marist,Holy Cross,59,68,1,-9,2016-12-23
Harvard,Houston,57,56,0,1,2016-12-23
San Francisco,Illinois State,66,58,0,8,2016-12-23
UMBC,James Madison,62,61,0,1,2016-12-23
UMass-Lowell,Loyola (MD),60,69,1,-9,2016-12-23
Arkansas State,Minnesota,75,82,1,-7,2016-12-23
DePaul,Missouri State,58,69,1,-11,2016-12-23
Georgia,Oakland,79,86,1,-7,2016-12-23
Richmond,Oral Roberts,72,87,1,-15,2016-12-23
Pacific Union,Pacific,54,102,1,-48,2016-12-23
Grace,Radford,58,82,1,-24,2016-12-23
Tulsa,San Diego State,63,82,1,-19,2016-12-23
Rutgers,Seton Hall,61,72,1,-11,2016-12-23
Wyoming,USC,92,94,1,-2,2016-12-23
Stephen F. Austin,Southern Miss,67,64,0,3,2016-12-23
St. Peter's,St. Francis (NY),65,58,0,7,2016-12-23
Chicago State,Troy,65,83,1,-18,2016-12-23
Texas State,Tulane,69,66,0,3,2016-12-23
Montana Tech,Utah Valley,47,72,1,-25,2016-12-23
Northern Kentucky,West Virginia,61,92,1,-31,2016-12-23
Florida A&M,Wisconsin,37,90,1,-53,2016-12-23
Southern Miss,Hawaii,46,60,1,-14,2016-12-25
San Francisco,San Diego State,48,62,1,-14,2016-12-25
Illinois State,Tulsa,68,56,0,12,2016-12-25
Stephen F. Austin,Utah,66,74,1,-8,2016-12-25
Morgan State,Loyola Marymount,49,70,1,-21,2016-12-26
Cal State Bakersfield,UCSB,60,62,1,-2,2016-12-27
Illinois,Maryland,59,84,1,-25,2016-12-27
SMU,Memphis,58,54,0,4,2016-12-27
Michigan State,Minnesota,75,74,0,1,2016-12-27
Eastern New Mexico,New Mexico State,50,84,1,-34,2016-12-27
Northwestern,Penn State,87,77,0,10,2016-12-27
Lander,South Carolina,62,90,1,-28,2016-12-27
Cornell,Syracuse,56,80,1,-24,2016-12-27
Covenant,Tennessee State,50,81,1,-31,2016-12-27
Kent State,Texas,63,58,0,5,2016-12-27
Howard,VCU,51,85,1,-34,2016-12-27
Rutgers,Wisconsin,52,72,1,-20,2016-12-27
Miles,Alabama-Birmingham,66,98,1,-32,2016-12-28
Utah Valley,UC-Riverside,73,64,0,9,2016-12-28
UNC Greensboro,Citadel,95,87,0,8,2016-12-28
UNC Wilmington,Clemson,73,87,1,-14,2016-12-28
UNLV,Colorado State,77,91,1,-14,2016-12-28
Houston,UConn,62,46,0,16,2016-12-28
Seton Hall,Creighton,75,89,1,-14,2016-12-28
Hartford,Davidson,75,105,1,-30,2016-12-28
Iona,Delaware,54,63,1,-9,2016-12-28
Oral Roberts,Denver,73,77,1,-4,2016-12-28
South Florida,East Carolina,49,60,1,-11,2016-12-28
Virginia Wise,Eastern Kentucky,51,70,1,-19,2016-12-28
Central Pennsylvania College,Elon,60,89,1,-29,2016-12-28
Florida Gulf Coast,Florida Atlantic,75,62,0,13,2016-12-28
Wake Forest,Florida State,72,88,1,-16,2016-12-28
UMass,Georgia State,74,65,0,9,2016-12-28
North Carolina A&T,Georgia Tech,52,59,1,-7,2016-12-28
Cal Poly,Grand Canyon,64,71,1,-7,2016-12-28
Nebraska,Indiana,87,83,0,4,2016-12-28
Wichita State,Indiana State,80,72,0,8,2016-12-28
Marian,IUPUI,60,81,1,-21,2016-12-28
Thomas University,Jacksonville,64,93,1,-29,2016-12-28
East Mennonite,James Madison,65,82,1,-17,2016-12-28
Mercer,Kennesaw State,80,76,0,4,2016-12-28
Grambling,Louisiana-Monroe,45,81,1,-36,2016-12-28
Virginia,Louisville,61,53,0,8,2016-12-28
Georgetown,Marquette,66,76,1,-10,2016-12-28
Columbia,Miami (FL),67,78,1,-11,2016-12-28
Asbury,Morehead State,77,120,1,-43,2016-12-28
San Jose State,Nevada,55,80,1,-25,2016-12-28
Fresno State,New Mexico,73,78,1,-5,2016-12-28
Spring Hill,Nicholls State,64,88,1,-24,2016-12-28
Monmouth,UNC,74,102,1,-28,2016-12-28
Truett-McConnell,North Carolina Central,54,88,1,-34,2016-12-28
Rider,NC State,71,99,1,-28,2016-12-28
Missouri State,Northern Iowa,68,64,0,4,2016-12-28
Louisiana College,Northwestern State,66,86,1,-20,2016-12-28
St. Peter's,Notre Dame,55,63,1,-8,2016-12-28
UCLA,Oregon,87,89,1,-2,2016-12-28
USC,Oregon State,70,63,0,7,2016-12-28
Drexel,Penn,67,75,1,-8,2016-12-28
Marshall,Pitt,106,112,1,-6,2016-12-28
Huston-Tillotson,Prairie View,57,87,1,-30,2016-12-28
Hampton,Princeton,49,77,1,-28,2016-12-28
Iowa,Purdue,67,89,1,-22,2016-12-28
Fort Valley State,Samford,74,94,1,-20,2016-12-28
UC-Davis,Seattle,72,65,0,7,2016-12-28
North Dakota State,South Dakota State,80,69,0,11,2016-12-28
Southeastern Louisiana,Southern,64,53,0,11,2016-12-28
Missouri S&T,SIU-Edwardsville,67,85,1,-18,2016-12-28
NJIT,Stony Brook,64,61,0,3,2016-12-28
Cincinnati,Temple,56,50,0,6,2016-12-28
UCF,Tulane,85,72,0,13,2016-12-28
Boise State,Utah State,83,80,0,3,2016-12-28
Chicago State,Valparaiso,61,80,1,-19,2016-12-28
DePaul,Villanova,65,68,1,-3,2016-12-28
UMBC,Virginia Tech,70,87,1,-17,2016-12-28
Mars Hill,Western Carolina,71,87,1,-16,2016-12-28
Austin Peay,Western Kentucky,92,97,1,-5,2016-12-28
Air Force,Wyoming,72,84,1,-12,2016-12-28
Providence,Xavier,56,82,1,-26,2016-12-28
Stetson,Alabama,60,83,1,-23,2016-12-29
Fort Valley State,Alabama State,68,75,1,-7,2016-12-29
Florida,Arkansas,81,72,0,9,2016-12-29
Georgia,Auburn,96,84,0,12,2016-12-29
Southern Illinois,Bradley,51,60,1,-9,2016-12-29
Santa Clara,BYU,59,89,1,-30,2016-12-29
Quinnipiac,Brown,61,66,1,-5,2016-12-29
Morgan State,Cal State Northridge,61,82,1,-21,2016-12-29
Winthrop,Charleston Southern,84,68,0,16,2016-12-29
Green Bay,Cleveland State,76,75,0,1,2016-12-29
UMass-Lowell,Cornell,98,96,0,2,2016-12-29
Northern Kentucky,Detroit,81,70,0,11,2016-12-29
Loyola (IL),Drake,98,102,1,-4,2016-12-29
Savannah State,ETSU,71,92,1,-21,2016-12-29
Long Beach State,Eastern Michigan,72,98,1,-26,2016-12-29
Saint Francis (PA),Fairleigh Dickinson,65,77,1,-12,2016-12-29
High Point,Gardner-Webb,71,64,0,7,2016-12-29
Pepperdine,Gonzaga,62,92,1,-30,2016-12-29
Delaware State,Hawaii,66,77,1,-11,2016-12-29
Evansville,Illinois State,50,62,1,-12,2016-12-29
Western Illinois,Purdue-Fort Wayne,93,91,0,2,2016-12-29
Huston-Tillotson,Lamar,63,90,1,-27,2016-12-29
Mount St. Mary's,LIU-Brooklyn,67,65,0,2,2016-12-29
Campbell,Longwood,77,79,1,-2,2016-12-29
Vanderbilt,LSU,96,89,0,7,2016-12-29
Saint Mary's,Loyola Marymount,72,60,0,12,2016-12-29
Olivet,Miami (OH),69,89,1,-20,2016-12-29
Kentucky,Ole Miss,99,76,0,23,2016-12-29
UMKC,Mississippi State,54,77,1,-23,2016-12-29
Lipscomb,Missouri,81,76,0,5,2016-12-29
Idaho State,Montana,62,74,1,-12,2016-12-29
Weber State,Montana State,87,75,0,12,2016-12-29
Brescia,Murray State,83,99,1,-16,2016-12-29
Abilene Christian,New Orleans,66,75,1,-9,2016-12-29
Ball State,North Florida,73,68,0,5,2016-12-29
Wright State,Oakland,62,81,1,-19,2016-12-29
William & Mary,Old Dominion,65,54,0,11,2016-12-29
Portland,Pacific,80,76,0,4,2016-12-29
North Dakota,Portland State,62,99,1,-37,2016-12-29
Liberty,Presbyterian,77,61,0,16,2016-12-29
UNC Asheville,Radford,77,80,1,-3,2016-12-29
Northern Colorado,Sacramento State,69,53,0,16,2016-12-29
Robert Morris,Sacred Heart,78,67,0,11,2016-12-29
Houston Baptist,Sam Houston State,79,65,0,14,2016-12-29
San Diego,San Francisco,74,80,1,-6,2016-12-29
Vermont,Siena,76,60,0,16,2016-12-29
Omaha,South Dakota,69,86,1,-17,2016-12-29
Henderson State,Southeast Missouri State,75,89,1,-14,2016-12-29
Bryant,St. Francis (NY),77,80,1,-3,2016-12-29
Butler,St. John's (NY),73,76,1,-3,2016-12-29
Jacksonville State,UT-Martin,90,72,0,18,2016-12-29
Tennessee,Texas A&M,73,63,0,10,2016-12-29
Our Lady of the Lake,Texas-Rio Grande Valley,81,97,1,-16,2016-12-29
East Central,UTSA,75,79,1,-4,2016-12-29
Central Connecticut,Wagner,46,71,1,-25,2016-12-29
Alabama A&M,Western Michigan,50,80,1,-30,2016-12-29
Milwaukee,Youngstown State,87,88,1,-1,2016-12-29
Loyola (MD),American,68,66,0,2,2016-12-30
Lehigh,Army,66,59,0,7,2016-12-30
Marywood,Binghamton,54,101,1,-47,2016-12-30
Holy Cross,Boston University,55,61,1,-6,2016-12-30
Norfolk State,Bowling Green State,77,86,1,-9,2016-12-30
Maine,Buffalo,60,79,1,-19,2016-12-30
Bethesda University (CA),Cal State Fullerton,56,99,1,-43,2016-12-30
Arizona,California,67,62,0,5,2016-12-30
Life Pacific,UC-Irvine,43,101,1,-58,2016-12-30
Seattle,UCSB,80,76,0,4,2016-12-30
Chicago State,Central Michigan,82,90,1,-8,2016-12-30
Albany (NY),Columbia,70,67,0,3,2016-12-30
La Salle,Dayton,55,66,1,-11,2016-12-30
Duquesne,Fordham,75,72,0,3,2016-12-30
VCU,George Mason,73,64,0,9,2016-12-30
Coker,Hampton,69,94,1,-25,2016-12-30
Howard,Harvard,46,67,1,-21,2016-12-30
Eastern Washington,Idaho,69,62,0,7,2016-12-30
Valparaiso,UIC,70,59,0,11,2016-12-30
Texas Tech,Iowa State,56,63,1,-7,2016-12-30
Fisk,Jackson State,62,94,1,-32,2016-12-30
Texas,Kansas State,62,65,1,-3,2016-12-30
Colgate,Lafayette,85,75,0,10,2016-12-30
St. Bonaventure,UMass,89,77,0,12,2016-12-30
South Carolina,Memphis,54,70,1,-16,2016-12-30
Northwestern,Michigan State,52,61,1,-9,2016-12-30
Bucknell,Navy,59,55,0,4,2016-12-30
UTEP,New Mexico State,70,79,1,-9,2016-12-30
Montreat,North Carolina Central,66,101,1,-35,2016-12-30
Urbana,Ohio,50,77,1,-27,2016-12-30
Baylor,Oklahoma,76,50,0,26,2016-12-30
West Virginia,Oklahoma State,92,75,0,17,2016-12-30
USC,Oregon,61,84,1,-23,2016-12-30
UCLA,Oregon State,76,63,0,13,2016-12-30
Fairfield,Penn,68,74,1,-6,2016-12-30
George Washington,St. Joseph's,63,68,1,-5,2016-12-30
Rhode Island,Saint Louis,90,56,0,34,2016-12-30
Allen,USC Upstate,67,93,1,-26,2016-12-30
Arizona State,Stanford,98,93,0,5,2016-12-30
Kansas,TCU,86,80,0,6,2016-12-30
Ohio Christian,Toledo,58,98,1,-40,2016-12-30
Utah State,Air Force,73,78,1,-5,2016-12-31
Louisiana-Monroe,Little Rock,75,79,1,-4,2016-12-31
Louisiana,Arkansas State,71,74,1,-3,2016-12-31
Belmont,Austin Peay,82,77,0,5,2016-12-31
Colorado State,Boise State,73,74,1,-1,2016-12-31
Stony Brook,Brown,92,89,0,3,2016-12-31
Utah Valley,UC-Davis,69,83,1,-14,2016-12-31
Grand Canyon,UC-Riverside,56,76,1,-20,2016-12-31
Presbyterian,Campbell,58,69,1,-11,2016-12-31
Sam Houston State,Central Arkansas,65,67,1,-2,2016-12-31
Temple,UCF,53,77,1,-24,2016-12-31
Liberty,Charleston Southern,81,70,0,11,2016-12-31
North Texas,Charlotte,76,101,1,-25,2016-12-31
Milwaukee,Cleveland State,53,62,1,-9,2016-12-31
Villanova,Creighton,80,70,0,10,2016-12-31
New Hampshire,Dartmouth,62,63,1,-1,2016-12-31
Richmond,Davidson,82,80,0,2,2016-12-31
Hofstra,Delaware,58,56,0,2,2016-12-31
Wright State,Detroit,85,72,0,13,2016-12-31
SMU,East Carolina,75,44,0,31,2016-12-31
VMI,ETSU,75,102,1,-27,2016-12-31
Jacksonville State,Eastern Illinois,57,56,0,1,2016-12-31
College of Charleston,Elon,66,54,0,12,2016-12-31
Robert Morris,Fairleigh Dickinson,77,81,1,-4,2016-12-31
Western Kentucky,Florida Atlantic,69,54,0,15,2016-12-31
Florida Tech,Florida Gulf Coast,49,101,1,-52,2016-12-31
Marshall,Florida International,94,70,0,24,2016-12-31
Nevada,Fresno State,76,77,1,-1,2016-12-31
Citadel,Furman,68,83,1,-15,2016-12-31
Xavier,Georgetown,81,76,0,5,2016-12-31
Georgia State,Georgia Southern,65,88,1,-23,2016-12-31
UNC,Georgia Tech,63,75,1,-12,2016-12-31
Longwood,High Point,60,55,0,5,2016-12-31
Louisville,Indiana,77,62,0,15,2016-12-31
Marist,Iona,80,93,1,-13,2016-12-31
Oral Roberts,Purdue-Fort Wayne,91,102,1,-11,2016-12-31
Western Illinois,IUPUI,71,89,1,-18,2016-12-31
South Carolina State,Jacksonville,85,89,1,-4,2016-12-31
Drexel,James Madison,67,78,1,-11,2016-12-31
North Georgia,Kennesaw State,76,89,1,-13,2016-12-31
Bryant,LIU-Brooklyn,63,74,1,-11,2016-12-31
BYU,Loyola Marymount,81,76,0,5,2016-12-31
NC State,Miami (FL),63,81,1,-18,2016-12-31
Indiana State,Missouri State,75,81,1,-6,2016-12-31
Rider,Monmouth,93,90,0,3,2016-12-31
Weber State,Montana,84,81,0,3,2016-12-31
Idaho State,Montana State,63,80,1,-17,2016-12-31
Wagner,Mount St. Mary's,56,57,1,-1,2016-12-31
Tennessee State,Murray State,83,92,1,-9,2016-12-31
Wyoming,UNLV,75,81,1,-6,2016-12-31
Texas A&M-Corpus Christi,New Orleans,72,73,1,-1,2016-12-31
Incarnate Word,Nicholls State,84,94,1,-10,2016-12-31
Gardner-Webb,UNC Asheville,85,90,1,-5,2016-12-31
Samford,UNC Greensboro,73,62,0,11,2016-12-31
Omaha,North Dakota State,70,82,1,-12,2016-12-31
William & Mary,Northeastern,64,84,1,-20,2016-12-31
Southern Utah,Northern Arizona,93,80,0,13,2016-12-31
Illinois-Springfield,Northern Illinois,62,77,1,-15,2016-12-31
McNeese State,Northwestern State,79,72,0,7,2016-12-31
Northern Kentucky,Oakland,65,76,1,-11,2016-12-31
Rice,Old Dominion,56,62,1,-6,2016-12-31
Gonzaga,Pacific,81,61,0,20,2016-12-31
Notre Dame,Pitt,78,77,0,1,2016-12-31
Pepperdine,Portland,60,73,1,-13,2016-12-31
Northern Colorado,Portland State,73,59,0,14,2016-12-31
Cal Poly,Princeton,52,81,1,-29,2016-12-31
North Dakota,Sacramento State,90,82,0,8,2016-12-31
Saint Francis (PA),Sacred Heart,87,67,0,20,2016-12-31
San Diego,Saint Mary's,60,72,1,-12,2016-12-31
San Francisco,Santa Clara,58,72,1,-14,2016-12-31
South Dakota,South Dakota State,72,73,1,-1,2016-12-31
Houston,South Florida,70,56,0,14,2016-12-31
Eastern Kentucky,Southeast Missouri State,48,81,1,-33,2016-12-31
Abilene Christian,Southeastern Louisiana,53,75,1,-22,2016-12-31
Tennessee Tech,SIU-Edwardsville,72,66,0,6,2016-12-31
Central Connecticut,St. Francis (NY),77,86,1,-9,2016-12-31
Houston Baptist,Stephen F. Austin,51,61,1,-10,2016-12-31
Morehead State,UT-Martin,77,81,1,-4,2016-12-31
Coastal Carolina,Texas-Arlington,69,90,1,-21,2016-12-31
Texas A&M-Kingsville,Texas-Rio Grande Valley,78,96,1,-18,2016-12-31
Appalachian State,Texas State,58,67,1,-9,2016-12-31
UNC Wilmington,Towson,76,67,0,9,2016-12-31
UConn,Tulsa,59,61,1,-2,2016-12-31
Florida State,Virginia,60,58,0,2,2016-12-31
Duke,Virginia Tech,75,89,1,-14,2016-12-31
Clemson,Wake Forest,73,68,0,5,2016-12-31
Chattanooga,Western Carolina,64,48,0,16,2016-12-31
Radford,Winthrop,82,80,0,2,2016-12-31
Mercer,Wofford,71,88,1,-17,2016-12-31
Green Bay,Youngstown State,90,77,0,13,2016-12-31
Syracuse,Boston College,81,96,1,-15,2017-01-01
Providence,Butler,61,78,1,-17,2017-01-01
Arizona State,California,65,81,1,-16,2017-01-01
Tulane,Cincinnati,56,92,1,-36,2017-01-01
St. John's (NY),DePaul,79,73,0,6,2017-01-01
Northern Iowa,Evansville,58,70,1,-12,2017-01-01
Ohio State,Illinois,70,75,1,-5,2017-01-01
Michigan,Iowa,83,86,1,-3,2017-01-01
Illinois State,Loyola (IL),81,59,0,22,2017-01-01
Nebraska,Maryland,67,65,0,2,2017-01-01
Alabama-Birmingham,Middle Tennessee,49,60,1,-11,2017-01-01
Minnesota,Purdue,91,82,0,9,2017-01-01
Penn State,Rutgers,60,47,0,13,2017-01-01
New Mexico,San Diego State,68,62,0,6,2017-01-01
Marquette,Seton Hall,66,69,1,-3,2017-01-01
Drake,Southern Illinois,69,83,1,-14,2017-01-01
Louisiana Tech,Southern Miss,79,55,0,24,2017-01-01
Arizona,Stanford,91,52,0,39,2017-01-01
UTEP,UTSA,55,67,1,-12,2017-01-01
Colorado,Utah,60,76,1,-16,2017-01-01
Washington State,Washington,79,74,0,5,2017-01-01
Bradley,Wichita State,66,100,1,-34,2017-01-01
Jackson State,Alabama A&M,63,51,0,12,2017-01-02
Grambling,Alabama State,69,73,1,-4,2017-01-02
Cornell,Albany (NY),59,69,1,-10,2017-01-02
Texas Southern,Alcorn State,67,65,0,2,2017-01-02
Louisiana,Little Rock,69,52,0,17,2017-01-02
Mississippi Valley State,Arkansas-Pine Bluff,91,105,1,-14,2017-01-02
Louisiana-Monroe,Arkansas State,45,76,1,-31,2017-01-02
Lehigh,Boston University,61,75,1,-14,2017-01-02
Army,Bucknell,76,84,1,-8,2017-01-02
Siena,Canisius,79,82,1,-3,2017-01-02
Lamar,Central Arkansas,78,75,0,3,2017-01-02
Rice,Charlotte,89,70,0,19,2017-01-02
American,Colgate,67,64,0,3,2017-01-02
College of Charleston,Delaware,65,56,0,9,2017-01-02
Northeastern,Drexel,75,70,0,5,2017-01-02
Iona,Fairfield,87,93,1,-6,2017-01-02
Marshall,Florida Atlantic,89,72,0,17,2017-01-02
Western Kentucky,Florida International,69,66,0,3,2017-01-02
Mercer,Furman,69,71,1,-2,2017-01-02
William & Mary,Hofstra,95,93,0,2,2017-01-02
Navy,Holy Cross,50,51,1,-1,2017-01-02
Towson,James Madison,44,64,1,-20,2017-01-02
Lafayette,Loyola (MD),78,69,0,9,2017-01-02
Columbia,Maine,98,73,0,25,2017-01-02
Manhattan,Marist,88,90,1,-2,2017-01-02
Valley Forge,Maryland-Eastern Shore,65,90,1,-25,2017-01-02
Stephen F. Austin,McNeese State,54,69,1,-15,2017-01-02
USC Upstate,UMKC,84,75,0,9,2017-01-02
Wheelock,New Hampshire,50,95,1,-45,2017-01-02
Quinnipiac,Niagara,81,78,0,3,2017-01-02
Texas A&M-Corpus Christi,Nicholls State,64,68,1,-4,2017-01-02
Chattanooga,UNC Greensboro,68,73,1,-5,2017-01-02
Elon,UNC Wilmington,63,79,1,-16,2017-01-02
Palm Beach Atlantic,North Florida,67,102,1,-35,2017-01-02
North Texas,Old Dominion,48,55,1,-7,2017-01-02
Monmouth,St. Peter's,61,71,1,-10,2017-01-02
Troy,South Alabama,75,76,1,-1,2017-01-02
Incarnate Word,Southeastern Louisiana,63,74,1,-11,2017-01-02
Prairie View,Southern,57,59,1,-2,2017-01-02
Ave Maria,Stetson,72,95,1,-23,2017-01-02
Kennesaw State,Tennessee State,76,73,0,3,2017-01-02
Appalachian State,Texas-Arlington,69,84,1,-15,2017-01-02
Coastal Carolina,Texas State,60,53,0,7,2017-01-02
Antelope Valley,Utah Valley,63,102,1,-39,2017-01-02
Harvard,Vermont,71,82,1,-11,2017-01-02
Samford,Western Carolina,70,65,0,5,2017-01-02
Citadel,Wofford,104,103,0,1,2017-01-02
Hartford,Yale,72,88,1,-16,2017-01-02
Bowling Green State,Akron,84,89,1,-5,2017-01-03
East Carolina,UCF,45,48,1,-3,2017-01-03
UNC,Clemson,89,86,0,3,2017-01-03
Cal State Bakersfield,Dartmouth,64,60,0,4,2017-01-03
Central Michigan,Eastern Michigan,63,85,1,-22,2017-01-03
Ole Miss,Florida,63,70,1,-7,2017-01-03
Wisconsin,Indiana,75,68,0,7,2017-01-03
Middle Georgia State,Jacksonville,85,124,1,-39,2017-01-03
Kansas State,Kansas,88,90,1,-2,2017-01-03
Ball State,Kent State,90,100,1,-10,2017-01-03
Texas A&M,Kentucky,58,100,1,-42,2017-01-03
UNC Asheville,Liberty,70,57,0,13,2017-01-03
Northern Illinois,Miami (OH),67,69,1,-2,2017-01-03
Alabama,Mississippi State,68,58,0,10,2017-01-03
Western Michigan,Ohio,58,89,1,-31,2017-01-03
St. Joseph's,Rhode Island,58,88,1,-30,2017-01-03
Dayton,St. Bonaventure,90,74,0,16,2017-01-03
Arkansas,Tennessee,82,78,0,4,2017-01-03
Oklahoma,TCU,57,60,1,-3,2017-01-03
West Virginia,Texas Tech,76,77,1,-1,2017-01-03
Buffalo,Toledo,54,86,1,-32,2017-01-03
Boston College,Wake Forest,66,79,1,-13,2017-01-03
Grambling,Alabama A&M,69,67,0,2,2017-01-04
Jackson State,Alabama State,63,60,0,3,2017-01-04
Prairie View,Alcorn State,55,66,1,-11,2017-01-04
Iowa State,Baylor,63,65,1,-2,2017-01-04
Villanova,Butler,58,66,1,-8,2017-01-04
UC-Riverside,Cal State Northridge,76,82,1,-6,2017-01-04
UCSB,UC-Davis,47,73,1,-26,2017-01-04
Long Beach State,UC-Irvine,67,82,1,-15,2017-01-04
Charleston Southern,Campbell,82,92,1,-10,2017-01-04
Quinnipiac,Canisius,77,83,1,-6,2017-01-04
South Carolina State,Coppin State,59,75,1,-16,2017-01-04
South Dakota,Denver,75,69,0,6,2017-01-04
Georgia Tech,Duke,57,110,1,-53,2017-01-04
VCU,Duquesne,94,87,0,7,2017-01-04
Bradley,Evansville,74,63,0,11,2017-01-04
Wyoming,Fresno State,70,85,1,-15,2017-01-04
UMass,George Mason,81,86,1,-5,2017-01-04
South Carolina,Georgia,67,61,0,6,2017-01-04
North Carolina A&T,Hampton,53,68,1,-15,2017-01-04
Winthrop,High Point,80,74,0,6,2017-01-04
Tulsa,Houston,61,64,1,-3,2017-01-04
Florida A&M,Howard,78,66,0,12,2017-01-04
Missouri State,Illinois State,71,74,1,-3,2017-01-04
Saint Louis,La Salle,54,75,1,-21,2017-01-04
Presbyterian,Longwood,76,79,1,-3,2017-01-04
Northern Iowa,Loyola (IL),66,77,1,-11,2017-01-04
Penn State,Michigan,69,72,1,-3,2017-01-04
Rutgers,Michigan State,65,93,1,-28,2017-01-04
LSU,Missouri,88,77,0,11,2017-01-04
Norfolk State,Morgan State,56,58,1,-2,2017-01-04
Purdue-Fort Wayne,Omaha,80,78,0,2,2017-01-04
San Diego State,Nevada,69,72,1,-3,2017-01-04
Boise State,UNLV,77,59,0,18,2017-01-04
Siena,Niagara,66,71,1,-5,2017-01-04
Brown,NJIT,73,75,1,-2,2017-01-04
Virginia Tech,NC State,78,104,1,-26,2017-01-04
Louisville,Notre Dame,70,77,1,-7,2017-01-04
Virginia,Pitt,76,88,1,-12,2017-01-04
Georgetown,Providence,70,76,1,-6,2017-01-04
Gardner-Webb,Radford,70,59,0,11,2017-01-04
Fordham,Richmond,72,80,1,-8,2017-01-04
Colorado State,San Jose State,76,71,0,5,2017-01-04
Bethune-Cookman,Savannah State,91,104,1,-13,2017-01-04
Texas Southern,Southern,82,74,0,8,2017-01-04
Indiana State,Southern Illinois,74,80,1,-6,2017-01-04
Temple,SMU,65,79,1,-14,2017-01-04
Creighton,St. John's (NY),85,72,0,13,2017-01-04
Miami (FL),Syracuse,55,70,1,-15,2017-01-04
Oklahoma State,Texas,79,82,1,-3,2017-01-04
New Mexico,Utah State,75,79,1,-4,2017-01-04
Auburn,Vanderbilt,61,80,1,-19,2017-01-04
Oregon,Washington,83,61,0,22,2017-01-04
Oregon State,Washington State,62,75,1,-13,2017-01-04
South Dakota State,Western Illinois,74,82,1,-8,2017-01-04
Drake,Wichita State,65,90,1,-25,2017-01-04
Central Arkansas,Abilene Christian,81,76,0,5,2017-01-05
Bucknell,American,69,60,0,9,2017-01-05
Utah,Arizona,56,66,1,-10,2017-01-05
Colorado,Arizona State,77,78,1,-1,2017-01-05
UT-Martin,Belmont,67,83,1,-16,2017-01-05
Mount St. Mary's,Bryant,71,72,1,-1,2017-01-05
Hawaii,Cal State Fullerton,64,67,1,-3,2017-01-05
Sacred Heart,Central Connecticut,64,62,0,2,2017-01-05
Wofford,Chattanooga,66,77,1,-11,2017-01-05
Texas-Rio Grande Valley,Chicago State,83,64,0,19,2017-01-05
ETSU,Citadel,115,71,0,44,2017-01-05
Holy Cross,Colgate,67,61,0,6,2017-01-05
Towson,College of Charleston,57,62,1,-5,2017-01-05
UNC Wilmington,Drexel,90,72,0,18,2017-01-05
SIU-Edwardsville,Eastern Kentucky,61,78,1,-17,2017-01-05
Montana State,Eastern Washington,64,82,1,-18,2017-01-05
Davidson,George Washington,69,73,1,-4,2017-01-05
James Madison,Hofstra,62,54,0,8,2017-01-05
Southeastern Louisiana,Houston Baptist,74,81,1,-7,2017-01-05
Montana,Idaho,70,57,0,13,2017-01-05
Northwestern State,Incarnate Word,80,84,1,-4,2017-01-05
Murray State,Jacksonville State,76,63,0,13,2017-01-05
Army,Lafayette,74,79,1,-5,2017-01-05
New Orleans,Lamar,66,62,0,4,2017-01-05
Loyola (MD),Lehigh,84,83,0,1,2017-01-05
Fisk,Lipscomb,43,126,1,-83,2017-01-05
UTEP,Louisiana Tech,44,64,1,-20,2017-01-05
Vermont,Maine,90,77,0,13,2017-01-05
Fairfield,Manhattan,97,79,0,18,2017-01-05
Old Dominion,Marshall,86,90,1,-4,2017-01-05
Binghamton,UMBC,71,85,1,-14,2017-01-05
Albany (NY),UMass-Lowell,79,85,1,-6,2017-01-05
Sam Houston State,McNeese State,74,67,0,7,2017-01-05
UConn,Memphis,61,70,1,-9,2017-01-05
VMI,Mercer,50,68,1,-18,2017-01-05
New Mexico State,UMKC,77,64,0,13,2017-01-05
Eastern Illinois,Morehead State,75,85,1,-10,2017-01-05
Boston University,Navy,71,53,0,18,2017-01-05
Iowa,Nebraska,90,93,1,-3,2017-01-05
Stony Brook,New Hampshire,59,56,0,3,2017-01-05
Northern Arizona,North Dakota,63,68,1,-5,2017-01-05
IUPUI,North Dakota State,89,93,1,-4,2017-01-05
Alabama-Birmingham,North Texas,54,52,0,2,2017-01-05
Delaware,Northeastern,54,90,1,-36,2017-01-05
Southern Utah,Northern Colorado,78,76,0,2,2017-01-05
Youngstown State,Northern Kentucky,70,83,1,-13,2017-01-05
Minnesota,Northwestern,70,66,0,4,2017-01-05
Purdue,Ohio State,76,75,0,1,2017-01-05
Loyola Marymount,Pepperdine,70,71,1,-1,2017-01-05
Middle Tennessee,Rice,80,77,0,3,2017-01-05
LIU-Brooklyn,Robert Morris,65,54,0,11,2017-01-05
St. Francis (NY),Saint Francis (PA),56,81,1,-25,2017-01-05
BYU,Saint Mary's,68,81,1,-13,2017-01-05
Furman,Samford,83,73,0,10,2017-01-05
Pacific,San Diego,56,53,0,3,2017-01-05
Gonzaga,San Francisco,95,80,0,15,2017-01-05
Portland,Santa Clara,42,70,1,-28,2017-01-05
Stanford,USC,56,72,1,-16,2017-01-05
UTSA,Southern Miss,59,77,1,-18,2017-01-05
Southeast Missouri State,Tennessee State,62,65,1,-3,2017-01-05
Austin Peay,Tennessee Tech,67,76,1,-9,2017-01-05
California,UCLA,71,81,1,-10,2017-01-05
Fairleigh Dickinson,Wagner,70,69,0,1,2017-01-05
Charlotte,Western Kentucky,80,82,1,-2,2017-01-05
Elon,William & Mary,85,88,1,-3,2017-01-05
Cleveland State,Wright State,51,55,1,-4,2017-01-05
Western Michigan,Akron,59,66,1,-7,2017-01-06
Rhode Island,Dayton,64,67,1,-3,2017-01-06
Milwaukee,Green Bay,74,80,1,-6,2017-01-06
Detroit,UIC,64,78,1,-14,2017-01-06
Rider,Marist,73,62,0,11,2017-01-06
Iona,Monmouth,74,92,1,-18,2017-01-06
Kent State,Ohio,67,85,1,-18,2017-01-06
Oakland,Valparaiso,78,66,0,12,2017-01-06
Stephen F. Austin,Abilene Christian,60,69,1,-9,2017-01-07
Vanderbilt,Alabama,56,59,1,-3,2017-01-07
Little Rock,Appalachian State,76,68,0,8,2017-01-07
Colorado,Arizona,73,82,1,-9,2017-01-07
Utah,Arizona State,88,82,0,6,2017-01-07
Alabama State,Arkansas-Pine Bluff,63,71,1,-8,2017-01-07
Ole Miss,Auburn,88,85,0,3,2017-01-07
Bowling Green State,Ball State,76,71,0,5,2017-01-07
Oklahoma State,Baylor,57,61,1,-4,2017-01-07
Southeast Missouri State,Belmont,75,87,1,-12,2017-01-07
Morgan State,Bethune-Cookman,69,63,0,6,2017-01-07
San Diego State,Boise State,66,78,1,-12,2017-01-07
Loyola (IL),Bradley,78,62,0,16,2017-01-07
Pacific,BYU,62,91,1,-29,2017-01-07
Seattle,Cal State Bakersfield,71,78,1,-7,2017-01-07
Cal State Northridge,Cal State Fullerton,70,65,0,5,2017-01-07
Cal Poly,UC-Davis,64,68,1,-4,2017-01-07
Hawaii,UC-Irvine,56,84,1,-28,2017-01-07
Mount St. Mary's,Central Connecticut,77,68,0,9,2017-01-07
Furman,Chattanooga,64,80,1,-16,2017-01-07
New Mexico State,Chicago State,78,62,0,16,2017-01-07
VMI,Citadel,74,79,1,-5,2017-01-07
Arkansas State,Coastal Carolina,65,80,1,-15,2017-01-07
Hofstra,College of Charleston,71,77,1,-6,2017-01-07
Air Force,Colorado State,58,85,1,-27,2017-01-07
Howard,Columbia,48,66,1,-18,2017-01-07
Harvard,Dartmouth,74,58,0,16,2017-01-07
UNC Wilmington,Delaware,91,81,0,10,2017-01-07
Boston College,Duke,82,93,1,-11,2017-01-07
Eastern Illinois,Eastern Kentucky,74,60,0,14,2017-01-07
Buffalo,Eastern Michigan,77,68,0,9,2017-01-07
Montana,Eastern Washington,65,59,0,6,2017-01-07
Towson,Elon,61,72,1,-11,2017-01-07
Bryant,Fairleigh Dickinson,84,87,1,-3,2017-01-07
Tennessee,Florida,70,83,1,-13,2017-01-07
Coppin State,Florida A&M,53,54,1,-1,2017-01-07
Florida International,Florida Atlantic,64,73,1,-9,2017-01-07
Virginia Tech,Florida State,78,93,1,-15,2017-01-07
St. Joseph's,Fordham,70,55,0,15,2017-01-07
Charleston Southern,Gardner-Webb,75,79,1,-4,2017-01-07
Butler,Georgetown,85,76,0,9,2017-01-07
Missouri,Georgia,66,71,1,-5,2017-01-07
Troy,Georgia Southern,82,86,1,-4,2017-01-07
South Alabama,Georgia State,77,78,1,-1,2017-01-07
Louisville,Georgia Tech,65,50,0,15,2017-01-07
Southern,Grambling,87,79,0,8,2017-01-07
Utah Valley,Grand Canyon,72,82,1,-10,2017-01-07
Cincinnati,Houston,67,58,0,9,2017-01-07
McNeese State,Houston Baptist,49,60,1,-11,2017-01-07
Montana State,Idaho,81,83,1,-2,2017-01-07
New Orleans,Incarnate Word,87,72,0,15,2017-01-07
Illinois,Indiana,80,96,1,-16,2017-01-07
Illinois State,Indiana State,77,58,0,19,2017-01-07
Texas,Iowa State,70,79,1,-9,2017-01-07
Denver,Purdue-Fort Wayne,83,87,1,-4,2017-01-07
North Florida,Jacksonville,80,64,0,16,2017-01-07
Austin Peay,Jacksonville State,68,71,1,-3,2017-01-07
Texas Tech,Kansas,68,85,1,-17,2017-01-07
Oklahoma,Kansas State,64,75,1,-11,2017-01-07
Arkansas,Kentucky,71,97,1,-26,2017-01-07
Duquesne,La Salle,81,88,1,-7,2017-01-07
Southeastern Louisiana,Lamar,54,74,1,-20,2017-01-07
Campbell,Liberty,54,61,1,-7,2017-01-07
Kennesaw State,Lipscomb,79,82,1,-3,2017-01-07
UC-Riverside,Long Beach State,64,70,1,-6,2017-01-07
Louisiana-Monroe,Louisiana,60,69,1,-9,2017-01-07
Mississippi State,LSU,95,78,0,17,2017-01-07
UTSA,Louisiana Tech,69,68,0,1,2017-01-07
Santa Clara,Loyola Marymount,56,66,1,-10,2017-01-07
Charlotte,Marshall,93,110,1,-17,2017-01-07
ETSU,Mercer,67,58,0,9,2017-01-07
Maryland,Michigan,77,70,0,7,2017-01-07
Alabama A&M,Mississippi Valley State,79,76,0,3,2017-01-07
Texas-Rio Grande Valley,UMKC,79,83,1,-4,2017-01-07
Southern Illinois,Missouri State,75,67,0,8,2017-01-07
SIU-Edwardsville,Morehead State,65,73,1,-8,2017-01-07
Nevada,New Mexico,105,104,0,1,2017-01-07
High Point,UNC Asheville,58,88,1,-30,2017-01-07
Delaware State,North Carolina A&T,55,53,0,2,2017-01-07
Western Carolina,UNC Greensboro,57,76,1,-19,2017-01-07
Southern Utah,North Dakota,65,95,1,-30,2017-01-07
Middle Tennessee,North Texas,79,68,0,11,2017-01-07
James Madison,Northeastern,54,64,1,-10,2017-01-07
Northern Arizona,Northern Colorado,79,83,1,-4,2017-01-07
Central Michigan,Northern Illinois,83,87,1,-4,2017-01-07
Cleveland State,Northern Kentucky,75,83,1,-8,2017-01-07
Clemson,Notre Dame,70,75,1,-5,2017-01-07
Michigan State,Penn State,63,72,1,-9,2017-01-07
San Diego,Pepperdine,76,68,0,8,2017-01-07
Sacramento State,Portland State,76,83,1,-7,2017-01-07
Texas Southern,Prairie View,87,82,0,5,2017-01-07
Radford,Presbyterian,76,63,0,13,2017-01-07
Penn,Princeton,52,61,1,-9,2017-01-07
Creighton,Providence,78,64,0,14,2017-01-07
Manhattan,Quinnipiac,72,81,1,-9,2017-01-07
Alabama-Birmingham,Rice,88,81,0,7,2017-01-07
St. Francis (NY),Robert Morris,58,62,1,-4,2017-01-07
LIU-Brooklyn,Saint Francis (PA),83,70,0,13,2017-01-07
Nicholls State,Sam Houston State,61,74,1,-13,2017-01-07
Saint Mary's,San Francisco,63,52,0,11,2017-01-07
Fresno State,San Jose State,62,69,1,-7,2017-01-07
DePaul,Seton Hall,56,87,1,-31,2017-01-07
St. Peter's,Siena,54,56,1,-2,2017-01-07
Texas A&M,South Carolina,68,79,1,-11,2017-01-07
NJIT,USC Upstate,65,75,1,-10,2017-01-07
IUPUI,South Dakota,74,85,1,-11,2017-01-07
Omaha,South Dakota State,101,93,0,8,2017-01-07
South Florida,SMU,65,84,1,-19,2017-01-07
UTEP,Southern Miss,65,73,1,-8,2017-01-07
George Mason,St. Bonaventure,72,82,1,-10,2017-01-07
Florida Gulf Coast,Stetson,89,88,0,1,2017-01-07
Pitt,Syracuse,66,77,1,-11,2017-01-07
East Carolina,Temple,62,81,1,-19,2017-01-07
UT-Martin,Tennessee State,65,76,1,-11,2017-01-07
Murray State,Tennessee Tech,67,71,1,-4,2017-01-07
Northwestern State,Texas A&M-Corpus Christi,82,99,1,-17,2017-01-07
Texas-Arlington,Texas State,73,81,1,-8,2017-01-07
Miami (OH),Toledo,76,91,1,-15,2017-01-07
UNLV,Utah State,63,79,1,-16,2017-01-07
Marquette,Villanova,81,93,1,-12,2017-01-07
UMass,VCU,64,81,1,-17,2017-01-07
Sacred Heart,Wagner,64,75,1,-11,2017-01-07
Oregon State,Washington,61,87,1,-26,2017-01-07
Oregon,Washington State,85,66,0,19,2017-01-07
TCU,West Virginia,70,82,1,-12,2017-01-07
Oral Roberts,Western Illinois,71,86,1,-15,2017-01-07
Old Dominion,Western Kentucky,79,67,0,12,2017-01-07
Longwood,Winthrop,65,83,1,-18,2017-01-07
Youngstown State,Wright State,80,75,0,5,2017-01-07
St. John's (NY),Xavier,82,97,1,-15,2017-01-07
Mitchell,Yale,46,102,1,-56,2017-01-07
Loyola (MD),Army,57,66,1,-9,2017-01-08
UMass-Lowell,Binghamton,79,75,0,4,2017-01-08
UCF,UConn,49,64,1,-15,2017-01-08
Fisher College,Cornell,72,100,1,-28,2017-01-08
Evansville,Drake,76,88,1,-12,2017-01-08
Richmond,George Washington,77,70,0,7,2017-01-08
Bucknell,Holy Cross,68,49,0,19,2017-01-08
Oakland,UIC,58,57,0,1,2017-01-08
Canisius,Iona,75,98,1,-23,2017-01-08
Rutgers,Iowa,62,68,1,-6,2017-01-08
Boston University,Lafayette,91,75,0,16,2017-01-08
American,Lehigh,73,79,1,-6,2017-01-08
Maine,UMBC,64,75,1,-11,2017-01-08
Ohio State,Minnesota,68,78,1,-10,2017-01-08
Marist,Monmouth,64,71,1,-7,2017-01-08
Colgate,Navy,55,67,1,-12,2017-01-08
Northwestern,Nebraska,74,66,0,8,2017-01-08
NC State,UNC,56,107,1,-51,2017-01-08
Wichita State,Northern Iowa,80,66,0,14,2017-01-08
Wisconsin,Purdue,55,66,1,-11,2017-01-08
Niagara,Rider,78,89,1,-11,2017-01-08
Davidson,Saint Louis,77,66,0,11,2017-01-08
Wofford,Samford,89,91,1,-2,2017-01-08
California,USC,74,73,0,1,2017-01-08
Albany (NY),Stony Brook,70,72,1,-2,2017-01-08
Memphis,Tulane,80,59,0,21,2017-01-08
Stanford,UCLA,75,89,1,-14,2017-01-08
Detroit,Valparaiso,74,81,1,-7,2017-01-08
Hartford,Vermont,54,85,1,-31,2017-01-08
Wake Forest,Virginia,62,79,1,-17,2017-01-08
Arkansas State,Appalachian State,57,70,1,-13,2017-01-09
Alabama A&M,Arkansas-Pine Bluff,65,81,1,-16,2017-01-09
Coppin State,Bethune-Cookman,76,73,0,3,2017-01-09
Little Rock,Coastal Carolina,63,66,1,-3,2017-01-09
St. John's (NY),Georgetown,55,83,1,-28,2017-01-09
South Alabama,Georgia Southern,79,84,1,-5,2017-01-09
Troy,Georgia State,80,77,0,3,2017-01-09
Alcorn State,Grambling,62,67,1,-5,2017-01-09
Savannah State,Hampton,80,84,1,-4,2017-01-09
Olivet,Purdue-Fort Wayne,60,115,1,-55,2017-01-09
Southern,Jackson State,61,65,1,-4,2017-01-09
Alabama State,Mississippi Valley State,70,73,1,-3,2017-01-09
Maryland-Eastern Shore,North Carolina A&T,99,88,0,11,2017-01-09
Quinnipiac,St. Peter's,54,58,1,-4,2017-01-09
Florida,Alabama,80,67,0,13,2017-01-10
Mississippi State,Arkansas,84,78,0,6,2017-01-10
Miami (OH),Ball State,74,85,1,-11,2017-01-10
Eastern Michigan,Bowling Green State,81,53,0,28,2017-01-10
Ohio,Buffalo,74,72,0,2,2017-01-10
Akron,Central Michigan,89,85,0,4,2017-01-10
Providence,DePaul,63,64,1,-1,2017-01-10
Canisius,Fairfield,86,72,0,14,2017-01-10
Morgan State,Florida A&M,62,59,0,3,2017-01-10
Duke,Florida State,72,88,1,-16,2017-01-10
Northern Kentucky,Green Bay,71,80,1,-9,2017-01-10
McGill,Harvard,45,70,1,-25,2017-01-10
Fort Valley State,Jacksonville State,69,81,1,-12,2017-01-10
Northern Illinois,Kent State,74,70,0,4,2017-01-10
Niagara,Manhattan,69,78,1,-9,2017-01-10
Indiana,Maryland,72,75,1,-3,2017-01-10
Auburn,Missouri,77,72,0,5,2017-01-10
UNLV,New Mexico,71,66,0,5,2017-01-10
Delaware State,North Carolina Central,69,68,0,1,2017-01-10
Kansas,Oklahoma,81,70,0,11,2017-01-10
George Mason,St. Joseph's,75,67,0,8,2017-01-10
San Jose State,San Diego State,61,76,1,-15,2017-01-10
Tennessee Tech,Southeast Missouri State,78,83,1,-5,2017-01-10
Kansas State,Texas Tech,65,66,1,-1,2017-01-10
Kentucky,Vanderbilt,87,81,0,6,2017-01-10
Xavier,Villanova,54,79,1,-25,2017-01-10
Syracuse,Virginia Tech,73,83,1,-10,2017-01-10
Baylor,West Virginia,68,89,1,-21,2017-01-10
Toledo,Western Michigan,74,90,1,-16,2017-01-10
Fresno State,Air Force,72,81,1,-9,2017-01-11
New Hampshire,Albany (NY),75,67,0,8,2017-01-11
Colgate,Army,79,76,0,3,2017-01-11
Vermont,Binghamton,67,50,0,17,2017-01-11
NC State,Boston College,66,74,1,-8,2017-01-11
American,Boston University,66,76,1,-10,2017-01-11
Northern Iowa,Bradley,61,72,1,-11,2017-01-11
Lehigh,Bucknell,82,71,0,11,2017-01-11
Radford,Charleston Southern,64,70,1,-6,2017-01-11
Citadel,Chattanooga,73,83,1,-10,2017-01-11
Temple,UConn,59,73,1,-14,2017-01-11
Butler,Creighton,64,75,1,-11,2017-01-11
Fordham,Davidson,60,54,0,6,2017-01-11
Western Illinois,Denver,70,84,1,-14,2017-01-11
Indiana State,Drake,70,87,1,-17,2017-01-11
Saint Louis,Duquesne,66,73,1,-7,2017-01-11
Houston,East Carolina,74,58,0,16,2017-01-11
Campbell,Gardner-Webb,76,60,0,16,2017-01-11
UMBC,Hartford,84,68,0,16,2017-01-11
Liberty,High Point,62,58,0,4,2017-01-11
Lafayette,Holy Cross,54,71,1,-17,2017-01-11
Michigan,Illinois,69,85,1,-16,2017-01-11
Omaha,IUPUI,79,71,0,8,2017-01-11
Alcorn State,Jackson State,63,50,0,13,2017-01-11
Incarnate Word,Lamar,72,87,1,-15,2017-01-11
Cal State Northridge,Long Beach State,89,82,0,7,2017-01-11
Pitt,Louisville,80,85,1,-5,2017-01-11
Navy,Loyola (MD),75,62,0,13,2017-01-11
UMass-Lowell,Maine,71,73,1,-2,2017-01-11
Seton Hall,Marquette,86,89,1,-3,2017-01-11
Dayton,UMass,55,67,1,-12,2017-01-11
Minnesota,Michigan State,47,65,1,-18,2017-01-11
Georgia,Ole Miss,69,47,0,22,2017-01-11
Evansville,Missouri State,51,55,1,-4,2017-01-11
Savannah State,Norfolk State,76,80,1,-4,2017-01-11
Longwood,UNC Asheville,68,89,1,-21,2017-01-11
Maryland-Eastern Shore,North Carolina Central,52,69,1,-17,2017-01-11
Iowa State,Oklahoma State,96,86,0,10,2017-01-11
St. Bonaventure,Richmond,61,78,1,-17,2017-01-11
Mercer,Samford,68,65,0,3,2017-01-11
North Dakota State,South Dakota,70,69,0,1,2017-01-11
Tulane,South Florida,82,67,0,15,2017-01-11
Illinois State,Southern Illinois,60,53,0,7,2017-01-11
Texas A&M-Corpus Christi,Stephen F. Austin,46,79,1,-33,2017-01-11
South Carolina,Tennessee,70,60,0,10,2017-01-11
TCU,Texas,64,61,0,3,2017-01-11
LSU,Texas A&M,62,92,1,-30,2017-01-11
Memphis,Tulsa,71,81,1,-10,2017-01-11
George Washington,VCU,55,85,1,-30,2017-01-11
UNC,Wake Forest,93,87,0,6,2017-01-11
Loyola (IL),Wichita State,75,87,1,-12,2017-01-11
Presbyterian,Winthrop,52,75,1,-23,2017-01-11
Utah State,Wyoming,87,95,1,-8,2017-01-11
Southeastern Louisiana,Abilene Christian,56,50,0,6,2017-01-12
Western Kentucky,Alabama-Birmingham,54,72,1,-18,2017-01-12
Arizona State,Arizona,75,91,1,-16,2017-01-12
San Francisco,BYU,75,85,1,-10,2017-01-12
Wagner,Bryant,66,77,1,-11,2017-01-12
Cal State Fullerton,Cal Poly,87,74,0,13,2017-01-12
Washington,California,59,69,1,-10,2017-01-12
UC-Davis,UC-Riverside,55,61,1,-6,2017-01-12
UC-Irvine,UCSB,66,62,0,4,2017-01-12
Louisiana Tech,Charlotte,79,73,0,6,2017-01-12
SMU,Cincinnati,64,66,1,-2,2017-01-12
UIC,Cleveland State,59,54,0,5,2017-01-12
UCLA,Colorado,104,89,0,15,2017-01-12
UNC Greensboro,ETSU,83,79,0,4,2017-01-12
Murray State,Eastern Illinois,83,72,0,11,2017-01-12
Tennessee State,Eastern Kentucky,63,49,0,14,2017-01-12
Hofstra,Elon,80,96,1,-16,2017-01-12
Clemson,Georgia Tech,63,75,1,-12,2017-01-12
Loyola Marymount,Gonzaga,55,93,1,-38,2017-01-12
Wright State,Green Bay,61,78,1,-17,2017-01-12
Central Arkansas,Houston Baptist,89,78,0,11,2017-01-12
Eastern Washington,Idaho State,92,85,0,7,2017-01-12
Purdue,Iowa,78,83,1,-5,2017-01-12
College of Charleston,James Madison,53,51,0,2,2017-01-12
Florida Gulf Coast,Kennesaw State,78,75,0,3,2017-01-12
Stetson,Lipscomb,68,94,1,-26,2017-01-12
Central Connecticut,LIU-Brooklyn,49,60,1,-11,2017-01-12
Notre Dame,Miami (FL),67,62,0,5,2017-01-12
Marshall,Middle Tennessee,57,69,1,-12,2017-01-12
Northern Kentucky,Milwaukee,58,68,1,-10,2017-01-12
Northern Colorado,Montana,68,89,1,-21,2017-01-12
North Dakota,Montana State,90,85,0,5,2017-01-12
Belmont,Morehead State,84,78,0,6,2017-01-12
Fairleigh Dickinson,Mount St. Mary's,70,77,1,-7,2017-01-12
Grand Canyon,New Mexico State,69,81,1,-12,2017-01-12
Sam Houston State,New Orleans,70,68,0,2,2017-01-12
Jacksonville,NJIT,82,81,0,1,2017-01-12
William & Mary,UNC Wilmington,77,101,1,-24,2017-01-12
Drexel,Northeastern,75,92,1,-17,2017-01-12
Nicholls State,Northwestern State,81,86,1,-5,2017-01-12
Southern Miss,Old Dominion,50,54,1,-4,2017-01-12
South Dakota State,Oral Roberts,88,94,1,-6,2017-01-12
Pepperdine,Pacific,74,79,1,-5,2017-01-12
Saint Mary's,Portland,74,33,0,41,2017-01-12
La Salle,Rhode Island,87,75,0,12,2017-01-12
Saint Francis (PA),Robert Morris,77,57,0,20,2017-01-12
Northwestern,Rutgers,69,60,0,9,2017-01-12
Santa Clara,San Diego,59,57,0,2,2017-01-12
UMKC,Seattle,84,68,0,16,2017-01-12
Quinnipiac,Siena,74,81,1,-7,2017-01-12
North Florida,USC Upstate,73,65,0,8,2017-01-12
Austin Peay,SIU-Edwardsville,83,81,0,2,2017-01-12
Sacramento State,Southern Utah,88,83,0,5,2017-01-12
Sacred Heart,St. Francis (NY),87,75,0,12,2017-01-12
Washington State,Stanford,54,84,1,-30,2017-01-12
Florida International,UTEP,87,88,1,-1,2017-01-12
Cal State Bakersfield,Texas-Rio Grande Valley,88,81,0,7,2017-01-12
Florida Atlantic,UTSA,63,68,1,-5,2017-01-12
Delaware,Towson,56,83,1,-27,2017-01-12
USC,Utah,64,86,1,-22,2017-01-12
Chicago State,Utah Valley,70,61,0,9,2017-01-12
Western Carolina,VMI,78,79,1,-1,2017-01-12
Idaho,Weber State,66,91,1,-25,2017-01-12
Ohio State,Wisconsin,66,89,1,-23,2017-01-12
Valparaiso,Youngstown State,78,62,0,16,2017-01-12
Toledo,Central Michigan,88,96,1,-8,2017-01-13
Rider,Manhattan,73,76,1,-3,2017-01-13
Detroit,Oakland,93,88,0,5,2017-01-13
Yale,Penn,68,60,0,8,2017-01-13
Brown,Princeton,66,97,1,-31,2017-01-13
UMBC,Vermont,72,81,1,-9,2017-01-13
Lamar,Abilene Christian,64,67,1,-3,2017-01-14
San Jose State,Air Force,89,85,0,4,2017-01-14
Alabama State,Alabama A&M,57,55,0,2,2017-01-14
Marshall,Alabama-Birmingham,78,94,1,-16,2017-01-14
Mississippi Valley State,Alcorn State,84,77,0,7,2017-01-14
Army,American,53,49,0,4,2017-01-14
Missouri,Arkansas,73,92,1,-19,2017-01-14
Arkansas State,Little Rock,77,72,0,5,2017-01-14
Northern Illinois,Bowling Green State,69,52,0,17,2017-01-14
Sacred Heart,Bryant,112,110,0,2,2017-01-14
Ball State,Buffalo,92,77,0,15,2017-01-14
Xavier,Butler,78,83,1,-5,2017-01-14
UC-Davis,Cal State Northridge,71,68,0,3,2017-01-14
Washington State,California,54,58,1,-4,2017-01-14
Cal State Fullerton,UC-Irvine,67,87,1,-20,2017-01-14
Cal Poly,UCSB,53,58,1,-5,2017-01-14
Winthrop,Campbell,72,63,0,9,2017-01-14
Marist,Canisius,58,91,1,-33,2017-01-14
Fairleigh Dickinson,Central Connecticut,59,47,0,12,2017-01-14
Houston,UCF,70,77,1,-7,2017-01-14
UNC Asheville,Charleston Southern,76,67,0,9,2017-01-14
Southern Miss,Charlotte,66,82,1,-16,2017-01-14
Samford,Citadel,98,90,0,8,2017-01-14
Virginia,Clemson,77,73,0,4,2017-01-14
Valparaiso,Cleveland State,78,67,0,11,2017-01-14
Appalachian State,Coastal Carolina,73,85,1,-12,2017-01-14
Bucknell,Colgate,83,69,0,14,2017-01-14
William & Mary,College of Charleston,67,77,1,-10,2017-01-14
New Mexico,Colorado State,84,71,0,13,2017-01-14
North Carolina A&T,Coppin State,73,75,1,-2,2017-01-14
Columbia,Cornell,79,75,0,4,2017-01-14
Truman State,Creighton,69,101,1,-32,2017-01-14
VCU,Davidson,63,69,1,-6,2017-01-14
Hampton,Delaware State,85,77,0,8,2017-01-14
North Dakota State,Denver,55,79,1,-24,2017-01-14
Delaware,Drexel,60,76,1,-16,2017-01-14
Dayton,Duquesne,76,57,0,19,2017-01-14
Western Carolina,ETSU,52,75,1,-23,2017-01-14
Austin Peay,Eastern Illinois,92,84,0,8,2017-01-14
Belmont,Eastern Kentucky,72,59,0,13,2017-01-14
Southern Illinois,Evansville,73,61,0,12,2017-01-14
Georgia,Florida,76,80,1,-4,2017-01-14
Boise State,Fresno State,80,89,1,-9,2017-01-14
Saint Louis,George Mason,63,56,0,7,2017-01-14
UConn,Georgetown,69,72,1,-3,2017-01-14
Saint Mary's,Gonzaga,56,79,1,-23,2017-01-14
Long Beach State,Hawaii,107,114,1,-7,2017-01-14
Presbyterian,High Point,44,77,1,-33,2017-01-14
Idaho,Idaho State,77,62,0,15,2017-01-14
Maryland,Illinois,62,56,0,6,2017-01-14
Wichita State,Illinois State,62,76,1,-14,2017-01-14
Houston Baptist,Incarnate Word,77,82,1,-5,2017-01-14
Bradley,Indiana State,71,81,1,-10,2017-01-14
Elon,James Madison,59,60,1,-1,2017-01-14
Oklahoma State,Kansas,80,87,1,-7,2017-01-14
Baylor,Kansas State,77,68,0,9,2017-01-14
Stetson,Kennesaw State,65,84,1,-19,2017-01-14
Auburn,Kentucky,72,92,1,-20,2017-01-14
Navy,Lafayette,88,51,0,37,2017-01-14
Holy Cross,Lehigh,51,68,1,-17,2017-01-14
Florida Gulf Coast,Lipscomb,84,80,0,4,2017-01-14
St. Francis (NY),LIU-Brooklyn,58,63,1,-5,2017-01-14
Gardner-Webb,Longwood,85,79,0,6,2017-01-14
Georgia Southern,Louisiana,81,76,0,5,2017-01-14
Georgia State,Louisiana-Monroe,73,65,0,8,2017-01-14
Alabama,LSU,81,66,0,15,2017-01-14
Duke,Louisville,69,78,1,-9,2017-01-14
Stony Brook,Maine,74,54,0,20,2017-01-14
DePaul,Marquette,58,83,1,-25,2017-01-14
Howard,Maryland-Eastern Shore,72,64,0,8,2017-01-14
Hartford,UMass-Lowell,55,71,1,-16,2017-01-14
South Florida,Memphis,56,62,1,-6,2017-01-14
Chattanooga,Mercer,70,68,0,2,2017-01-14
Akron,Miami (OH),74,70,0,4,2017-01-14
Nebraska,Michigan,85,91,1,-6,2017-01-14
Western Kentucky,Middle Tennessee,76,91,1,-15,2017-01-14
Wright State,Milwaukee,70,67,0,3,2017-01-14
Texas A&M,Mississippi State,59,67,1,-8,2017-01-14
North Dakota,Montana,70,76,1,-6,2017-01-14
Northern Colorado,Montana State,53,68,1,-15,2017-01-14
Tennessee State,Morehead State,85,87,1,-2,2017-01-14
Saint Francis (PA),Mount St. Mary's,72,78,1,-6,2017-01-14
Western Illinois,Omaha,72,86,1,-14,2017-01-14
Binghamton,New Hampshire,66,73,1,-7,2017-01-14
Cal State Bakersfield,New Mexico State,58,63,1,-5,2017-01-14
Monmouth,Niagara,90,83,0,7,2017-01-14
North Florida,NJIT,78,84,1,-6,2017-01-14
North Carolina Central,Norfolk State,72,57,0,15,2017-01-14
Florida State,UNC,83,96,1,-13,2017-01-14
Hofstra,UNC Wilmington,76,84,1,-8,2017-01-14
Sacramento State,Northern Arizona,74,62,0,12,2017-01-14
Sam Houston State,Northwestern State,77,68,0,9,2017-01-14
Eastern Michigan,Ohio,53,49,0,4,2017-01-14
Texas Tech,Oklahoma,75,84,1,-9,2017-01-14
Louisiana Tech,Old Dominion,75,63,0,12,2017-01-14
IUPUI,Oral Roberts,91,85,0,6,2017-01-14
Oregon State,Oregon,43,85,1,-42,2017-01-14
Minnesota,Penn State,50,52,1,-2,2017-01-14
Brown,Penn,82,70,0,12,2017-01-14
Santa Clara,Pepperdine,75,61,0,14,2017-01-14
Miami (FL),Pitt,72,46,0,26,2017-01-14
Loyola Marymount,Portland,79,78,0,1,2017-01-14
Jackson State,Prairie View,56,63,1,-7,2017-01-14
Yale,Princeton,58,66,1,-8,2017-01-14
Seton Hall,Providence,61,65,1,-4,2017-01-14
Iona,Quinnipiac,91,97,1,-6,2017-01-14
Liberty,Radford,71,64,0,7,2017-01-14
North Texas,Rice,79,101,1,-22,2017-01-14
Richmond,St. Joseph's,70,66,0,4,2017-01-14
BYU,San Diego,75,88,1,-13,2017-01-14
Utah State,San Diego State,55,74,1,-19,2017-01-14
Pacific,San Francisco,51,72,1,-21,2017-01-14
Florida A&M,Savannah State,88,93,1,-5,2017-01-14
Chicago State,Seattle,50,65,1,-15,2017-01-14
Texas State,South Alabama,67,72,1,-5,2017-01-14
Ole Miss,South Carolina,56,67,1,-11,2017-01-14
Bethune-Cookman,South Carolina State,74,78,1,-4,2017-01-14
Jacksonville,USC Upstate,66,73,1,-7,2017-01-14
Purdue-Fort Wayne,South Dakota,63,66,1,-3,2017-01-14
Arkansas-Pine Bluff,Southern,75,76,1,-1,2017-01-14
Murray State,SIU-Edwardsville,67,59,0,8,2017-01-14
Portland State,Southern Utah,88,77,0,11,2017-01-14
Fordham,St. Bonaventure,53,73,1,-20,2017-01-14
Villanova,St. John's (NY),70,57,0,13,2017-01-14
Washington,Stanford,69,76,1,-7,2017-01-14
Nicholls State,Stephen F. Austin,60,80,1,-20,2017-01-14
Boston College,Syracuse,53,76,1,-23,2017-01-14
Tulsa,Temple,70,68,0,2,2017-01-14
Southeast Missouri State,UT-Martin,69,79,1,-10,2017-01-14
Jacksonville State,Tennessee Tech,74,59,0,15,2017-01-14
West Virginia,Texas,74,72,0,2,2017-01-14
Central Arkansas,Texas A&M-Corpus Christi,81,88,1,-7,2017-01-14
Iowa State,TCU,77,84,1,-7,2017-01-14
Florida Atlantic,UTEP,65,66,1,-1,2017-01-14
Grand Canyon,Texas-Rio Grande Valley,79,66,0,13,2017-01-14
Florida International,UTSA,55,57,1,-2,2017-01-14
Grambling,Texas Southern,55,76,1,-21,2017-01-14
Northeastern,Towson,67,74,1,-7,2017-01-14
Texas-Arlington,Troy,71,93,1,-22,2017-01-14
UCLA,Utah,83,82,0,1,2017-01-14
UMKC,Utah Valley,76,86,1,-10,2017-01-14
Tennessee,Vanderbilt,87,75,0,12,2017-01-14
UNC Greensboro,VMI,91,82,0,9,2017-01-14
Notre Dame,Virginia Tech,76,71,0,5,2017-01-14
Robert Morris,Wagner,50,53,1,-3,2017-01-14
Eastern Washington,Weber State,67,70,1,-3,2017-01-14
Kent State,Western Michigan,88,92,1,-4,2017-01-14
Furman,Wofford,58,67,1,-9,2017-01-14
Nevada,Wyoming,89,74,0,15,2017-01-14
UIC,Youngstown State,92,89,0,3,2017-01-14
USC,Colorado,71,68,0,3,2017-01-15
Cincinnati,East Carolina,55,46,0,9,2017-01-15
Siena,Fairfield,63,54,0,9,2017-01-15
Rutgers,Indiana,57,76,1,-19,2017-01-15
George Washington,La Salle,69,79,1,-10,2017-01-15
Missouri State,Loyola (IL),71,77,1,-6,2017-01-15
Georgia Tech,NC State,86,76,0,10,2017-01-15
Drake,Northern Iowa,60,79,1,-19,2017-01-15
Iowa,Northwestern,54,89,1,-35,2017-01-15
Michigan State,Ohio State,67,72,1,-5,2017-01-15
UMass,Rhode Island,77,79,1,-2,2017-01-15
St. Peter's,Rider,71,65,0,6,2017-01-15
McNeese State,Southeastern Louisiana,75,79,1,-4,2017-01-15
SMU,Tulane,80,64,0,16,2017-01-15
Arkansas-Pine Bluff,Alcorn State,64,82,1,-18,2017-01-16
Harvard,Bryant,70,65,0,5,2017-01-16
Marquette,Butler,80,88,1,-8,2017-01-16
Monmouth,Canisius,76,72,0,4,2017-01-16
Norfolk State,Delaware State,75,70,0,5,2017-01-16
Youngstown State,Detroit,71,87,1,-16,2017-01-16
Bethune-Cookman,Florida A&M,82,76,0,6,2017-01-16
Providence,Georgetown,74,56,0,18,2017-01-16
North Carolina Central,Hampton,64,51,0,13,2017-01-16
Maine,Hartford,44,54,1,-10,2017-01-16
Coppin State,Howard,81,72,0,9,2017-01-16
Kansas,Iowa State,76,72,0,4,2017-01-16
Georgia State,Louisiana,101,86,0,15,2017-01-16
Georgia Southern,Louisiana-Monroe,62,60,0,2,2017-01-16
Boston University,Loyola (MD),69,77,1,-8,2017-01-16
Albany (NY),UMBC,77,50,0,27,2017-01-16
Stony Brook,UMass-Lowell,86,75,0,11,2017-01-16
North Carolina A&T,Morgan State,53,82,1,-29,2017-01-16
Vermont,New Hampshire,71,59,0,12,2017-01-16
Marist,Niagara,93,87,0,6,2017-01-16
Syracuse,UNC,68,85,1,-17,2017-01-16
Portland State,Northern Arizona,76,83,1,-7,2017-01-16
Cleveland State,Oakland,76,65,0,11,2017-01-16
Grambling,Prairie View,82,94,1,-12,2017-01-16
Texas-Arlington,South Alabama,89,83,0,6,2017-01-16
Savannah State,South Carolina State,86,82,0,4,2017-01-16
Mississippi Valley State,Southern,81,87,1,-6,2017-01-16
DePaul,St. John's (NY),68,78,1,-10,2017-01-16
Jackson State,Texas Southern,44,67,1,-23,2017-01-16
Texas State,Troy,75,71,0,4,2017-01-16
Green Bay,Valparaiso,56,80,1,-24,2017-01-16
Seton Hall,Villanova,46,76,1,-30,2017-01-16
Creighton,Xavier,72,67,0,5,2017-01-16
Ohio,Akron,68,83,1,-15,2017-01-17
Central Michigan,Ball State,83,98,1,-15,2017-01-17
Texas,Baylor,64,74,1,-10,2017-01-17
New Mexico,Boise State,81,70,0,11,2017-01-17
South Florida,UCF,64,86,1,-22,2017-01-17
Western Michigan,Eastern Michigan,80,86,1,-6,2017-01-17
Wichita State,Evansville,82,65,0,17,2017-01-17
St. Peter's,Fairfield,69,55,0,14,2017-01-17
Vanderbilt,Georgia,68,76,1,-8,2017-01-17
San Diego Christian,Grand Canyon,58,90,1,-32,2017-01-17
Milwaukee,UIC,57,71,1,-14,2017-01-17
Buffalo,Kent State,82,69,0,13,2017-01-17
Iona,Manhattan,82,67,0,15,2017-01-17
Tennessee,Ole Miss,69,80,1,-11,2017-01-17
Kentucky,Mississippi State,88,81,0,7,2017-01-17
San Diego State,UNLV,64,51,0,13,2017-01-17
Pitt,NC State,74,79,1,-5,2017-01-17
Miami (OH),Northern Illinois,58,62,1,-4,2017-01-17
Illinois,Purdue,68,91,1,-23,2017-01-17
St. Bonaventure,Saint Louis,71,52,0,19,2017-01-17
Rider,Siena,68,78,1,-10,2017-01-17
Arkansas,Texas A&M,62,60,0,2,2017-01-17
Bowling Green State,Toledo,73,85,1,-12,2017-01-17
Michigan,Wisconsin,64,68,1,-4,2017-01-17
Missouri,Alabama,56,68,1,-12,2017-01-18
Lafayette,American,57,71,1,-14,2017-01-18
Holy Cross,Army,85,76,0,9,2017-01-18
LSU,Auburn,74,78,1,-4,2017-01-18
Virginia,Boston College,71,54,0,17,2017-01-18
Colgate,Boston University,67,58,0,9,2017-01-18
Illinois State,Bradley,69,49,0,20,2017-01-18
Loyola (MD),Bucknell,63,76,1,-13,2017-01-18
UC-Irvine,Cal Poly,70,48,0,22,2017-01-18
UC-Riverside,Cal State Fullerton,71,63,0,8,2017-01-18
Roosevelt,Chicago State,57,77,1,-20,2017-01-18
Temple,Cincinnati,74,81,1,-7,2017-01-18
Southern Illinois,Drake,84,88,1,-4,2017-01-18
Notre Dame,Florida State,80,83,1,-3,2017-01-18
VCU,Fordham,67,69,1,-2,2017-01-18
Colorado State,Fresno State,57,78,1,-21,2017-01-18
Duquesne,George Washington,63,65,1,-2,2017-01-18
Cal State Northridge,Hawaii,77,80,1,-3,2017-01-18
Missouri State,Indiana State,73,68,0,5,2017-01-18
South Dakota State,IUPUI,83,85,1,-2,2017-01-18
St. Joseph's,UMass,57,62,1,-5,2017-01-18
Central Arkansas,McNeese State,72,82,1,-10,2017-01-18
Lehigh,Navy,72,75,1,-3,2017-01-18
Ohio State,Nebraska,67,66,0,1,2017-01-18
Denver,Omaha,88,97,1,-9,2017-01-18
Air Force,Nevada,76,83,1,-7,2017-01-18
Loyola (IL),Northern Iowa,69,72,1,-3,2017-01-18
Kansas State,Oklahoma State,96,88,0,8,2017-01-18
South Dakota,Oral Roberts,80,90,1,-10,2017-01-18
Indiana,Penn State,78,75,0,3,2017-01-18
Wyoming,San Jose State,80,70,0,10,2017-01-18
Florida,South Carolina,53,57,1,-4,2017-01-18
TCU,Texas Tech,69,75,1,-6,2017-01-18
Tulane,Tulsa,82,89,1,-7,2017-01-18
Georgia Tech,Virginia Tech,61,62,1,-1,2017-01-18
Miami (FL),Wake Forest,79,96,1,-17,2017-01-18
Colorado,Washington,83,85,1,-2,2017-01-18
Utah,Washington State,88,47,0,41,2017-01-18
Oklahoma,West Virginia,89,87,0,2,2017-01-18
Binghamton,Albany (NY),65,84,1,-19,2017-01-19
Morehead State,Austin Peay,89,82,0,7,2017-01-19
Jacksonville State,Belmont,60,77,1,-17,2017-01-19
Pepperdine,BYU,70,99,1,-29,2017-01-19
High Point,Campbell,83,78,0,5,2017-01-19
UNC Wilmington,College of Charleston,65,59,0,6,2017-01-19
Richmond,Dayton,59,75,1,-16,2017-01-19
Northeastern,Delaware,62,69,1,-7,2017-01-19
Northern Arizona,Eastern Washington,62,84,1,-22,2017-01-19
Drexel,Elon,73,93,1,-20,2017-01-19
St. Francis (NY),Fairleigh Dickinson,40,57,1,-17,2017-01-19
Alabama-Birmingham,Florida Atlantic,80,78,0,2,2017-01-19
USC Upstate,Florida Gulf Coast,62,60,0,2,2017-01-19
Middle Tennessee,Florida International,65,52,0,13,2017-01-19
ETSU,Furman,62,75,1,-13,2017-01-19
Towson,Hofstra,86,80,0,6,2017-01-19
Memphis,Houston,70,67,0,3,2017-01-19
Southern Utah,Idaho,67,79,1,-12,2017-01-19
Maryland,Iowa,84,76,0,8,2017-01-19
Lipscomb,Jacksonville,112,95,0,17,2017-01-19
Davidson,La Salle,83,91,1,-8,2017-01-19
Gardner-Webb,Liberty,62,65,1,-3,2017-01-19
UCSB,Long Beach State,76,81,1,-5,2017-01-19
Wagner,LIU-Brooklyn,69,76,1,-7,2017-01-19
Radford,Longwood,72,60,0,12,2017-01-19
Rice,Louisiana Tech,64,74,1,-10,2017-01-19
Clemson,Louisville,60,92,1,-32,2017-01-19
San Diego,Loyola Marymount,69,62,0,7,2017-01-19
New Hampshire,Maine,74,63,0,11,2017-01-19
Eastern Kentucky,Murray State,79,86,1,-7,2017-01-19
Houston Baptist,New Orleans,64,72,1,-8,2017-01-19
Abilene Christian,Nicholls State,59,62,1,-3,2017-01-19
Mercer,UNC Greensboro,66,68,1,-2,2017-01-19
Weber State,North Dakota,77,83,1,-6,2017-01-19
Purdue-Fort Wayne,North Dakota State,83,89,1,-6,2017-01-19
Kennesaw State,North Florida,84,86,1,-2,2017-01-19
Idaho State,Northern Colorado,73,69,0,4,2017-01-19
California,Oregon,63,86,1,-23,2017-01-19
Stanford,Oregon State,62,46,0,16,2017-01-19
Montana,Portland State,79,88,1,-9,2017-01-19
Charleston Southern,Presbyterian,73,52,0,21,2017-01-19
Central Connecticut,Robert Morris,67,74,1,-7,2017-01-19
Montana State,Sacramento State,74,65,0,9,2017-01-19
Mount St. Mary's,Sacred Heart,86,75,0,11,2017-01-19
Bryant,Saint Francis (PA),61,75,1,-14,2017-01-19
Pacific,Saint Mary's,50,62,1,-12,2017-01-19
Siena,St. Peter's,65,77,1,-12,2017-01-19
Lamar,Sam Houston State,65,87,1,-22,2017-01-19
Portland,San Francisco,50,75,1,-25,2017-01-19
Gonzaga,Santa Clara,88,57,0,31,2017-01-19
SIU-Edwardsville,Southeast Missouri State,76,79,1,-3,2017-01-19
Arizona,USC,73,66,0,7,2017-01-19
UConn,SMU,49,69,1,-20,2017-01-19
North Texas,Southern Miss,65,75,1,-10,2017-01-19
NJIT,Stetson,76,82,1,-6,2017-01-19
Hartford,Stony Brook,64,80,1,-16,2017-01-19
Eastern Illinois,UT-Martin,71,82,1,-11,2017-01-19
Tennessee Tech,Tennessee State,80,74,0,6,2017-01-19
Stephen F. Austin,Texas A&M-Corpus Christi,61,58,0,3,2017-01-19
Arizona State,UCLA,80,102,1,-22,2017-01-19
UMass-Lowell,Vermont,67,81,1,-14,2017-01-19
Citadel,Western Carolina,95,100,1,-5,2017-01-19
James Madison,William & Mary,72,73,1,-1,2017-01-19
UNC Asheville,Winthrop,73,76,1,-3,2017-01-19
VMI,Wofford,70,88,1,-18,2017-01-19
Eastern Michigan,Akron,63,70,1,-7,2017-01-20
Yale,Brown,75,74,0,1,2017-01-20
Youngstown State,Green Bay,92,89,0,3,2017-01-20
Fairfield,Iona,89,96,1,-7,2017-01-20
Cleveland State,Milwaukee,62,63,1,-1,2017-01-20
Manhattan,Monmouth,71,82,1,-11,2017-01-20
Oakland,Northern Kentucky,79,70,0,9,2017-01-20
Canisius,Quinnipiac,90,95,1,-5,2017-01-20
Detroit,Wright State,88,106,1,-18,2017-01-20
Southern,Alabama A&M,53,52,0,1,2017-01-21
Alcorn State,Alabama State,78,71,0,7,2017-01-21
LSU,Arkansas,86,99,1,-13,2017-01-21
South Alabama,Little Rock,56,73,1,-17,2017-01-21
Texas Southern,Arkansas-Pine Bluff,70,63,0,7,2017-01-21
Troy,Arkansas State,80,82,1,-2,2017-01-21
Navy,Army,96,80,0,16,2017-01-21
Alabama,Auburn,64,84,1,-20,2017-01-21
Murray State,Austin Peay,81,84,1,-3,2017-01-21
Tennessee Tech,Belmont,70,82,1,-12,2017-01-21
Maryland-Eastern Shore,Bethune-Cookman,82,79,0,3,2017-01-21
UNC,Boston College,90,82,0,8,2017-01-21
Ball State,Bowling Green State,74,79,1,-5,2017-01-21
Boston University,Bucknell,59,70,1,-11,2017-01-21
Western Michigan,Buffalo,54,66,1,-12,2017-01-21
Long Beach State,Cal Poly,98,92,0,6,2017-01-21
Utah Valley,Cal State Bakersfield,65,68,1,-3,2017-01-21
UC-Irvine,Cal State Northridge,105,73,0,32,2017-01-21
UCSB,UC-Riverside,55,65,1,-10,2017-01-21
New Orleans,Central Arkansas,81,63,0,18,2017-01-21
Miami (OH),Central Michigan,92,101,1,-9,2017-01-21
Longwood,Charleston Southern,61,76,1,-15,2017-01-21
Old Dominion,Charlotte,72,74,1,-2,2017-01-21
Samford,Chattanooga,78,82,1,-4,2017-01-21
Loyola (MD),Colgate,49,52,1,-3,2017-01-21
James Madison,College of Charleston,60,73,1,-13,2017-01-21
Cornell,Columbia,67,62,0,5,2017-01-21
Marquette,Creighton,102,94,0,8,2017-01-21
Towson,Delaware,75,58,0,17,2017-01-21
Butler,DePaul,70,69,0,1,2017-01-21
Miami (FL),Duke,58,70,1,-12,2017-01-21
Rhode Island,Duquesne,90,69,0,21,2017-01-21
Southern Utah,Eastern Washington,68,83,1,-15,2017-01-21
William & Mary,Elon,62,71,1,-9,2017-01-21
LIU-Brooklyn,Fairleigh Dickinson,66,83,1,-17,2017-01-21
Vanderbilt,Florida,68,66,0,2,2017-01-21
Middle Tennessee,Florida Atlantic,86,57,0,29,2017-01-21
NJIT,Florida Gulf Coast,71,84,1,-13,2017-01-21
Alabama-Birmingham,Florida International,85,94,1,-9,2017-01-21
Louisville,Florida State,68,73,1,-5,2017-01-21
VMI,Furman,72,89,1,-17,2017-01-21
Presbyterian,Gardner-Webb,61,78,1,-17,2017-01-21
Appalachian State,Georgia Southern,88,92,1,-4,2017-01-21
Coastal Carolina,Georgia State,56,76,1,-20,2017-01-21
Portland,Gonzaga,52,73,1,-21,2017-01-21
Jackson State,Grambling,57,72,1,-15,2017-01-21
Seattle,Grand Canyon,59,61,1,-2,2017-01-21
Dartmouth,Harvard,68,82,1,-14,2017-01-21
UC-Davis,Hawaii,76,70,0,6,2017-01-21
Northeastern,Hofstra,73,78,1,-5,2017-01-21
Northern Arizona,Idaho,49,65,1,-16,2017-01-21
Drake,Illinois State,58,72,1,-14,2017-01-21
Stephen F. Austin,Incarnate Word,68,70,1,-2,2017-01-21
Michigan State,Indiana,75,82,1,-7,2017-01-21
Denver,IUPUI,78,74,0,4,2017-01-21
Kennesaw State,Jacksonville,81,71,0,10,2017-01-21
Texas,Kansas,67,79,1,-12,2017-01-21
West Virginia,Kansas State,75,79,1,-4,2017-01-21
Toledo,Kent State,61,85,1,-24,2017-01-21
South Carolina,Kentucky,69,85,1,-16,2017-01-21
Lafayette,Lehigh,68,75,1,-7,2017-01-21
Winthrop,Liberty,61,48,0,13,2017-01-21
North Texas,Louisiana Tech,57,81,1,-24,2017-01-21
Evansville,Loyola (IL),61,67,1,-6,2017-01-21
Western Kentucky,Marshall,80,94,1,-14,2017-01-21
Fordham,UMass,71,68,0,3,2017-01-21
Northwestern State,McNeese State,78,65,0,13,2017-01-21
Illinois,Michigan,57,66,1,-9,2017-01-21
Wisconsin,Minnesota,78,76,0,2,2017-01-21
Prairie View,Mississippi Valley State,87,72,0,15,2017-01-21
Ole Miss,Missouri,75,71,0,4,2017-01-21
Bradley,Missouri State,62,76,1,-14,2017-01-21
Eastern Kentucky,Morehead State,54,80,1,-26,2017-01-21
Fresno State,Nevada,81,76,0,5,2017-01-21
Air Force,UNLV,85,87,1,-2,2017-01-21
Wyoming,New Mexico,71,78,1,-7,2017-01-21
UMKC,New Mexico State,71,94,1,-23,2017-01-21
Lamar,Nicholls State,87,76,0,11,2017-01-21
Hampton,Norfolk State,62,79,1,-17,2017-01-21
Campbell,UNC Asheville,56,72,1,-16,2017-01-21
Howard,North Carolina A&T,78,63,0,15,2017-01-21
Citadel,UNC Greensboro,72,81,1,-9,2017-01-21
Wake Forest,NC State,93,88,0,5,2017-01-21
Drexel,UNC Wilmington,74,87,1,-13,2017-01-21
Idaho State,North Dakota,64,89,1,-25,2017-01-21
Lipscomb,North Florida,84,90,1,-6,2017-01-21
Weber State,Northern Colorado,74,69,0,5,2017-01-21
Ohio,Northern Illinois,78,69,0,9,2017-01-21
Syracuse,Notre Dame,66,84,1,-18,2017-01-21
Iowa State,Oklahoma,92,87,0,5,2017-01-21
Omaha,Oral Roberts,86,103,1,-17,2017-01-21
Stanford,Oregon,52,69,1,-17,2017-01-21
California,Oregon State,69,58,0,11,2017-01-21
BYU,Pacific,62,47,0,15,2017-01-21
Montana State,Portland State,71,65,0,6,2017-01-21
Penn State,Purdue,52,77,1,-25,2017-01-21
High Point,Radford,61,58,0,3,2017-01-21
Marist,Rider,66,84,1,-18,2017-01-21
Bryant,Robert Morris,59,56,0,3,2017-01-21
Nebraska,Rutgers,64,65,1,-1,2017-01-21
Montana,Sacramento State,83,92,1,-9,2017-01-21
Wagner,Sacred Heart,67,62,0,5,2017-01-21
Central Connecticut,Saint Francis (PA),84,83,0,1,2017-01-21
Penn,St. Joseph's,71,78,1,-7,2017-01-21
Pepperdine,Saint Mary's,65,85,1,-20,2017-01-21
Niagara,St. Peter's,57,55,0,2,2017-01-21
Texas A&M-Corpus Christi,Sam Houston State,62,76,1,-14,2017-01-21
San Francisco,San Diego,60,43,0,17,2017-01-21
Boise State,San Jose State,75,65,0,10,2017-01-21
Loyola Marymount,Santa Clara,63,64,1,-1,2017-01-21
Morgan State,Savannah State,61,74,1,-13,2017-01-21
Delaware State,South Carolina State,64,74,1,-10,2017-01-21
Purdue-Fort Wayne,South Dakota State,67,77,1,-10,2017-01-21
Tulsa,South Florida,79,67,0,12,2017-01-21
Eastern Illinois,Southeast Missouri State,71,83,1,-12,2017-01-21
Houston Baptist,Southeastern Louisiana,71,83,1,-12,2017-01-21
Northern Iowa,Southern Illinois,58,57,0,1,2017-01-21
Houston,SMU,64,85,1,-21,2017-01-21
Rice,Southern Miss,61,58,0,3,2017-01-21
Mount St. Mary's,St. Francis (NY),55,47,0,8,2017-01-21
USC Upstate,Stetson,97,86,0,11,2017-01-21
Mississippi State,Tennessee,74,91,1,-17,2017-01-21
SIU-Edwardsville,UT-Martin,67,75,1,-8,2017-01-21
Jacksonville State,Tennessee State,86,79,0,7,2017-01-21
Georgia,Texas A&M,62,63,1,-1,2017-01-21
Louisiana-Monroe,Texas-Arlington,55,71,1,-16,2017-01-21
Baylor,TCU,62,53,0,9,2017-01-21
UTSA,UTEP,39,59,1,-20,2017-01-21
Chicago State,Texas-Rio Grande Valley,77,85,1,-8,2017-01-21
Louisiana,Texas State,79,73,0,6,2017-01-21
Oklahoma State,Texas Tech,83,64,0,19,2017-01-21
Cincinnati,Tulane,78,61,0,17,2017-01-21
Arizona,UCLA,96,85,0,11,2017-01-21
Colorado State,Utah State,64,56,0,8,2017-01-21
Providence,Villanova,68,78,1,-10,2017-01-21
Georgia Tech,Virginia,49,62,1,-13,2017-01-21
Utah,Washington,94,72,0,22,2017-01-21
Colorado,Washington State,89,91,1,-2,2017-01-21
Mercer,Western Carolina,70,50,0,20,2017-01-21
North Dakota State,Western Illinois,89,57,0,32,2017-01-21
Indiana State,Wichita State,58,84,1,-26,2017-01-21
Maine,Albany (NY),63,81,1,-18,2017-01-22
Stony Brook,Binghamton,67,71,1,-4,2017-01-22
Virginia Tech,Clemson,82,81,0,1,2017-01-22
East Carolina,UConn,65,72,1,-7,2017-01-22
Saint Louis,Dayton,46,67,1,-21,2017-01-22
Wofford,ETSU,72,79,1,-7,2017-01-22
New Hampshire,Hartford,81,56,0,25,2017-01-22
Siena,Manhattan,81,68,0,13,2017-01-22
UMBC,UMass-Lowell,102,86,0,16,2017-01-22
UCF,Memphis,65,70,1,-5,2017-01-22
Youngstown State,Milwaukee,85,94,1,-9,2017-01-22
Fairfield,Monmouth,49,91,1,-42,2017-01-22
Detroit,Northern Kentucky,87,101,1,-14,2017-01-22
Northwestern,Ohio State,74,72,0,2,2017-01-22
George Mason,Richmond,82,77,0,5,2017-01-22
St. John's (NY),Seton Hall,73,86,1,-13,2017-01-22
Arizona State,USC,79,82,1,-3,2017-01-22
UIC,Valparaiso,65,96,1,-31,2017-01-22
La Salle,VCU,52,90,1,-38,2017-01-22
Oakland,Wright State,67,88,1,-21,2017-01-22
Georgetown,Xavier,75,86,1,-11,2017-01-22
Alcorn State,Alabama A&M,81,70,0,11,2017-01-23
Southern,Alabama State,65,79,1,-14,2017-01-23
Troy,Little Rock,78,69,0,9,2017-01-23
Prairie View,Arkansas-Pine Bluff,68,71,1,-3,2017-01-23
South Alabama,Arkansas State,62,74,1,-12,2017-01-23
Norfolk State,Coppin State,74,64,0,10,2017-01-23
NC State,Duke,84,82,0,2,2017-01-23
Maryland-Eastern Shore,Florida A&M,86,79,0,7,2017-01-23
Coastal Carolina,Georgia Southern,80,91,1,-11,2017-01-23
Appalachian State,Georgia State,72,83,1,-11,2017-01-23
Cleveland State,Green Bay,73,83,1,-10,2017-01-23
American,Holy Cross,55,63,1,-8,2017-01-23
Quinnipiac,Iona,74,84,1,-10,2017-01-23
Texas Southern,Mississippi Valley State,89,103,1,-14,2017-01-23
Canisius,Niagara,84,91,1,-7,2017-01-23
Howard,North Carolina Central,39,74,1,-35,2017-01-23
TCU,Oklahoma State,76,89,1,-13,2017-01-23
Gonzaga,Portland,83,64,0,19,2017-01-23
Rider,St. Peter's,51,56,1,-5,2017-01-23
Delaware State,Savannah State,79,94,1,-15,2017-01-23
Morgan State,South Carolina State,77,75,0,2,2017-01-23
Oklahoma,Texas,83,84,1,-1,2017-01-23
Louisiana,Texas-Arlington,71,108,1,-37,2017-01-23
Louisiana-Monroe,Texas State,57,63,1,-6,2017-01-23
San Diego State,Air Force,57,60,1,-3,2017-01-24
Bowling Green State,Central Michigan,76,82,1,-6,2017-01-24
Duquesne,Davidson,60,74,1,-14,2017-01-24
Ball State,Eastern Michigan,88,80,0,8,2017-01-24
Tulane,Houston,51,65,1,-14,2017-01-24
Kansas State,Iowa State,65,70,1,-5,2017-01-24
Villanova,Marquette,72,74,1,-2,2017-01-24
Rutgers,Maryland,55,67,1,-12,2017-01-24
Buffalo,Miami (OH),74,75,1,-1,2017-01-24
Purdue,Michigan State,84,73,0,11,2017-01-24
Drake,Missouri State,72,71,0,1,2017-01-24
Utah State,New Mexico,61,74,1,-13,2017-01-24
Kent State,Northern Illinois,73,66,0,7,2017-01-24
Virginia,Notre Dame,71,54,0,17,2017-01-24
Toledo,Ohio,79,76,0,3,2017-01-24
Louisville,Pitt,106,51,0,55,2017-01-24
Auburn,South Carolina,69,98,1,-29,2017-01-24
St. Joseph's,St. Bonaventure,63,67,1,-4,2017-01-24
Wake Forest,Syracuse,76,81,1,-5,2017-01-24
Kentucky,Tennessee,80,82,1,-2,2017-01-24
Arkansas,Vanderbilt,71,70,0,1,2017-01-24
Kansas,West Virginia,69,85,1,-16,2017-01-24
Akron,Western Michigan,90,80,0,10,2017-01-24
Southern Illinois,Wichita State,45,87,1,-42,2017-01-24
Penn State,Wisconsin,55,82,1,-27,2017-01-24
Vermont,Albany (NY),60,49,0,11,2017-01-25
Navy,American,71,53,0,18,2017-01-25
Washington,Arizona State,75,86,1,-11,2017-01-25
Texas Tech,Baylor,61,65,1,-4,2017-01-25
Hartford,Binghamton,55,76,1,-21,2017-01-25
Nevada,Boise State,76,57,0,19,2017-01-25
Army,Boston University,89,90,1,-1,2017-01-25
Cal State Northridge,UCSB,78,57,0,21,2017-01-25
Bryant,Central Connecticut,65,54,0,11,2017-01-25
SMU,UCF,65,60,0,5,2017-01-25
VMI,Chattanooga,80,64,0,16,2017-01-25
Lehigh,Colgate,76,62,0,14,2017-01-25
San Jose State,Colorado State,72,81,1,-9,2017-01-25
South Dakota State,Denver,82,91,1,-9,2017-01-25
Tulsa,East Carolina,66,69,1,-3,2017-01-25
Belmont,Eastern Illinois,77,64,0,13,2017-01-25
Western Carolina,Furman,37,85,1,-48,2017-01-25
George Washington,George Mason,87,68,0,19,2017-01-25
Creighton,Georgetown,51,71,1,-20,2017-01-25
Alabama,Georgia,80,60,0,20,2017-01-25
Florida State,Georgia Tech,56,78,1,-22,2017-01-25
South Carolina State,Hampton,68,66,0,2,2017-01-25
UC-Riverside,Hawaii,70,64,0,6,2017-01-25
Weber State,Idaho State,85,73,0,12,2017-01-25
Iowa,Illinois,64,76,1,-12,2017-01-25
Indiana State,Illinois State,66,71,1,-5,2017-01-25
IUPUI,Purdue-Fort Wayne,73,103,1,-30,2017-01-25
Stetson,Jacksonville,92,103,1,-11,2017-01-25
NJIT,Kennesaw State,65,71,1,-6,2017-01-25
Penn,La Salle,77,74,0,3,2017-01-25
Bucknell,Lafayette,78,55,0,23,2017-01-25
Texas A&M-Corpus Christi,Lamar,69,66,0,3,2017-01-25
USC Upstate,Lipscomb,77,84,1,-7,2017-01-25
Florida,LSU,106,71,0,35,2017-01-25
Bradley,Loyola (IL),50,70,1,-20,2017-01-25
Holy Cross,Loyola (MD),62,65,1,-3,2017-01-25
Boston College,Miami (FL),77,78,1,-1,2017-01-25
Texas A&M,Ole Miss,80,76,0,4,2017-01-25
Missouri,Mississippi State,74,89,1,-15,2017-01-25
UMass-Lowell,New Hampshire,71,80,1,-9,2017-01-25
Oral Roberts,North Dakota State,71,81,1,-10,2017-01-25
Florida Gulf Coast,North Florida,86,82,0,4,2017-01-25
Evansville,Northern Iowa,54,61,1,-7,2017-01-25
Minnesota,Ohio State,72,78,1,-6,2017-01-25
St. John's (NY),Providence,91,86,0,5,2017-01-25
Rhode Island,Richmond,62,73,1,-11,2017-01-25
UMass,Saint Louis,70,74,1,-4,2017-01-25
ETSU,Samford,96,86,0,10,2017-01-25
Butler,Seton Hall,61,54,0,7,2017-01-25
Western Illinois,South Dakota,55,62,1,-7,2017-01-25
UConn,South Florida,81,60,0,21,2017-01-25
Northwestern State,Southeastern Louisiana,85,71,0,14,2017-01-25
UCLA,USC,76,84,1,-8,2017-01-25
Tennessee State,SIU-Edwardsville,76,56,0,20,2017-01-25
Central Arkansas,Stephen F. Austin,76,78,1,-2,2017-01-25
UMBC,Stony Brook,73,83,1,-10,2017-01-25
Memphis,Temple,66,77,1,-11,2017-01-25
UNC Greensboro,Wofford,74,93,1,-19,2017-01-25
UNLV,Wyoming,65,66,1,-1,2017-01-25
Louisiana Tech,Alabama-Birmingham,70,79,1,-9,2017-01-26
Washington State,Arizona,62,79,1,-17,2017-01-26
UT-Martin,Austin Peay,85,79,0,6,2017-01-26
Cal Poly,UC-Irvine,79,66,0,13,2017-01-26
Cal State Bakersfield,Chicago State,75,59,0,16,2017-01-26
Xavier,Cincinnati,78,86,1,-8,2017-01-26
Oregon State,Colorado,78,85,1,-7,2017-01-26
Hofstra,Drexel,80,81,1,-1,2017-01-26
Florida Atlantic,Florida International,83,65,0,18,2017-01-26
Winthrop,Gardner-Webb,72,70,0,2,2017-01-26
San Diego,Gonzaga,43,79,1,-36,2017-01-26
Charleston Southern,High Point,69,72,1,-3,2017-01-26
Nicholls State,Houston Baptist,80,83,1,-3,2017-01-26
Abilene Christian,Incarnate Word,79,82,1,-3,2017-01-26
Eastern Kentucky,Jacksonville State,57,52,0,5,2017-01-26
UNC Wilmington,James Madison,87,76,0,11,2017-01-26
Cal State Fullerton,Long Beach State,65,76,1,-11,2017-01-26
Liberty,Longwood,93,62,0,31,2017-01-26
Pacific,Loyola Marymount,73,79,1,-6,2017-01-26
St. Peter's,Marist,81,65,0,16,2017-01-26
UTSA,Marshall,71,92,1,-21,2017-01-26
Indiana,Michigan,60,90,1,-30,2017-01-26
Southern Miss,Middle Tennessee,56,72,1,-16,2017-01-26
Grand Canyon,UMKC,77,83,1,-6,2017-01-26
Eastern Washington,Montana,72,60,0,12,2017-01-26
Idaho,Montana State,91,94,1,-3,2017-01-26
Robert Morris,Mount St. Mary's,47,48,1,-1,2017-01-26
Southeast Missouri State,Murray State,75,74,0,1,2017-01-26
McNeese State,New Orleans,56,75,1,-19,2017-01-26
Manhattan,Niagara,70,69,0,1,2017-01-26
Virginia Tech,UNC,72,91,1,-19,2017-01-26
Charlotte,North Texas,82,81,0,1,2017-01-26
Elon,Northeastern,51,49,0,2,2017-01-26
Northern Colorado,Northern Arizona,50,63,1,-13,2017-01-26
Nebraska,Northwestern,61,73,1,-12,2017-01-26
Portland,Pepperdine,60,78,1,-18,2017-01-26
UNC Asheville,Presbyterian,73,47,0,26,2017-01-26
Campbell,Radford,78,61,0,17,2017-01-26
Old Dominion,Rice,80,72,0,8,2017-01-26
LIU-Brooklyn,Sacred Heart,60,57,0,3,2017-01-26
San Francisco,Saint Mary's,46,66,1,-20,2017-01-26
BYU,Santa Clara,68,76,1,-8,2017-01-26
New Mexico State,Seattle,71,56,0,15,2017-01-26
North Dakota,Southern Utah,91,89,0,2,2017-01-26
Fairleigh Dickinson,St. Francis (NY),79,73,0,6,2017-01-26
Morehead State,Tennessee Tech,73,76,1,-3,2017-01-26
College of Charleston,Towson,77,83,1,-6,2017-01-26
Oregon,Utah,73,67,0,6,2017-01-26
Texas-Rio Grande Valley,Utah Valley,81,92,1,-11,2017-01-26
Saint Francis (PA),Wagner,72,67,0,5,2017-01-26
UTEP,Western Kentucky,62,65,1,-3,2017-01-26
Delaware,William & Mary,58,82,1,-24,2017-01-26
Dartmouth,Columbia,54,66,1,-12,2017-01-27
Harvard,Cornell,77,71,0,6,2017-01-27
Milwaukee,Detroit,73,69,0,4,2017-01-27
Northern Kentucky,UIC,79,62,0,17,2017-01-27
Quinnipiac,Monmouth,76,95,1,-19,2017-01-27
Green Bay,Oakland,80,72,0,8,2017-01-27
Iona,Siena,77,66,0,11,2017-01-27
Wright State,Valparaiso,55,70,1,-15,2017-01-27
Dayton,VCU,68,73,1,-5,2017-01-27
Idaho State,Weber State,74,96,1,-22,2017-01-27
Brown,Yale,75,85,1,-10,2017-01-27
Buffalo,Akron,90,91,1,-1,2017-01-28
Mississippi State,Alabama,62,71,1,-9,2017-01-28
Southern Miss,Alabama-Birmingham,43,87,1,-44,2017-01-28
Southern,Alcorn State,64,74,1,-10,2017-01-28
Texas-Arlington,Appalachian State,83,67,0,16,2017-01-28
Bucknell,Army,96,75,0,21,2017-01-28
Southeast Missouri State,Austin Peay,82,71,0,11,2017-01-28
Western Michigan,Ball State,78,84,1,-6,2017-01-28
Ohio,Bowling Green State,96,72,0,24,2017-01-28
Loyola Marymount,BYU,77,85,1,-8,2017-01-28
Fairleigh Dickinson,Bryant,72,73,1,-1,2017-01-28
Georgetown,Butler,85,81,0,4,2017-01-28
Cal Poly,Cal State Fullerton,71,81,1,-10,2017-01-28
UC-Irvine,UC-Davis,65,74,1,-9,2017-01-28
Cal State Northridge,UC-Riverside,63,59,0,4,2017-01-28
Liberty,Campbell,72,40,0,32,2017-01-28
Manhattan,Canisius,64,78,1,-14,2017-01-28
Incarnate Word,Central Arkansas,81,80,0,1,2017-01-28
LIU-Brooklyn,Central Connecticut,52,61,1,-9,2017-01-28
Gardner-Webb,Charleston Southern,85,76,0,9,2017-01-28
Grand Canyon,Chicago State,85,77,0,8,2017-01-28
Texas State,Coastal Carolina,52,50,0,2,2017-01-28
Oregon,Colorado,65,74,1,-9,2017-01-28
Harvard,Columbia,62,65,1,-3,2017-01-28
Tulane,UConn,68,78,1,-10,2017-01-28
Morgan State,Coppin State,76,74,0,2,2017-01-28
Dartmouth,Cornell,62,75,1,-13,2017-01-28
DePaul,Creighton,66,83,1,-17,2017-01-28
James Madison,Delaware,61,66,1,-5,2017-01-28
Florida A&M,Delaware State,81,68,0,13,2017-01-28
Northern Iowa,Drake,71,63,0,8,2017-01-28
College of Charleston,Drexel,90,76,0,14,2017-01-28
Chattanooga,ETSU,71,76,1,-5,2017-01-28
SIU-Edwardsville,Eastern Illinois,60,75,1,-15,2017-01-28
Marist,Fairfield,62,72,1,-10,2017-01-28
Jacksonville,Florida Gulf Coast,56,78,1,-22,2017-01-28
Davidson,Fordham,84,66,0,18,2017-01-28
Saint Louis,George Washington,55,63,1,-8,2017-01-28
Texas,Georgia,57,59,1,-2,2017-01-28
Notre Dame,Georgia Tech,60,62,1,-2,2017-01-28
Arkansas-Pine Bluff,Grambling,53,61,1,-8,2017-01-28
Albany (NY),Hartford,74,61,0,13,2017-01-28
UCSB,Hawaii,56,78,1,-22,2017-01-28
Elon,Hofstra,84,70,0,14,2017-01-28
Temple,Houston,66,79,1,-13,2017-01-28
Savannah State,Howard,73,70,0,3,2017-01-28
Loyola (IL),Indiana State,81,66,0,15,2017-01-28
Ohio State,Iowa,72,85,1,-13,2017-01-28
Mississippi Valley State,Jackson State,68,83,1,-15,2017-01-28
Morehead State,Jacksonville State,72,69,0,3,2017-01-28
Central Michigan,Kent State,105,98,0,7,2017-01-28
Kansas,Kentucky,79,73,0,6,2017-01-28
Loyola (MD),Lafayette,70,62,0,8,2017-01-28
Northwestern State,Lamar,64,85,1,-21,2017-01-28
Little Rock,Louisiana,82,88,1,-6,2017-01-28
Arkansas State,Louisiana-Monroe,73,63,0,10,2017-01-28
Providence,Marquette,79,78,0,1,2017-01-28
UTEP,Marshall,91,68,0,23,2017-01-28
New Hampshire,UMBC,103,105,1,-2,2017-01-28
South Carolina State,Maryland-Eastern Shore,69,92,1,-23,2017-01-28
George Mason,UMass,76,74,0,2,2017-01-28
Fisher College,UMass-Lowell,73,97,1,-24,2017-01-28
East Carolina,Memphis,50,57,1,-7,2017-01-28
Citadel,Mercer,66,82,1,-16,2017-01-28
UNC,Miami (FL),62,77,1,-15,2017-01-28
Eastern Michigan,Miami (OH),74,57,0,17,2017-01-28
Louisiana Tech,Middle Tennessee,61,71,1,-10,2017-01-28
Maryland,Minnesota,85,78,0,7,2017-01-28
Baylor,Ole Miss,78,75,0,3,2017-01-28
South Carolina,Missouri,63,53,0,10,2017-01-28
Cal State Bakersfield,UMKC,74,63,0,11,2017-01-28
Idaho,Montana,85,77,0,8,2017-01-28
Eastern Washington,Montana State,90,91,1,-1,2017-01-28
Sacred Heart,Mount St. Mary's,53,67,1,-14,2017-01-28
UT-Martin,Murray State,86,94,1,-8,2017-01-28
Holy Cross,Navy,47,60,1,-13,2017-01-28
South Dakota State,Omaha,88,84,0,4,2017-01-28
New Mexico,Nevada,65,82,1,-17,2017-01-28
Rider,Niagara,67,80,1,-13,2017-01-28
McNeese State,Nicholls State,74,78,1,-4,2017-01-28
Lipscomb,NJIT,66,62,0,4,2017-01-28
Bethune-Cookman,Norfolk State,66,73,1,-7,2017-01-28
Radford,UNC Asheville,69,80,1,-11,2017-01-28
North Carolina A&T,North Carolina Central,59,82,1,-23,2017-01-28
Furman,UNC Greensboro,73,67,0,6,2017-01-28
Old Dominion,North Texas,73,67,0,6,2017-01-28
Towson,Northeastern,62,69,1,-7,2017-01-28
North Dakota,Northern Arizona,67,68,1,-1,2017-01-28
Florida,Oklahoma,84,52,0,32,2017-01-28
Arkansas,Oklahoma State,71,99,1,-28,2017-01-28
Purdue-Fort Wayne,Oral Roberts,87,83,0,4,2017-01-28
San Francisco,Pacific,81,60,0,21,2017-01-28
Illinois,Penn State,67,71,1,-4,2017-01-28
Gonzaga,Pepperdine,96,49,0,47,2017-01-28
Clemson,Pitt,67,60,0,7,2017-01-28
San Diego,Portland,68,52,0,16,2017-01-28
Alabama A&M,Prairie View,65,70,1,-5,2017-01-28
Longwood,Presbyterian,62,71,1,-9,2017-01-28
St. Bonaventure,Rhode Island,59,71,1,-12,2017-01-28
Charlotte,Rice,67,84,1,-17,2017-01-28
Duquesne,Richmond,90,101,1,-11,2017-01-28
Wisconsin,Rutgers,61,54,0,7,2017-01-28
Portland State,Sacramento State,77,80,1,-3,2017-01-28
Robert Morris,Saint Francis (PA),83,89,1,-6,2017-01-28
La Salle,St. Joseph's,72,73,1,-1,2017-01-28
Southeastern Louisiana,Sam Houston State,69,71,1,-2,2017-01-28
Colorado State,San Diego State,78,77,0,1,2017-01-28
UNLV,San Jose State,72,76,1,-4,2017-01-28
Saint Mary's,Santa Clara,72,59,0,13,2017-01-28
Texas-Rio Grande Valley,Seattle,84,96,1,-12,2017-01-28
Georgia Southern,South Alabama,66,78,1,-12,2017-01-28
Kennesaw State,USC Upstate,73,79,1,-6,2017-01-28
Denver,South Dakota,83,88,1,-5,2017-01-28
Missouri State,Southern Illinois,84,85,1,-1,2017-01-28
Northern Colorado,Southern Utah,89,71,0,18,2017-01-28
New Orleans,Stephen F. Austin,61,71,1,-10,2017-01-28
North Florida,Stetson,74,88,1,-14,2017-01-28
Vermont,Stony Brook,71,64,0,7,2017-01-28
Florida State,Syracuse,72,82,1,-10,2017-01-28
Kansas State,Tennessee,58,70,1,-12,2017-01-28
Belmont,Tennessee State,93,76,0,17,2017-01-28
Eastern Kentucky,Tennessee Tech,79,66,0,13,2017-01-28
Abilene Christian,Texas A&M-Corpus Christi,60,72,1,-12,2017-01-28
Auburn,TCU,88,80,0,8,2017-01-28
Alabama State,Texas Southern,68,70,1,-2,2017-01-28
LSU,Texas Tech,64,77,1,-13,2017-01-28
Northern Illinois,Toledo,74,72,0,2,2017-01-28
Georgia State,Troy,78,72,0,6,2017-01-28
UCF,Tulsa,66,77,1,-11,2017-01-28
Oregon State,Utah,78,86,1,-8,2017-01-28
Fresno State,Utah State,65,78,1,-13,2017-01-28
New Mexico State,Utah Valley,74,69,0,5,2017-01-28
Iowa State,Vanderbilt,78,84,1,-6,2017-01-28
Samford,VMI,69,67,0,2,2017-01-28
St. Francis (NY),Wagner,64,66,1,-2,2017-01-28
Duke,Wake Forest,85,83,0,2,2017-01-28
Texas A&M,West Virginia,77,81,1,-4,2017-01-28
Wofford,Western Carolina,62,68,1,-6,2017-01-28
IUPUI,Western Illinois,69,78,1,-9,2017-01-28
UTSA,Western Kentucky,66,81,1,-15,2017-01-28
UNC Wilmington,William & Mary,78,96,1,-18,2017-01-28
High Point,Winthrop,83,80,0,3,2017-01-28
Boise State,Wyoming,80,65,0,15,2017-01-28
Cleveland State,Youngstown State,64,67,1,-3,2017-01-28
Colgate,American,70,65,0,5,2017-01-29
Washington,Arizona,66,77,1,-11,2017-01-29
Washington State,Arizona State,91,83,0,8,2017-01-29
Wichita State,Bradley,64,49,0,15,2017-01-29
Stanford,California,55,66,1,-11,2017-01-29
South Florida,Cincinnati,53,94,1,-41,2017-01-29
Green Bay,Detroit,92,93,1,-1,2017-01-29
Illinois State,Evansville,69,59,0,10,2017-01-29
Wright State,UIC,88,86,0,2,2017-01-29
St. Peter's,Iona,66,69,1,-3,2017-01-29
NC State,Louisville,60,85,1,-25,2017-01-29
Binghamton,Maine,65,54,0,11,2017-01-29
Michigan,Michigan State,62,70,1,-8,2017-01-29
Purdue,Nebraska,80,83,1,-3,2017-01-29
Indiana,Northwestern,55,68,1,-13,2017-01-29
Milwaukee,Oakland,70,79,1,-9,2017-01-29
Xavier,St. John's (NY),82,77,0,5,2017-01-29
Northern Kentucky,Valparaiso,58,65,1,-7,2017-01-29
Virginia,Villanova,59,61,1,-2,2017-01-29
Boston College,Virginia Tech,79,85,1,-6,2017-01-29
Texas State,Appalachian State,68,55,0,13,2017-01-30
SIU-Edwardsville,Belmont,69,92,1,-23,2017-01-30
Rider,Canisius,72,66,0,6,2017-01-30
Texas-Arlington,Coastal Carolina,70,72,1,-2,2017-01-30
North Carolina Central,Delaware State,82,74,0,8,2017-01-30
North Florida,Florida Gulf Coast,59,74,1,-15,2017-01-30
Mississippi Valley State,Grambling,74,77,1,-3,2017-01-30
Coppin State,Hampton,65,77,1,-12,2017-01-30
South Carolina State,Howard,77,68,0,9,2017-01-30
Arkansas-Pine Bluff,Jackson State,59,74,1,-15,2017-01-30
Boston University,Lehigh,76,59,0,17,2017-01-30
Arkansas State,Louisiana,88,69,0,19,2017-01-30
Little Rock,Louisiana-Monroe,52,68,1,-16,2017-01-30
Monmouth,Marist,83,71,0,12,2017-01-30
Savannah State,Maryland-Eastern Shore,87,82,0,5,2017-01-30
Western Carolina,Mercer,47,62,1,-15,2017-01-30
Florida A&M,Morgan State,60,77,1,-17,2017-01-30
Northern New Mexico,New Mexico State,75,98,1,-23,2017-01-30
Kennesaw State,NJIT,54,53,0,1,2017-01-30
North Carolina A&T,Norfolk State,69,83,1,-14,2017-01-30
Duke,Notre Dame,84,74,0,10,2017-01-30
Oklahoma State,Oklahoma,68,66,0,2,2017-01-30
Alabama State,Prairie View,52,72,1,-20,2017-01-30
Siena,Quinnipiac,84,75,0,9,2017-01-30
Georgia State,South Alabama,83,80,0,3,2017-01-30
Lipscomb,USC Upstate,92,80,0,12,2017-01-30
Jacksonville,Stetson,89,86,0,3,2017-01-30
Alabama A&M,Texas Southern,47,92,1,-45,2017-01-30
Georgia Southern,Troy,76,83,1,-7,2017-01-30
Drexel,William & Mary,85,108,1,-23,2017-01-30
Tennessee,Auburn,87,77,0,10,2017-01-31
Toledo,Ball State,80,81,1,-1,2017-01-31
Wake Forest,Boston College,85,80,0,5,2017-01-31
Miami (OH),Bowling Green State,72,83,1,-11,2017-01-31
Central Michigan,Buffalo,91,101,1,-10,2017-01-31
Creighton,Butler,76,67,0,9,2017-01-31
Boise State,Colorado State,79,76,0,3,2017-01-31
Georgetown,DePaul,76,73,0,3,2017-01-31
Kent State,Eastern Michigan,70,64,0,6,2017-01-31
Manhattan,Fairfield,49,78,1,-29,2017-01-31
Dayton,Fordham,75,66,0,9,2017-01-31
Bethesda University (CA),Grand Canyon,66,95,1,-29,2017-01-31
Wisconsin,Illinois,57,43,0,14,2017-01-31
West Virginia,Iowa State,85,72,0,13,2017-01-31
Georgia,Kentucky,81,90,1,-9,2017-01-31
Presbyterian,Liberty,51,71,1,-20,2017-01-31
Mississippi State,Ole Miss,61,88,1,-27,2017-01-31
Ottawa (KS),UMKC,67,93,1,-26,2017-01-31
Loyola (IL),Missouri State,81,82,1,-1,2017-01-31
Pitt,UNC,78,80,1,-2,2017-01-31
Akron,Northern Illinois,76,73,0,3,2017-01-31
Maryland,Ohio State,77,71,0,6,2017-01-31
Denver,Oral Roberts,93,69,0,24,2017-01-31
George Washington,Rhode Island,70,82,1,-12,2017-01-31
Iowa,Rutgers,83,63,0,20,2017-01-31
Davidson,St. Joseph's,75,60,0,15,2017-01-31
Wyoming,San Diego State,68,77,1,-9,2017-01-31
Vanderbilt,Texas A&M,68,54,0,14,2017-01-31
Temple,Tulane,79,71,0,8,2017-01-31
Ohio,Western Michigan,85,90,1,-5,2017-01-31
New Orleans,Abilene Christian,69,70,1,-1,2017-02-01
UMass-Lowell,Albany (NY),77,90,1,-13,2017-02-01
Alabama,Arkansas,68,87,1,-19,2017-02-01
Lafayette,Army,73,80,1,-7,2017-02-01
Stetson,Bethune-Cookman,76,67,0,9,2017-02-01
UMBC,Binghamton,92,74,0,18,2017-02-01
American,Bucknell,60,80,1,-20,2017-02-01
Long Beach State,Cal State Northridge,98,108,1,-10,2017-02-01
Gardner-Webb,Campbell,80,68,0,12,2017-02-01
Georgia Tech,Clemson,62,74,1,-12,2017-02-01
North Carolina A&T,Delaware State,65,82,1,-17,2017-02-01
Wichita State,Drake,77,69,0,8,2017-02-01
St. Bonaventure,Duquesne,71,64,0,7,2017-02-01
Austin Peay,Eastern Kentucky,83,81,0,2,2017-02-01
Air Force,Fresno State,64,73,1,-9,2017-02-01
Maryland-Eastern Shore,Hampton,65,66,1,-1,2017-02-01
Colgate,Holy Cross,50,56,1,-6,2017-02-01
UCF,Houston,64,82,1,-18,2017-02-01
Northern Iowa,Illinois State,51,57,1,-6,2017-02-01
Penn State,Indiana,102,110,1,-8,2017-02-01
Evansville,Indiana State,84,85,1,-1,2017-02-01
North Dakota State,IUPUI,81,86,1,-5,2017-02-01
Southeast Missouri State,Jacksonville State,62,74,1,-12,2017-02-01
Baylor,Kansas,68,73,1,-5,2017-02-01
TCU,Kansas State,86,80,0,6,2017-02-01
UMass,La Salle,78,88,1,-10,2017-02-01
High Point,Longwood,92,68,0,24,2017-02-01
South Carolina,LSU,88,63,0,25,2017-02-01
Lehigh,Loyola (MD),60,62,1,-2,2017-02-01
Florida State,Miami (FL),75,57,0,18,2017-02-01
South Dakota,Omaha,83,91,1,-8,2017-02-01
New Mexico,UNLV,80,77,0,3,2017-02-01
Charleston Southern,UNC Asheville,73,91,1,-18,2017-02-01
Syracuse,NC State,100,93,0,7,2017-02-01
Villanova,Providence,66,57,0,9,2017-02-01
Northwestern,Purdue,59,80,1,-21,2017-02-01
Winthrop,Radford,81,65,0,16,2017-02-01
George Mason,Saint Louis,74,76,1,-2,2017-02-01
Western Illinois,South Dakota State,65,98,1,-33,2017-02-01
Nicholls State,Southeastern Louisiana,44,72,1,-28,2017-02-01
Bradley,Southern Illinois,65,85,1,-20,2017-02-01
East Carolina,SMU,46,86,1,-40,2017-02-01
Marquette,St. John's (NY),72,86,1,-14,2017-02-01
New Hampshire,Stony Brook,61,64,1,-3,2017-02-01
UT-Martin,Tennessee Tech,75,46,0,29,2017-02-01
Texas Tech,Texas,58,62,1,-4,2017-02-01
Houston Baptist,Texas A&M-Corpus Christi,79,90,1,-11,2017-02-01
Cincinnati,Tulsa,57,55,0,2,2017-02-01
Nevada,Utah State,57,74,1,-17,2017-02-01
Maine,Vermont,53,74,1,-21,2017-02-01
Virginia Tech,Virginia,48,71,1,-23,2017-02-01
Richmond,VCU,74,81,1,-7,2017-02-01
USC,Washington,82,74,0,8,2017-02-01
UCLA,Washington State,95,79,0,16,2017-02-01
Seton Hall,Xavier,70,72,1,-2,2017-02-01
Navy,Boston University,70,61,0,9,2017-02-02
Gonzaga,BYU,85,75,0,10,2017-02-02
UC-Davis,Cal Poly,70,74,1,-4,2017-02-02
Utah,California,75,77,1,-2,2017-02-02
Hawaii,UC-Riverside,72,63,0,9,2017-02-02
Cal State Fullerton,UCSB,79,53,0,26,2017-02-02
Northwestern State,Central Arkansas,97,107,1,-10,2017-02-02
Wagner,Central Connecticut,70,60,0,10,2017-02-02
Florida Atlantic,Charlotte,77,75,0,2,2017-02-02
UNC Greensboro,Chattanooga,68,91,1,-23,2017-02-02
Wofford,Citadel,100,90,0,10,2017-02-02
Detroit,Cleveland State,73,90,1,-17,2017-02-02
Sacramento State,Eastern Washington,72,77,1,-5,2017-02-02
James Madison,Elon,61,67,1,-6,2017-02-02
Niagara,Fairfield,61,81,1,-20,2017-02-02
Sacred Heart,Fairleigh Dickinson,74,70,0,4,2017-02-02
Missouri,Florida,54,93,1,-39,2017-02-02
UIC,Green Bay,80,84,1,-4,2017-02-02
Delaware,Hofstra,65,73,1,-8,2017-02-02
Portland State,Idaho,72,89,1,-17,2017-02-02
Northern Arizona,Idaho State,90,91,1,-1,2017-02-02
McNeese State,Incarnate Word,87,79,0,8,2017-02-02
Robert Morris,LIU-Brooklyn,67,63,0,4,2017-02-02
Western Kentucky,Louisiana Tech,67,76,1,-9,2017-02-02
Furman,Mercer,70,68,0,2,2017-02-02
Valparaiso,Milwaukee,71,53,0,18,2017-02-02
Bryant,Mount St. Mary's,70,77,1,-7,2017-02-02
Belmont,Murray State,81,69,0,12,2017-02-02
Michigan State,Nebraska,72,61,0,11,2017-02-02
College of Charleston,UNC Wilmington,67,66,0,1,2017-02-02
Florida International,Old Dominion,57,64,1,-7,2017-02-02
Arizona State,Oregon,70,71,1,-1,2017-02-02
Arizona,Oregon State,71,54,0,17,2017-02-02
Saint Mary's,Pacific,74,70,0,4,2017-02-02
Santa Clara,Portland,60,45,0,15,2017-02-02
Stephen F. Austin,Sam Houston State,63,72,1,-9,2017-02-02
Western Carolina,Samford,63,82,1,-19,2017-02-02
Loyola Marymount,San Diego,72,53,0,19,2017-02-02
Pepperdine,San Francisco,56,77,1,-21,2017-02-02
Memphis,South Florida,85,75,0,10,2017-02-02
Marshall,Southern Miss,76,91,1,-15,2017-02-02
Saint Francis (PA),St. Francis (NY),78,61,0,17,2017-02-02
Colorado,Stanford,81,74,0,7,2017-02-02
Eastern Illinois,Tennessee State,77,67,0,10,2017-02-02
Alabama-Birmingham,UTEP,59,63,1,-4,2017-02-02
Middle Tennessee,UTSA,69,59,0,10,2017-02-02
Drexel,Towson,103,104,1,-1,2017-02-02
ETSU,VMI,81,71,0,10,2017-02-02
Southern Utah,Weber State,74,90,1,-16,2017-02-02
Northeastern,William & Mary,69,94,1,-25,2017-02-02
Oakland,Youngstown State,90,76,0,14,2017-02-02
Buffalo,Ball State,96,69,0,27,2017-02-03
Western Michigan,Central Michigan,82,86,1,-4,2017-02-03
Yale,Columbia,87,78,0,9,2017-02-03
Brown,Cornell,81,70,0,11,2017-02-03
Princeton,Dartmouth,69,64,0,5,2017-02-03
Rhode Island,Davidson,70,59,0,11,2017-02-03
Penn,Harvard,59,69,1,-10,2017-02-03
St. Peter's,Monmouth,70,71,1,-1,2017-02-03
Iona,Rider,95,76,0,19,2017-02-03
Sam Houston State,Abilene Christian,64,71,1,-7,2017-02-04
Wyoming,Air Force,83,74,0,9,2017-02-04
Auburn,Alabama,82,77,0,5,2017-02-04
Mississippi Valley State,Alabama A&M,68,66,0,2,2017-02-04
Arkansas-Pine Bluff,Alabama State,65,77,1,-12,2017-02-04
Stony Brook,Albany (NY),72,65,0,7,2017-02-04
Jackson State,Alcorn State,58,69,1,-11,2017-02-04
Lehigh,American,70,55,0,15,2017-02-04
Coastal Carolina,Little Rock,82,75,0,7,2017-02-04
Appalachian State,Arkansas State,78,79,1,-1,2017-02-04
Tennessee State,Austin Peay,70,66,0,4,2017-02-04
Kansas State,Baylor,56,54,0,2,2017-02-04
Delaware State,Bethune-Cookman,88,82,0,6,2017-02-04
Utah State,Boise State,70,72,1,-2,2017-02-04
Louisville,Boston College,90,67,0,23,2017-02-04
Toledo,Bowling Green State,100,104,1,-4,2017-02-04
Drake,Bradley,72,79,1,-7,2017-02-04
Portland,BYU,62,73,1,-11,2017-02-04
UC-Riverside,Cal Poly,67,56,0,11,2017-02-04
Hawaii,Cal State Northridge,76,72,0,4,2017-02-04
UC-Davis,UCSB,67,64,0,3,2017-02-04
Southeastern Louisiana,Central Arkansas,66,68,1,-2,2017-02-04
Memphis,UCF,57,72,1,-15,2017-02-04
Presbyterian,Charleston Southern,65,71,1,-6,2017-02-04
Florida International,Charlotte,80,95,1,-15,2017-02-04
Western Carolina,Chattanooga,65,77,1,-12,2017-02-04
UConn,Cincinnati,68,82,1,-14,2017-02-04
Furman,Citadel,99,91,0,8,2017-02-04
Oakland,Cleveland State,53,51,0,2,2017-02-04
Navy,Colgate,52,55,1,-3,2017-02-04
Elon,College of Charleston,58,71,1,-13,2017-02-04
Brown,Columbia,78,83,1,-5,2017-02-04
Yale,Cornell,78,71,0,7,2017-02-04
Xavier,Creighton,82,80,0,2,2017-02-04
Penn,Dartmouth,71,74,1,-3,2017-02-04
Duquesne,Dayton,53,90,1,-37,2017-02-04
Purdue-Fort Wayne,Denver,73,76,1,-3,2017-02-04
Marquette,DePaul,92,79,0,13,2017-02-04
Pitt,Duke,64,72,1,-8,2017-02-04
Tulane,East Carolina,65,74,1,-9,2017-02-04
Tennessee Tech,Eastern Illinois,87,68,0,19,2017-02-04
Portland State,Eastern Washington,124,130,1,-6,2017-02-04
Missouri State,Evansville,66,74,1,-8,2017-02-04
Wagner,Fairleigh Dickinson,68,59,0,9,2017-02-04
Kentucky,Florida,66,88,1,-22,2017-02-04
Howard,Florida A&M,62,71,1,-9,2017-02-04
San Diego State,Fresno State,70,67,0,3,2017-02-04
Longwood,Gardner-Webb,64,90,1,-26,2017-02-04
La Salle,George Mason,75,95,1,-20,2017-02-04
Seton Hall,Georgetown,68,66,0,2,2017-02-04
Louisiana-Monroe,Georgia Southern,62,76,1,-14,2017-02-04
Louisiana,Georgia State,82,85,1,-3,2017-02-04
Santa Clara,Gonzaga,55,90,1,-35,2017-02-04
Cal State Bakersfield,Grand Canyon,65,62,0,3,2017-02-04
Valparaiso,Green Bay,69,86,1,-17,2017-02-04
Vermont,Hartford,79,66,0,13,2017-02-04
Princeton,Harvard,57,56,0,1,2017-02-04
UNC Asheville,High Point,74,71,0,3,2017-02-04
Drexel,Hofstra,77,79,1,-2,2017-02-04
Incarnate Word,Houston Baptist,70,84,1,-14,2017-02-04
Sacramento State,Idaho,67,81,1,-14,2017-02-04
Southern Utah,Idaho State,68,94,1,-26,2017-02-04
Minnesota,Illinois,68,59,0,9,2017-02-04
Florida Gulf Coast,Jacksonville,67,57,0,10,2017-02-04
Northeastern,James Madison,69,73,1,-4,2017-02-04
Iowa State,Kansas,92,89,0,3,2017-02-04
USC Upstate,Kennesaw State,79,84,1,-5,2017-02-04
McNeese State,Lamar,57,77,1,-20,2017-02-04
Radford,Liberty,54,57,1,-3,2017-02-04
NJIT,Lipscomb,63,87,1,-24,2017-02-04
UC-Irvine,Long Beach State,63,72,1,-9,2017-02-04
Saint Francis (PA),LIU-Brooklyn,80,78,0,2,2017-02-04
Texas A&M,LSU,85,73,0,12,2017-02-04
Marshall,Louisiana Tech,90,94,1,-4,2017-02-04
Southern Illinois,Loyola (IL),67,61,0,6,2017-02-04
Army,Loyola (MD),63,78,1,-15,2017-02-04
UMBC,Maine,83,71,0,12,2017-02-04
Marist,Manhattan,67,68,1,-1,2017-02-04
Purdue,Maryland,73,72,0,1,2017-02-04
Coppin State,Maryland-Eastern Shore,57,78,1,-21,2017-02-04
Binghamton,UMass-Lowell,59,60,1,-1,2017-02-04
Wofford,Mercer,65,62,0,3,2017-02-04
Kent State,Miami (OH),66,62,0,4,2017-02-04
Ohio State,Michigan,70,66,0,4,2017-02-04
UIC,Milwaukee,105,100,0,5,2017-02-04
Tennessee,Mississippi State,59,64,1,-5,2017-02-04
Arkansas,Missouri,78,83,1,-5,2017-02-04
Montana State,Montana,84,90,1,-6,2017-02-04
North Carolina Central,Morgan State,68,62,0,6,2017-02-04
Central Connecticut,Mount St. Mary's,54,52,0,2,2017-02-04
Colorado State,UNLV,69,49,0,20,2017-02-04
San Jose State,New Mexico,78,68,0,10,2017-02-04
Chicago State,New Mexico State,51,86,1,-35,2017-02-04
Nicholls State,New Orleans,69,78,1,-9,2017-02-04
Miami (FL),NC State,84,79,0,5,2017-02-04
Delaware,UNC Wilmington,80,108,1,-28,2017-02-04
Northern Colorado,North Dakota,77,87,1,-10,2017-02-04
South Dakota,North Dakota State,76,66,0,10,2017-02-04
Stetson,North Florida,64,96,1,-32,2017-02-04
Rice,North Texas,95,80,0,15,2017-02-04
Eastern Michigan,Northern Illinois,69,81,1,-12,2017-02-04
Indiana State,Northern Iowa,60,65,1,-5,2017-02-04
Stephen F. Austin,Northwestern State,75,73,0,2,2017-02-04
Akron,Ohio,70,85,1,-15,2017-02-04
Florida Atlantic,Old Dominion,65,61,0,4,2017-02-04
Arizona,Oregon,58,85,1,-27,2017-02-04
Arizona State,Oregon State,81,68,0,13,2017-02-04
Rutgers,Penn State,70,68,0,2,2017-02-04
Pacific,Pepperdine,72,82,1,-10,2017-02-04
Niagara,Quinnipiac,81,89,1,-8,2017-02-04
George Washington,Richmond,75,84,1,-9,2017-02-04
Bryant,Sacred Heart,70,73,1,-3,2017-02-04
Fordham,St. Joseph's,86,83,0,3,2017-02-04
North Carolina A&T,Saint Louis,59,78,1,-19,2017-02-04
UNC Greensboro,Samford,81,75,0,6,2017-02-04
Saint Mary's,San Diego,71,27,0,44,2017-02-04
Loyola Marymount,San Francisco,64,74,1,-10,2017-02-04
Hampton,Savannah State,92,89,0,3,2017-02-04
Utah Valley,Seattle,50,63,1,-13,2017-02-04
Canisius,Siena,80,73,0,7,2017-02-04
Georgia,South Carolina,75,77,1,-2,2017-02-04
Norfolk State,South Carolina State,65,62,0,3,2017-02-04
Oral Roberts,South Dakota State,67,74,1,-7,2017-02-04
Morehead State,Southeast Missouri State,89,81,0,8,2017-02-04
Grambling,Southern,66,67,1,-1,2017-02-04
Jacksonville State,SIU-Edwardsville,72,61,0,11,2017-02-04
Western Kentucky,Southern Miss,64,47,0,17,2017-02-04
VCU,St. Bonaventure,83,77,0,6,2017-02-04
Robert Morris,St. Francis (NY),78,54,0,24,2017-02-04
Utah,Stanford,75,81,1,-6,2017-02-04
Virginia,Syracuse,62,66,1,-4,2017-02-04
Eastern Kentucky,UT-Martin,68,85,1,-17,2017-02-04
Texas State,Texas-Arlington,61,76,1,-15,2017-02-04
Texas,TCU,63,78,1,-15,2017-02-04
Middle Tennessee,UTEP,54,57,1,-3,2017-02-04
UMKC,Texas-Rio Grande Valley,73,60,0,13,2017-02-04
Alabama-Birmingham,UTSA,67,82,1,-15,2017-02-04
Prairie View,Texas Southern,61,74,1,-13,2017-02-04
Oklahoma,Texas Tech,69,77,1,-8,2017-02-04
William & Mary,Towson,80,82,1,-2,2017-02-04
South Alabama,Troy,76,71,0,5,2017-02-04
SMU,Tulsa,76,53,0,23,2017-02-04
Ole Miss,Vanderbilt,81,74,0,7,2017-02-04
St. John's (NY),Villanova,79,92,1,-13,2017-02-04
Georgia Tech,Wake Forest,69,81,1,-12,2017-02-04
UCLA,Washington,107,66,0,41,2017-02-04
USC,Washington State,86,77,0,9,2017-02-04
Northern Arizona,Weber State,80,86,1,-6,2017-02-04
Oklahoma State,West Virginia,82,75,0,7,2017-02-04
Omaha,Western Illinois,79,67,0,12,2017-02-04
Illinois State,Wichita State,45,86,1,-41,2017-02-04
Campbell,Winthrop,62,76,1,-14,2017-02-04
Northern Kentucky,Wright State,83,79,0,4,2017-02-04
Detroit,Youngstown State,90,80,0,10,2017-02-04
Lafayette,Boston University,58,75,1,-17,2017-02-05
Colorado,California,66,77,1,-11,2017-02-05
Clemson,Florida State,61,109,1,-48,2017-02-05
Nebraska,Iowa,70,81,1,-11,2017-02-05
Notre Dame,UNC,76,83,1,-7,2017-02-05
South Florida,Temple,74,83,1,-9,2017-02-05
Indiana,Wisconsin,60,65,1,-5,2017-02-05
Arkansas-Pine Bluff,Alabama A&M,65,49,0,16,2017-02-06
Mississippi Valley State,Alabama State,66,71,1,-5,2017-02-06
Grambling,Alcorn State,65,75,1,-10,2017-02-06
Appalachian State,Little Rock,62,69,1,-7,2017-02-06
Coastal Carolina,Arkansas State,57,67,1,-10,2017-02-06
Howard,Bethune-Cookman,67,71,1,-4,2017-02-06
Holy Cross,Bucknell,68,82,1,-14,2017-02-06
North Carolina Central,Coppin State,86,77,0,9,2017-02-06
Quinnipiac,Fairfield,73,71,0,2,2017-02-06
Delaware State,Florida A&M,80,77,0,3,2017-02-06
Louisiana,Georgia Southern,70,74,1,-4,2017-02-06
Louisiana-Monroe,Georgia State,55,69,1,-14,2017-02-06
Kansas,Kansas State,74,71,0,3,2017-02-06
Hartford,Maine,41,52,1,-11,2017-02-06
Albany (NY),New Hampshire,69,55,0,14,2017-02-06
Monmouth,Rider,74,69,0,5,2017-02-06
Canisius,St. Peter's,72,70,0,2,2017-02-06
Norfolk State,Savannah State,92,87,0,5,2017-02-06
Hampton,South Carolina State,93,64,0,29,2017-02-06
Jackson State,Southern,75,88,1,-13,2017-02-06
UMass-Lowell,Stony Brook,72,83,1,-11,2017-02-06
Binghamton,Vermont,51,71,1,-20,2017-02-06
Louisville,Virginia,55,71,1,-16,2017-02-06
ETSU,Wofford,76,79,1,-3,2017-02-06
Ball State,Akron,63,65,1,-2,2017-02-07
Vanderbilt,Arkansas,72,59,0,13,2017-02-07
Mississippi State,Auburn,92,98,1,-6,2017-02-07
Northern Illinois,Buffalo,45,65,1,-20,2017-02-07
Syracuse,Clemson,82,81,0,1,2017-02-07
Utah State,Colorado State,52,69,1,-17,2017-02-07
St. Joseph's,Dayton,70,77,1,-7,2017-02-07
Illinois State,Drake,82,53,0,29,2017-02-07
Florida,Georgia,72,60,0,12,2017-02-07
Tusculum,Georgia Tech,58,96,1,-38,2017-02-07
Siena,Iona,81,79,0,2,2017-02-07
Bowling Green State,Kent State,84,83,0,1,2017-02-07
LSU,Kentucky,85,92,1,-7,2017-02-07
Butler,Marquette,68,65,0,3,2017-02-07
Rhode Island,UMass,70,62,0,8,2017-02-07
Tulsa,Memphis,44,66,1,-22,2017-02-07
Western Michigan,Miami (OH),72,55,0,17,2017-02-07
Michigan State,Michigan,57,86,1,-29,2017-02-07
Allen,North Carolina A&T,78,86,1,-8,2017-02-07
Illinois,Northwestern,68,61,0,7,2017-02-07
Wake Forest,Notre Dame,81,88,1,-7,2017-02-07
Central Michigan,Ohio,97,87,0,10,2017-02-07
Maryland,Penn State,64,70,1,-6,2017-02-07
Princeton,Penn,64,49,0,15,2017-02-07
San Diego State,San Jose State,71,76,1,-5,2017-02-07
Alabama,South Carolina,90,86,0,4,2017-02-07
Iowa State,Texas,65,67,1,-2,2017-02-07
Texas Tech,TCU,61,62,1,-1,2017-02-07
Eastern Michigan,Toledo,57,73,1,-16,2017-02-07
Georgetown,Villanova,64,75,1,-11,2017-02-07
New Mexico,Air Force,74,67,0,7,2017-02-08
Boston University,American,67,64,0,3,2017-02-08
Stanford,Arizona,67,74,1,-7,2017-02-08
California,Arizona State,68,43,0,25,2017-02-08
Pitt,Boston College,83,72,0,11,2017-02-08
Indiana State,Bradley,56,54,0,2,2017-02-08
Cal State Fullerton,UC-Davis,65,74,1,-9,2017-02-08
UCSB,UC-Irvine,47,64,1,-17,2017-02-08
UCF,Cincinnati,50,60,1,-10,2017-02-08
Army,Colgate,58,70,1,-12,2017-02-08
South Florida,UConn,51,97,1,-46,2017-02-08
George Mason,Davidson,76,69,0,7,2017-02-08
Loyola (IL),Evansville,58,60,1,-2,2017-02-08
NC State,Florida State,71,95,1,-24,2017-02-08
La Salle,Fordham,67,52,0,15,2017-02-08
VCU,George Washington,54,53,0,1,2017-02-08
South Dakota,Purdue-Fort Wayne,93,82,0,11,2017-02-08
Holy Cross,Lafayette,59,69,1,-10,2017-02-08
Bucknell,Lehigh,71,79,1,-8,2017-02-08
Virginia Tech,Miami (FL),68,74,1,-6,2017-02-08
Iowa,Minnesota,89,101,1,-12,2017-02-08
Murray State,Morehead State,100,101,1,-1,2017-02-08
Loyola (MD),Navy,59,62,1,-3,2017-02-08
IUPUI,Omaha,89,78,0,11,2017-02-08
UNLV,Nevada,77,104,1,-27,2017-02-08
South Dakota State,North Dakota State,65,82,1,-17,2017-02-08
Southern Illinois,Northern Iowa,41,49,1,-8,2017-02-08
Rutgers,Ohio State,64,70,1,-6,2017-02-08
West Virginia,Oklahoma,61,50,0,11,2017-02-08
Baylor,Oklahoma State,72,69,0,3,2017-02-08
Western Illinois,Oral Roberts,63,60,0,3,2017-02-08
Providence,Seton Hall,70,72,1,-2,2017-02-08
Saint Louis,St. Bonaventure,55,70,1,-15,2017-02-08
Ole Miss,Tennessee,66,75,1,-9,2017-02-08
Missouri,Texas A&M,73,76,1,-3,2017-02-08
Southeastern Louisiana,Texas A&M-Corpus Christi,75,80,1,-5,2017-02-08
Houston,Tulane,91,62,0,29,2017-02-08
Fresno State,Wyoming,100,102,1,-2,2017-02-08
DePaul,Xavier,61,72,1,-11,2017-02-08
Charlotte,Alabama-Birmingham,69,82,1,-13,2017-02-09
Albany (NY),Binghamton,66,54,0,12,2017-02-09
LIU-Brooklyn,Bryant,88,85,0,3,2017-02-09
New Mexico State,Cal State Bakersfield,53,72,1,-19,2017-02-09
Long Beach State,UC-Riverside,78,71,0,7,2017-02-09
Longwood,Campbell,79,83,1,-4,2017-02-09
Abilene Christian,Central Arkansas,73,84,1,-11,2017-02-09
Seattle,Chicago State,90,65,0,25,2017-02-09
Northeastern,College of Charleston,73,72,0,1,2017-02-09
Washington,Colorado,66,81,1,-15,2017-02-09
Elon,Delaware,74,76,1,-2,2017-02-09
William & Mary,Drexel,61,79,1,-18,2017-02-09
UNC,Duke,78,86,1,-8,2017-02-09
Citadel,ETSU,69,90,1,-21,2017-02-09
UT-Martin,Eastern Illinois,71,81,1,-10,2017-02-09
Central Connecticut,Fairleigh Dickinson,62,79,1,-17,2017-02-09
North Texas,Florida Atlantic,70,64,0,6,2017-02-09
Lipscomb,Florida Gulf Coast,65,60,0,5,2017-02-09
Rice,Florida International,89,78,0,11,2017-02-09
Chattanooga,Furman,56,60,1,-4,2017-02-09
Liberty,Gardner-Webb,92,87,0,5,2017-02-09
Texas-Rio Grande Valley,Grand Canyon,57,76,1,-19,2017-02-09
Cal Poly,Hawaii,65,74,1,-9,2017-02-09
Youngstown State,UIC,81,84,1,-3,2017-02-09
Purdue,Indiana,69,64,0,5,2017-02-09
USC Upstate,Jacksonville,70,67,0,3,2017-02-09
Belmont,Jacksonville State,66,53,0,13,2017-02-09
Sam Houston State,Lamar,76,80,1,-4,2017-02-09
Gonzaga,Loyola Marymount,90,60,0,30,2017-02-09
Fairfield,Marist,73,53,0,20,2017-02-09
Hartford,UMBC,84,77,0,7,2017-02-09
Maine,UMass-Lowell,68,100,1,-32,2017-02-09
New Orleans,McNeese State,69,63,0,6,2017-02-09
Old Dominion,Middle Tennessee,51,64,1,-13,2017-02-09
Utah Valley,UMKC,76,84,1,-8,2017-02-09
Wisconsin,Nebraska,70,69,0,1,2017-02-09
Winthrop,UNC Asheville,101,104,1,-3,2017-02-09
James Madison,UNC Wilmington,73,88,1,-15,2017-02-09
Eastern Washington,North Dakota,86,95,1,-9,2017-02-09
NJIT,North Florida,69,91,1,-22,2017-02-09
Montana State,Northern Arizona,63,69,1,-6,2017-02-09
Idaho,Northern Colorado,88,76,0,12,2017-02-09
Green Bay,Northern Kentucky,67,69,1,-2,2017-02-09
Houston Baptist,Northwestern State,86,69,0,17,2017-02-09
San Diego,Pacific,58,61,1,-3,2017-02-09
BYU,Pepperdine,83,99,1,-16,2017-02-09
Idaho State,Portland State,69,74,1,-5,2017-02-09
High Point,Presbyterian,68,58,0,10,2017-02-09
St. Peter's,Quinnipiac,76,45,0,31,2017-02-09
Charleston Southern,Radford,67,79,1,-12,2017-02-09
Mount St. Mary's,Robert Morris,74,70,0,4,2017-02-09
Weber State,Sacramento State,74,77,1,-3,2017-02-09
St. Francis (NY),Sacred Heart,65,80,1,-15,2017-02-09
Wagner,Saint Francis (PA),76,74,0,2,2017-02-09
Portland,Saint Mary's,41,51,1,-10,2017-02-09
Santa Clara,San Francisco,58,61,1,-3,2017-02-09
Oregon State,USC,66,92,1,-26,2017-02-09
Southeast Missouri State,SIU-Edwardsville,71,67,0,4,2017-02-09
Montana,Southern Utah,70,55,0,15,2017-02-09
Incarnate Word,Stephen F. Austin,79,87,1,-8,2017-02-09
Kennesaw State,Stetson,92,85,0,7,2017-02-09
SMU,Temple,66,50,0,16,2017-02-09
Tennessee State,Tennessee Tech,72,59,0,13,2017-02-09
Louisiana Tech,UTEP,62,61,0,1,2017-02-09
Southern Miss,UTSA,51,57,1,-6,2017-02-09
Hofstra,Towson,65,69,1,-4,2017-02-09
Oregon,UCLA,79,82,1,-3,2017-02-09
Washington State,Utah,70,74,1,-4,2017-02-09
Cleveland State,Valparaiso,57,78,1,-21,2017-02-09
New Hampshire,Vermont,74,82,1,-8,2017-02-09
Mercer,VMI,81,51,0,30,2017-02-09
Missouri State,Wichita State,62,80,1,-18,2017-02-09
Samford,Wofford,127,131,1,-4,2017-02-09
Milwaukee,Wright State,65,76,1,-11,2017-02-09
Ohio,Ball State,79,77,0,2,2017-02-10
Harvard,Brown,87,74,0,13,2017-02-10
Niagara,Canisius,94,81,0,13,2017-02-10
Oakland,Detroit,89,80,0,9,2017-02-10
Akron,Eastern Michigan,87,76,0,11,2017-02-10
Monmouth,Manhattan,62,58,0,4,2017-02-10
Columbia,Penn,62,70,1,-8,2017-02-10
Cornell,Princeton,60,69,1,-9,2017-02-10
Dayton,Rhode Island,75,74,0,1,2017-02-10
Dartmouth,Yale,64,73,1,-9,2017-02-10
Northwestern State,Abilene Christian,72,76,1,-4,2017-02-11
Kentucky,Alabama,67,58,0,9,2017-02-11
Old Dominion,Alabama-Birmingham,83,62,0,21,2017-02-11
Alabama A&M,Alabama State,89,97,1,-8,2017-02-11
Georgia State,Appalachian State,72,77,1,-5,2017-02-11
California,Arizona,57,62,1,-5,2017-02-11
Stanford,Arizona State,69,75,1,-6,2017-02-11
Southern,Arkansas-Pine Bluff,61,68,1,-7,2017-02-11
American,Army,61,58,0,3,2017-02-11
TCU,Baylor,52,70,1,-18,2017-02-11
Air Force,Boise State,66,76,1,-10,2017-02-11
Loyola (MD),Boston University,63,78,1,-15,2017-02-11
Buffalo,Bowling Green State,88,74,0,14,2017-02-11
Dartmouth,Brown,77,74,0,3,2017-02-11
St. Francis (NY),Bryant,69,80,1,-11,2017-02-11
Texas-Rio Grande Valley,Cal State Bakersfield,53,75,1,-22,2017-02-11
Long Beach State,Cal State Fullerton,69,74,1,-5,2017-02-11
UCSB,Cal State Northridge,55,77,1,-22,2017-02-11
UC-Riverside,UC-Davis,63,77,1,-14,2017-02-11
Nicholls State,Central Arkansas,83,106,1,-23,2017-02-11
UConn,UCF,66,63,0,3,2017-02-11
Utah Valley,Chicago State,87,54,0,33,2017-02-11
Georgia Southern,Coastal Carolina,70,82,1,-12,2017-02-11
Fresno State,Colorado State,62,78,1,-16,2017-02-11
Bethune-Cookman,Coppin State,72,76,1,-4,2017-02-11
Creighton,DePaul,93,58,0,35,2017-02-11
Towson,Drexel,69,65,0,4,2017-02-11
Clemson,Duke,62,64,1,-2,2017-02-11
Mercer,ETSU,71,88,1,-17,2017-02-11
Southeast Missouri State,Eastern Illinois,80,86,1,-6,2017-02-11
Morehead State,Eastern Kentucky,67,62,0,5,2017-02-11
UNC Wilmington,Elon,76,77,1,-1,2017-02-11
Texas A&M,Florida,62,71,1,-9,2017-02-11
Rice,Florida Atlantic,81,75,0,6,2017-02-11
Kennesaw State,Florida Gulf Coast,63,75,1,-12,2017-02-11
North Texas,Florida International,71,90,1,-19,2017-02-11
Samford,Furman,73,90,1,-17,2017-02-11
Fordham,George Mason,67,73,1,-6,2017-02-11
St. Bonaventure,George Washington,70,76,1,-6,2017-02-11
Marquette,Georgetown,62,80,1,-18,2017-02-11
Boston College,Georgia Tech,54,65,1,-11,2017-02-11
Texas Southern,Grambling,77,70,0,7,2017-02-11
New Mexico State,Grand Canyon,71,83,1,-12,2017-02-11
Howard,Hampton,61,75,1,-14,2017-02-11
UC-Irvine,Hawaii,72,58,0,14,2017-02-11
Radford,High Point,69,68,0,1,2017-02-11
Lamar,Houston Baptist,87,94,1,-7,2017-02-11
Penn State,Illinois,83,70,0,13,2017-02-11
Cleveland State,UIC,66,63,0,3,2017-02-11
Bradley,Illinois State,50,64,1,-14,2017-02-11
Drake,Indiana State,60,84,1,-24,2017-02-11
Oklahoma,Iowa State,64,80,1,-16,2017-02-11
Omaha,Purdue-Fort Wayne,101,108,1,-7,2017-02-11
Oral Roberts,IUPUI,74,68,0,6,2017-02-11
Prairie View,Jackson State,69,78,1,-9,2017-02-11
NJIT,Jacksonville,73,76,1,-3,2017-02-11
Tennessee State,Jacksonville State,57,63,1,-6,2017-02-11
Delaware,James Madison,58,57,0,1,2017-02-11
Richmond,La Salle,64,52,0,12,2017-02-11
Charleston Southern,Liberty,69,76,1,-7,2017-02-11
Fairleigh Dickinson,LIU-Brooklyn,69,75,1,-6,2017-02-11
UNC Asheville,Longwood,91,69,0,22,2017-02-11
Troy,Louisiana,100,88,0,12,2017-02-11
South Alabama,Louisiana-Monroe,66,63,0,3,2017-02-11
Arkansas,LSU,78,70,0,8,2017-02-11
Miami (FL),Louisville,66,71,1,-5,2017-02-11
Portland,Loyola Marymount,60,66,1,-6,2017-02-11
Siena,Marist,84,77,0,7,2017-02-11
Ohio State,Maryland,77,86,1,-9,2017-02-11
Texas A&M-Corpus Christi,McNeese State,73,66,0,7,2017-02-11
Central Michigan,Miami (OH),76,81,1,-5,2017-02-11
Iowa,Michigan State,66,77,1,-11,2017-02-11
Charlotte,Middle Tennessee,55,70,1,-15,2017-02-11
Auburn,Ole Miss,84,90,1,-6,2017-02-11
South Carolina,Mississippi State,77,73,0,4,2017-02-11
Alcorn State,Mississippi Valley State,88,77,0,11,2017-02-11
Vanderbilt,Missouri,52,72,1,-20,2017-02-11
Seattle,UMKC,72,102,1,-30,2017-02-11
Delaware State,Morgan State,56,45,0,11,2017-02-11
Austin Peay,Murray State,58,102,1,-44,2017-02-11
Lafayette,Navy,60,68,1,-8,2017-02-11
San Jose State,UNLV,76,74,0,2,2017-02-11
Maryland-Eastern Shore,Norfolk State,69,75,1,-6,2017-02-11
Florida A&M,North Carolina A&T,83,77,0,6,2017-02-11
South Carolina State,North Carolina Central,62,85,1,-23,2017-02-11
Idaho,North Dakota,65,88,1,-23,2017-02-11
Denver,North Dakota State,63,81,1,-18,2017-02-11
USC Upstate,North Florida,84,71,0,13,2017-02-11
Hofstra,Northeastern,74,64,0,10,2017-02-11
Montana,Northern Arizona,76,59,0,17,2017-02-11
Eastern Washington,Northern Colorado,70,44,0,26,2017-02-11
Milwaukee,Northern Kentucky,63,69,1,-6,2017-02-11
Florida State,Notre Dame,72,84,1,-12,2017-02-11
Texas,Oklahoma State,71,84,1,-13,2017-02-11
Santa Clara,Pacific,64,47,0,17,2017-02-11
Syracuse,Pitt,75,80,1,-5,2017-02-11
Weber State,Portland State,96,93,0,3,2017-02-11
Campbell,Presbyterian,70,57,0,13,2017-02-11
Columbia,Princeton,59,61,1,-2,2017-02-11
Butler,Providence,65,71,1,-6,2017-02-11
Quinnipiac,Rider,107,112,1,-5,2017-02-11
Wagner,Robert Morris,48,50,1,-2,2017-02-11
Minnesota,Rutgers,72,63,0,9,2017-02-11
Idaho State,Sacramento State,63,75,1,-12,2017-02-11
Central Connecticut,Sacred Heart,62,77,1,-15,2017-02-11
Mount St. Mary's,Saint Francis (PA),81,62,0,19,2017-02-11
UMass,St. Joseph's,87,76,0,11,2017-02-11
Duquesne,Saint Louis,81,87,1,-6,2017-02-11
Gonzaga,Saint Mary's,74,64,0,10,2017-02-11
Incarnate Word,Sam Houston State,63,72,1,-9,2017-02-11
Pepperdine,San Diego,65,60,0,5,2017-02-11
BYU,San Francisco,68,52,0,16,2017-02-11
South Dakota State,South Dakota,89,91,1,-2,2017-02-11
East Carolina,South Florida,57,64,1,-7,2017-02-11
New Orleans,Southeastern Louisiana,60,52,0,8,2017-02-11
Oregon,USC,81,70,0,11,2017-02-11
Evansville,Southern Illinois,75,70,0,5,2017-02-11
UT-Martin,SIU-Edwardsville,80,73,0,7,2017-02-11
Montana State,Southern Utah,83,78,0,5,2017-02-11
Seton Hall,St. John's (NY),70,78,1,-8,2017-02-11
Lipscomb,Stetson,97,85,0,12,2017-02-11
Georgia,Tennessee,76,75,0,1,2017-02-11
Belmont,Tennessee Tech,70,83,1,-13,2017-02-11
Arkansas State,Texas-Arlington,75,81,1,-6,2017-02-11
Southern Miss,UTEP,50,80,1,-30,2017-02-11
Louisiana Tech,UTSA,72,66,0,6,2017-02-11
Little Rock,Texas State,49,56,1,-7,2017-02-11
Kansas,Texas Tech,80,79,0,1,2017-02-11
Kent State,Toledo,58,78,1,-20,2017-02-11
Houston,Tulsa,73,64,0,9,2017-02-11
Washington,Utah,61,85,1,-24,2017-02-11
Wyoming,Utah State,74,81,1,-7,2017-02-11
Youngstown State,Valparaiso,72,82,1,-10,2017-02-11
Davidson,VCU,60,74,1,-14,2017-02-11
Citadel,VMI,78,101,1,-23,2017-02-11
NC State,Wake Forest,58,88,1,-30,2017-02-11
Kansas State,West Virginia,66,85,1,-19,2017-02-11
UNC Greensboro,Western Carolina,76,68,0,8,2017-02-11
Marshall,Western Kentucky,84,79,0,5,2017-02-11
Northern Illinois,Western Michigan,67,76,1,-9,2017-02-11
College of Charleston,William & Mary,79,89,1,-10,2017-02-11
Gardner-Webb,Winthrop,71,77,1,-6,2017-02-11
Chattanooga,Wofford,73,65,0,8,2017-02-11
Green Bay,Wright State,79,88,1,-9,2017-02-11
Villanova,Xavier,73,57,0,16,2017-02-11
Harvard,Yale,75,67,0,8,2017-02-11
New Hampshire,Binghamton,63,55,0,8,2017-02-12
Washington State,Colorado,49,81,1,-32,2017-02-12
UMass-Lowell,Hartford,84,87,1,-3,2017-02-12
Lehigh,Holy Cross,45,61,1,-16,2017-02-12
Michigan,Indiana,75,63,0,12,2017-02-12
Wichita State,Loyola (IL),81,64,0,17,2017-02-12
St. Peter's,Manhattan,69,50,0,19,2017-02-12
Vermont,UMBC,77,74,0,3,2017-02-12
Temple,Memphis,74,62,0,12,2017-02-12
Northern Iowa,Missouri State,55,52,0,3,2017-02-12
Iona,Niagara,90,76,0,14,2017-02-12
Cornell,Penn,63,82,1,-19,2017-02-12
Nevada,San Diego State,56,70,1,-14,2017-02-12
Cincinnati,SMU,51,60,1,-9,2017-02-12
Maine,Stony Brook,66,67,1,-1,2017-02-12
Oregon State,UCLA,60,78,1,-18,2017-02-12
Virginia,Virginia Tech,78,80,1,-2,2017-02-12
Northwestern,Wisconsin,66,59,0,7,2017-02-12
Georgia Southern,Appalachian State,78,83,1,-5,2017-02-13
Alcorn State,Arkansas-Pine Bluff,70,58,0,12,2017-02-13
Colgate,Bucknell,58,75,1,-17,2017-02-13
Georgia State,Coastal Carolina,64,65,1,-1,2017-02-13
Delaware State,Coppin State,75,83,1,-8,2017-02-13
Villanova,DePaul,75,62,0,13,2017-02-13
Rider,Fairfield,67,69,1,-2,2017-02-13
Prairie View,Grambling,58,61,1,-3,2017-02-13
Morgan State,Howard,67,70,1,-3,2017-02-13
Texas Southern,Jackson State,62,71,1,-9,2017-02-13
West Virginia,Kansas,80,84,1,-4,2017-02-13
South Alabama,Louisiana,61,87,1,-26,2017-02-13
Troy,Louisiana-Monroe,73,72,0,1,2017-02-13
Bethune-Cookman,Maryland-Eastern Shore,81,82,1,-1,2017-02-13
Southern,Mississippi Valley State,81,72,0,9,2017-02-13
South Carolina State,North Carolina A&T,72,65,0,7,2017-02-13
Florida A&M,North Carolina Central,73,78,1,-5,2017-02-13
Monmouth,Siena,102,82,0,20,2017-02-13
Louisville,Syracuse,76,72,0,4,2017-02-13
Little Rock,Texas-Arlington,55,71,1,-16,2017-02-13
Arkansas State,Texas State,58,62,1,-4,2017-02-13
Baylor,Texas Tech,78,84,1,-6,2017-02-13
Furman,VMI,80,52,0,28,2017-02-13
Toledo,Akron,65,71,1,-6,2017-02-14
Florida,Auburn,114,95,0,19,2017-02-14
Notre Dame,Boston College,84,76,0,8,2017-02-14
Iona,Canisius,83,89,1,-6,2017-02-14
Tulsa,UCF,53,71,1,-18,2017-02-14
Buffalo,Central Michigan,99,93,0,6,2017-02-14
Wake Forest,Clemson,83,95,1,-12,2017-02-14
Ohio,Eastern Michigan,79,71,0,8,2017-02-14
Drake,Evansville,70,87,1,-17,2017-02-14
Richmond,George Mason,70,93,1,-23,2017-02-14
Mississippi State,Georgia,72,79,1,-7,2017-02-14
Miami (OH),Kent State,72,76,1,-4,2017-02-14
Tennessee,Kentucky,58,83,1,-25,2017-02-14
High Point,Liberty,52,55,1,-3,2017-02-14
Ohio State,Michigan State,66,74,1,-8,2017-02-14
LSU,Ole Miss,76,96,1,-20,2017-02-14
Penn State,Nebraska,66,82,1,-16,2017-02-14
Boise State,New Mexico,73,78,1,-5,2017-02-14
Ball State,Northern Illinois,81,72,0,9,2017-02-14
Texas,Oklahoma,66,70,1,-4,2017-02-14
Virginia Tech,Pitt,66,63,0,3,2017-02-14
Rutgers,Purdue,55,74,1,-19,2017-02-14
Dayton,Saint Louis,85,63,0,22,2017-02-14
Marist,St. Peter's,46,71,1,-25,2017-02-14
St. Joseph's,VCU,81,91,1,-10,2017-02-14
Denver,Western Illinois,78,72,0,6,2017-02-14
Bowling Green State,Western Michigan,79,89,1,-10,2017-02-14
Colorado State,Wyoming,78,73,0,5,2017-02-14
Nevada,Air Force,78,59,0,19,2017-02-15
UMBC,Albany (NY),69,78,1,-9,2017-02-15
St. John's (NY),Butler,86,110,1,-24,2017-02-15
Cal Poly,Cal State Northridge,85,71,0,14,2017-02-15
Campbell,Charleston Southern,69,72,1,-3,2017-02-15
Boston University,Colgate,69,68,0,1,2017-02-15
George Washington,Davidson,63,74,1,-11,2017-02-15
UMass,Duquesne,66,96,1,-30,2017-02-15
Temple,East Carolina,64,78,1,-14,2017-02-15
Samford,ETSU,77,79,1,-2,2017-02-15
San Jose State,Fresno State,59,77,1,-18,2017-02-15
Radford,Gardner-Webb,59,70,1,-11,2017-02-15
Stony Brook,Hartford,66,54,0,12,2017-02-15
Army,Holy Cross,52,47,0,5,2017-02-15
Texas A&M-Corpus Christi,Incarnate Word,97,81,0,16,2017-02-15
North Dakota State,Purdue-Fort Wayne,61,77,1,-16,2017-02-15
Iowa State,Kansas State,87,79,0,8,2017-02-15
American,Lafayette,65,78,1,-13,2017-02-15
Navy,Lehigh,55,74,1,-19,2017-02-15
Winthrop,Longwood,83,63,0,20,2017-02-15
Indiana State,Loyola (IL),46,64,1,-18,2017-02-15
Bucknell,Loyola (MD),77,78,1,-1,2017-02-15
Vermont,UMass-Lowell,87,66,0,21,2017-02-15
Georgia Tech,Miami (FL),61,70,1,-9,2017-02-15
Indiana,Minnesota,74,75,1,-1,2017-02-15
Alabama,Missouri,57,54,0,3,2017-02-15
Illinois State,Missouri State,67,66,0,1,2017-02-15
Maine,New Hampshire,51,64,1,-13,2017-02-15
South Carolina State,Norfolk State,70,81,1,-11,2017-02-15
Presbyterian,UNC Asheville,48,89,1,-41,2017-02-15
Wofford,UNC Greensboro,55,74,1,-19,2017-02-15
UNC,NC State,97,73,0,24,2017-02-15
Bradley,Northern Iowa,61,64,1,-3,2017-02-15
Maryland,Northwestern,74,64,0,10,2017-02-15
Xavier,Providence,63,75,1,-12,2017-02-15
Fordham,Rhode Island,53,43,0,10,2017-02-15
Creighton,Seton Hall,81,87,1,-6,2017-02-15
Arkansas,South Carolina,83,76,0,7,2017-02-15
IUPUI,South Dakota State,67,81,1,-14,2017-02-15
Cincinnati,South Florida,68,54,0,14,2017-02-15
Wichita State,Southern Illinois,87,68,0,19,2017-02-15
Tulane,SMU,75,80,1,-5,2017-02-15
La Salle,St. Bonaventure,65,83,1,-18,2017-02-15
LIU-Brooklyn,St. Francis (NY),82,45,0,37,2017-02-15
Oklahoma State,TCU,71,68,0,3,2017-02-15
San Diego State,Utah State,66,62,0,4,2017-02-15
Duke,Virginia,65,55,0,10,2017-02-15
Chattanooga,VMI,74,68,0,6,2017-02-15
Furman,Western Carolina,74,62,0,12,2017-02-15
Eastern Illinois,Austin Peay,80,85,1,-5,2017-02-16
Eastern Kentucky,Belmont,72,76,1,-4,2017-02-16
San Diego,BYU,70,82,1,-12,2017-02-16
Robert Morris,Bryant,73,81,1,-8,2017-02-16
Cal State Fullerton,UC-Riverside,56,55,0,1,2017-02-16
Hawaii,UCSB,54,56,1,-2,2017-02-16
Saint Francis (PA),Central Connecticut,80,71,0,9,2017-02-16
Northern Kentucky,Cleveland State,62,60,0,2,2017-02-16
Memphis,UConn,62,65,1,-3,2017-02-16
Drexel,Delaware,67,68,1,-1,2017-02-16
San Francisco,Gonzaga,61,96,1,-35,2017-02-16
College of Charleston,Hofstra,76,72,0,4,2017-02-16
Sam Houston State,Houston Baptist,77,88,1,-11,2017-02-16
North Dakota,Idaho State,77,61,0,16,2017-02-16
William & Mary,James Madison,92,95,1,-3,2017-02-16
Jacksonville,Kennesaw State,79,78,0,1,2017-02-16
North Florida,Lipscomb,93,82,0,11,2017-02-16
UC-Davis,Long Beach State,69,78,1,-9,2017-02-16
Florida Atlantic,Louisiana Tech,69,95,1,-26,2017-02-16
Alabama-Birmingham,Marshall,59,74,1,-15,2017-02-16
Abilene Christian,McNeese State,82,78,0,4,2017-02-16
Wisconsin,Michigan,58,64,1,-6,2017-02-16
Niagara,Monmouth,75,93,1,-18,2017-02-16
Sacramento State,Montana,67,65,0,2,2017-02-16
Portland State,Montana State,90,92,1,-2,2017-02-16
SIU-Edwardsville,Murray State,73,84,1,-11,2017-02-16
Oral Roberts,Omaha,76,83,1,-7,2017-02-16
Central Arkansas,Nicholls State,89,96,1,-7,2017-02-16
Florida Gulf Coast,NJIT,80,73,0,7,2017-02-16
UTEP,North Texas,77,71,0,6,2017-02-16
UNC Wilmington,Northeastern,66,65,0,1,2017-02-16
Southeastern Louisiana,Northwestern State,73,66,0,7,2017-02-16
Utah,Oregon,61,79,1,-18,2017-02-16
Colorado,Oregon State,60,52,0,8,2017-02-16
Pacific,Portland,76,65,0,11,2017-02-16
UTSA,Rice,68,80,1,-12,2017-02-16
Fairleigh Dickinson,Sacred Heart,81,91,1,-10,2017-02-16
Loyola Marymount,Saint Mary's,48,81,1,-33,2017-02-16
Pepperdine,Santa Clara,55,106,1,-51,2017-02-16
Grand Canyon,Seattle,61,58,0,3,2017-02-16
Manhattan,Siena,71,94,1,-23,2017-02-16
Stetson,USC Upstate,83,72,0,11,2017-02-16
Florida International,Southern Miss,66,69,1,-3,2017-02-16
Lamar,Stephen F. Austin,61,70,1,-9,2017-02-16
Morehead State,Tennessee State,52,64,1,-12,2017-02-16
Elon,Towson,66,85,1,-19,2017-02-16
Cal State Bakersfield,Utah Valley,80,71,0,9,2017-02-16
Texas A&M,Vanderbilt,67,72,1,-5,2017-02-16
Mount St. Mary's,Wagner,65,69,1,-4,2017-02-16
Arizona State,Washington,83,81,0,2,2017-02-16
Arizona,Washington State,78,59,0,19,2017-02-16
Northern Colorado,Weber State,63,69,1,-6,2017-02-16
Middle Tennessee,Western Kentucky,78,52,0,26,2017-02-16
Wright State,Youngstown State,84,81,0,3,2017-02-16
Kent State,Akron,70,67,0,3,2017-02-17
Little Rock,Arkansas State,58,67,1,-9,2017-02-17
Penn,Brown,96,72,0,24,2017-02-17
Cornell,Dartmouth,69,65,0,4,2017-02-17
UIC,Detroit,74,69,0,5,2017-02-17
Idaho,Eastern Washington,67,77,1,-10,2017-02-17
Columbia,Harvard,72,78,1,-6,2017-02-17
Iona,Marist,95,88,0,7,2017-02-17
Valparaiso,Oakland,71,82,1,-11,2017-02-17
Fairfield,Quinnipiac,89,86,0,3,2017-02-17
VCU,Richmond,84,73,0,11,2017-02-17
Canisius,Rider,85,77,0,8,2017-02-17
California,Stanford,68,73,1,-5,2017-02-17
Princeton,Yale,71,52,0,19,2017-02-17
LSU,Alabama,72,90,1,-18,2017-02-18
Alabama State,Alcorn State,67,75,1,-8,2017-02-18
Ole Miss,Arkansas,80,98,1,-18,2017-02-18
SIU-Edwardsville,Austin Peay,84,92,1,-8,2017-02-18
Kansas,Baylor,67,65,0,2,2017-02-18
Morehead State,Belmont,73,89,1,-16,2017-02-18
Hampton,Bethune-Cookman,61,62,1,-1,2017-02-18
Wyoming,Boise State,87,91,1,-4,2017-02-18
Evansville,Bradley,72,84,1,-12,2017-02-18
Saint Mary's,BYU,70,57,0,13,2017-02-18
Princeton,Brown,66,51,0,15,2017-02-18
Saint Francis (PA),Bryant,75,79,1,-4,2017-02-18
Miami (OH),Buffalo,58,71,1,-13,2017-02-18
Hawaii,Cal Poly,82,61,0,21,2017-02-18
UC-Davis,Cal State Fullerton,72,79,1,-7,2017-02-18
UC-Riverside,UC-Irvine,60,79,1,-19,2017-02-18
Long Beach State,UCSB,66,48,0,18,2017-02-18
UNC Asheville,Campbell,66,53,0,13,2017-02-18
Robert Morris,Central Connecticut,74,64,0,10,2017-02-18
Ball State,Central Michigan,109,100,0,9,2017-02-18
High Point,Charleston Southern,75,76,1,-1,2017-02-18
ETSU,Chattanooga,65,51,0,14,2017-02-18
Tulsa,Cincinnati,60,80,1,-20,2017-02-18
Mercer,Citadel,89,78,0,11,2017-02-18
Wright State,Cleveland State,74,68,0,6,2017-02-18
Columbia,Dartmouth,79,80,1,-1,2017-02-18
St. Bonaventure,Dayton,72,76,1,-4,2017-02-18
William & Mary,Delaware,85,64,0,21,2017-02-18
Missouri State,Drake,76,73,0,3,2017-02-18
Elon,Drexel,65,56,0,9,2017-02-18
Wake Forest,Duke,94,99,1,-5,2017-02-18
UCF,East Carolina,61,58,0,3,2017-02-18
Mount St. Mary's,Fairleigh Dickinson,79,74,0,5,2017-02-18
Norfolk State,Florida A&M,77,65,0,12,2017-02-18
Saint Louis,Fordham,40,54,1,-14,2017-02-18
New Mexico,Fresno State,61,71,1,-10,2017-02-18
UNC Greensboro,Furman,73,52,0,21,2017-02-18
Rhode Island,George Mason,77,74,0,3,2017-02-18
Kentucky,Georgia,82,77,0,5,2017-02-18
Texas State,Georgia Southern,67,70,1,-3,2017-02-18
Texas-Arlington,Georgia State,68,67,0,1,2017-02-18
Pacific,Gonzaga,61,82,1,-21,2017-02-18
Cornell,Harvard,75,87,1,-12,2017-02-18
UNC Wilmington,Hofstra,83,76,0,7,2017-02-18
SMU,Houston,76,66,0,10,2017-02-18
Hillsdale,Houston Baptist,78,92,1,-14,2017-02-18
North Carolina A&T,Howard,53,84,1,-31,2017-02-18
Northern Colorado,Idaho State,87,81,0,6,2017-02-18
Sam Houston State,Incarnate Word,53,69,1,-16,2017-02-18
Illinois,Iowa,70,66,0,4,2017-02-18
TCU,Iowa State,71,84,1,-13,2017-02-18
South Dakota State,Purdue-Fort Wayne,97,89,0,8,2017-02-18
Grambling,Jackson State,62,59,0,3,2017-02-18
Tennessee Tech,Jacksonville State,79,78,0,1,2017-02-18
North Florida,Kennesaw State,68,85,1,-17,2017-02-18
St. Joseph's,La Salle,68,83,1,-15,2017-02-18
Jacksonville,Lipscomb,69,81,1,-12,2017-02-18
Sacred Heart,LIU-Brooklyn,82,83,1,-1,2017-02-18
Louisiana,Louisiana-Monroe,85,84,0,1,2017-02-18
Florida International,Louisiana Tech,61,77,1,-16,2017-02-18
Virginia Tech,Louisville,90,94,1,-4,2017-02-18
Pepperdine,Loyola Marymount,61,82,1,-21,2017-02-18
Xavier,Marquette,61,83,1,-22,2017-02-18
Middle Tennessee,Marshall,97,86,0,11,2017-02-18
UMass-Lowell,UMBC,102,108,1,-6,2017-02-18
North Carolina Central,Maryland-Eastern Shore,82,69,0,13,2017-02-18
Davidson,UMass,79,74,0,5,2017-02-18
Clemson,Miami (FL),65,71,1,-6,2017-02-18
Green Bay,Milwaukee,80,56,0,24,2017-02-18
Florida,Mississippi State,57,52,0,5,2017-02-18
Chicago State,UMKC,65,84,1,-19,2017-02-18
Portland State,Montana,82,85,1,-3,2017-02-18
Sacramento State,Montana State,59,62,1,-3,2017-02-18
Savannah State,Morgan State,75,83,1,-8,2017-02-18
Eastern Illinois,Murray State,82,65,0,17,2017-02-18
Army,Navy,71,68,0,3,2017-02-18
Utah State,Nevada,66,77,1,-11,2017-02-18
Hartford,New Hampshire,52,82,1,-30,2017-02-18
Central Arkansas,New Orleans,61,84,1,-23,2017-02-18
Northwestern State,Nicholls State,80,78,0,2,2017-02-18
Stetson,NJIT,56,60,1,-4,2017-02-18
Virginia,UNC,41,65,1,-24,2017-02-18
Notre Dame,NC State,81,72,0,9,2017-02-18
Western Illinois,North Dakota State,91,100,1,-9,2017-02-18
UTSA,North Texas,73,83,1,-10,2017-02-18
College of Charleston,Northeastern,85,71,0,14,2017-02-18
Toledo,Northern Illinois,88,80,0,8,2017-02-18
Rutgers,Northwestern,65,69,1,-4,2017-02-18
Bowling Green State,Ohio,75,95,1,-20,2017-02-18
Nebraska,Ohio State,58,57,0,1,2017-02-18
Oklahoma,Oklahoma State,92,96,1,-4,2017-02-18
Charlotte,Old Dominion,48,72,1,-24,2017-02-18
Colorado,Oregon,73,101,1,-28,2017-02-18
Florida State,Pitt,66,80,1,-14,2017-02-18
San Francisco,Portland,65,51,0,14,2017-02-18
Mississippi Valley State,Prairie View,69,82,1,-13,2017-02-18
Gardner-Webb,Presbyterian,84,56,0,28,2017-02-18
Michigan State,Purdue,63,80,1,-17,2017-02-18
Longwood,Radford,72,79,1,-7,2017-02-18
UTEP,Rice,79,71,0,8,2017-02-18
VMI,Samford,61,80,1,-19,2017-02-18
Air Force,San Jose State,78,83,1,-5,2017-02-18
San Diego,Santa Clara,60,58,0,2,2017-02-18
Cal State Bakersfield,Seattle,51,48,0,3,2017-02-18
Villanova,Seton Hall,92,70,0,22,2017-02-18
Niagara,Siena,70,76,1,-6,2017-02-18
Appalachian State,South Alabama,74,87,1,-13,2017-02-18
Coppin State,South Carolina State,79,84,1,-5,2017-02-18
Florida Gulf Coast,USC Upstate,97,89,0,8,2017-02-18
Oral Roberts,South Dakota,72,86,1,-14,2017-02-18
UT-Martin,Southeast Missouri State,61,90,1,-29,2017-02-18
Stephen F. Austin,Southeastern Louisiana,60,52,0,8,2017-02-18
Alabama A&M,Southern,64,77,1,-13,2017-02-18
Florida Atlantic,Southern Miss,94,82,0,12,2017-02-18
Northern Arizona,Southern Utah,68,84,1,-16,2017-02-18
Wagner,St. Francis (NY),73,55,0,18,2017-02-18
Binghamton,Stony Brook,55,76,1,-21,2017-02-18
Missouri,Tennessee,70,90,1,-20,2017-02-18
Eastern Kentucky,Tennessee State,66,68,1,-2,2017-02-18
Kansas State,Texas,64,61,0,3,2017-02-18
Auburn,Texas A&M,62,81,1,-19,2017-02-18
Lamar,Texas A&M-Corpus Christi,63,70,1,-7,2017-02-18
New Mexico State,Texas-Rio Grande Valley,107,101,0,6,2017-02-18
Arkansas-Pine Bluff,Texas Southern,40,78,1,-38,2017-02-18
James Madison,Towson,65,75,1,-10,2017-02-18
Coastal Carolina,Troy,78,87,1,-9,2017-02-18
South Florida,Tulane,71,94,1,-23,2017-02-18
USC,UCLA,70,102,1,-32,2017-02-18
Grand Canyon,Utah Valley,77,71,0,6,2017-02-18
South Carolina,Vanderbilt,62,71,1,-9,2017-02-18
Arizona,Washington,76,68,0,8,2017-02-18
Arizona State,Washington State,71,86,1,-15,2017-02-18
North Dakota,Weber State,77,68,0,9,2017-02-18
Texas Tech,West Virginia,74,83,1,-9,2017-02-18
Eastern Michigan,Western Michigan,80,88,1,-8,2017-02-18
Northern Iowa,Wichita State,44,73,1,-29,2017-02-18
Liberty,Winthrop,67,84,1,-17,2017-02-18
Western Carolina,Wofford,56,84,1,-28,2017-02-18
Northern Kentucky,Youngstown State,77,81,1,-4,2017-02-18
Holy Cross,American,69,54,0,15,2017-02-19
Bucknell,Boston University,86,66,0,20,2017-02-19
DePaul,Butler,66,82,1,-16,2017-02-19
Georgetown,Creighton,70,87,1,-17,2017-02-19
IUPUI,Denver,83,72,0,11,2017-02-19
Valparaiso,Detroit,83,63,0,20,2017-02-19
George Washington,Duquesne,77,70,0,7,2017-02-19
Syracuse,Georgia Tech,65,71,1,-6,2017-02-19
Loyola (IL),Illinois State,63,65,1,-2,2017-02-19
Southern Illinois,Indiana State,74,68,0,6,2017-02-19
Rider,Iona,103,85,0,18,2017-02-19
Lehigh,Lafayette,81,55,0,26,2017-02-19
Colgate,Loyola (MD),66,56,0,10,2017-02-19
Albany (NY),Maine,74,56,0,18,2017-02-19
Quinnipiac,Manhattan,74,95,1,-21,2017-02-19
Canisius,Marist,74,76,1,-2,2017-02-19
Michigan,Minnesota,78,83,1,-5,2017-02-19
UIC,Oakland,75,87,1,-12,2017-02-19
Utah,Oregon State,67,68,1,-1,2017-02-19
Fairfield,St. Peter's,55,74,1,-19,2017-02-19
UNLV,San Diego State,64,77,1,-13,2017-02-19
UConn,Temple,64,63,0,1,2017-02-19
Alabama-Birmingham,Western Kentucky,64,76,1,-12,2017-02-19
Maryland,Wisconsin,60,71,1,-11,2017-02-19
Penn,Yale,71,55,0,16,2017-02-19
Alabama A&M,Alcorn State,59,74,1,-15,2017-02-20
Norfolk State,Bethune-Cookman,65,75,1,-10,2017-02-20
Morgan State,Delaware State,65,54,0,11,2017-02-20
Hampton,Florida A&M,76,69,0,7,2017-02-20
Boston College,Florida State,72,104,1,-32,2017-02-20
Texas-Arlington,Georgia Southern,81,71,0,10,2017-02-20
Texas State,Georgia State,51,67,1,-16,2017-02-20
North Carolina Central,Howard,66,59,0,7,2017-02-20
North Carolina A&T,Maryland-Eastern Shore,95,106,1,-11,2017-02-20
Walla Walla,Portland,58,96,1,-38,2017-02-20
Arkansas-Pine Bluff,Prairie View,55,73,1,-18,2017-02-20
Coppin State,Savannah State,84,83,0,1,2017-02-20
Coastal Carolina,South Alabama,81,77,0,4,2017-02-20
Alabama State,Southern,73,79,1,-6,2017-02-20
Mississippi Valley State,Texas Southern,61,92,1,-31,2017-02-20
Iowa State,Texas Tech,82,80,0,2,2017-02-20
Appalachian State,Troy,66,76,1,-10,2017-02-20
Miami (FL),Virginia,54,48,0,6,2017-02-20
Texas,West Virginia,62,77,1,-15,2017-02-20
Eastern Michigan,Ball State,72,79,1,-7,2017-02-21
Oklahoma,Baylor,54,60,1,-6,2017-02-21
Trevecca Nazarene,Belmont,45,96,1,-51,2017-02-21
Akron,Bowling Green State,65,66,1,-1,2017-02-21
Kent State,Buffalo,77,69,0,8,2017-02-21
Northern Illinois,Central Michigan,89,66,0,23,2017-02-21
George Mason,Dayton,70,83,1,-13,2017-02-21
Cleveland State,Detroit,83,91,1,-8,2017-02-21
Monmouth,Fairfield,82,62,0,20,2017-02-21
South Carolina,Florida,66,81,1,-15,2017-02-21
NC State,Georgia Tech,71,69,0,2,2017-02-21
Northwestern,Illinois,50,66,1,-16,2017-02-21
Green Bay,UIC,87,79,0,8,2017-02-21
Indiana,Iowa,90,96,1,-6,2017-02-21
Rhode Island,La Salle,67,56,0,11,2017-02-21
Auburn,LSU,98,75,0,23,2017-02-21
St. John's (NY),Marquette,71,93,1,-22,2017-02-21
Ohio,Miami (OH),79,62,0,17,2017-02-21
Ole Miss,Mississippi State,87,82,0,5,2017-02-21
Kentucky,Missouri,72,62,0,10,2017-02-21
Colorado State,New Mexico,68,56,0,12,2017-02-21
Wright State,Northern Kentucky,76,83,1,-7,2017-02-21
Youngstown State,Oakland,72,101,1,-29,2017-02-21
Purdue,Penn State,74,70,0,4,2017-02-21
Davidson,Richmond,76,84,1,-8,2017-02-21
Western Michigan,Toledo,61,56,0,5,2017-02-21
East Carolina,Tulane,76,73,0,3,2017-02-21
Milwaukee,Valparaiso,61,67,1,-6,2017-02-21
Clemson,Virginia Tech,70,71,1,-1,2017-02-21
Evansville,Wichita State,83,109,1,-26,2017-02-21
Texas A&M-Corpus Christi,Abilene Christian,56,44,0,12,2017-02-22
UNLV,Air Force,58,81,1,-23,2017-02-22
Texas A&M,Arkansas,77,86,1,-9,2017-02-22
Boston University,Army,62,73,1,-11,2017-02-22
Missouri State,Bradley,68,77,1,-9,2017-02-22
Lafayette,Bucknell,64,94,1,-30,2017-02-22
UC-Irvine,Cal State Fullerton,54,56,1,-2,2017-02-22
Oregon,California,68,65,0,3,2017-02-22
Western Carolina,Citadel,84,80,0,4,2017-02-22
Providence,Creighton,68,66,0,2,2017-02-22
Omaha,Denver,84,83,0,1,2017-02-22
Fordham,Duquesne,70,52,0,18,2017-02-22
Furman,ETSU,81,93,1,-12,2017-02-22
DePaul,Georgetown,67,65,0,2,2017-02-22
Binghamton,Hartford,69,76,1,-7,2017-02-22
Loyola (MD),Holy Cross,62,63,1,-1,2017-02-22
UConn,Houston,70,75,1,-5,2017-02-22
Southern Illinois,Illinois State,46,50,1,-4,2017-02-22
Northern Iowa,Indiana State,59,69,1,-10,2017-02-22
TCU,Kansas,68,87,1,-19,2017-02-22
Oklahoma State,Kansas State,80,68,0,12,2017-02-22
Colgate,Lehigh,69,87,1,-18,2017-02-22
Drake,Loyola (IL),65,80,1,-15,2017-02-22
Minnesota,Maryland,89,75,0,14,2017-02-22
Stony Brook,UMBC,52,65,1,-13,2017-02-22
New Hampshire,UMass-Lowell,78,67,0,11,2017-02-22
UNC Greensboro,Mercer,72,66,0,6,2017-02-22
American,Navy,74,58,0,16,2017-02-22
Boise State,Nevada,77,85,1,-8,2017-02-22
Louisville,UNC,63,74,1,-11,2017-02-22
Lamar,Northwestern State,88,68,0,20,2017-02-22
North Dakota State,Oral Roberts,82,80,0,2,2017-02-22
Manhattan,Rider,82,93,1,-11,2017-02-22
Michigan,Rutgers,68,64,0,4,2017-02-22
St. Bonaventure,St. Joseph's,83,77,0,6,2017-02-22
Chattanooga,Samford,68,72,1,-4,2017-02-22
Fresno State,San Diego State,63,55,0,8,2017-02-22
Utah State,San Jose State,81,75,0,6,2017-02-22
Xavier,Seton Hall,64,71,1,-7,2017-02-22
Central Arkansas,Southeastern Louisiana,70,87,1,-17,2017-02-22
Oregon State,Stanford,66,79,1,-13,2017-02-22
Duke,Syracuse,75,78,1,-3,2017-02-22
UCF,Temple,71,69,0,2,2017-02-22
Vanderbilt,Tennessee,67,56,0,11,2017-02-22
Albany (NY),Vermont,50,62,1,-12,2017-02-22
Butler,Villanova,74,66,0,8,2017-02-22
Saint Louis,VCU,50,64,1,-14,2017-02-22
Wofford,VMI,81,63,0,18,2017-02-22
Pitt,Wake Forest,59,63,1,-4,2017-02-22
Georgia,Alabama,60,55,0,5,2017-02-23
USC,Arizona,77,90,1,-13,2017-02-23
UCLA,Arizona State,87,75,0,12,2017-02-23
UMKC,Cal State Bakersfield,62,71,1,-9,2017-02-23
Cal State Northridge,UC-Davis,85,96,1,-11,2017-02-23
UC-Riverside,UCSB,61,68,1,-7,2017-02-23
St. Francis (NY),Central Connecticut,53,62,1,-9,2017-02-23
Western Kentucky,Charlotte,77,83,1,-6,2017-02-23
Memphis,Cincinnati,74,87,1,-13,2017-02-23
Delaware,College of Charleston,65,78,1,-13,2017-02-23
Utah,Colorado,86,81,0,5,2017-02-23
James Madison,Drexel,70,64,0,6,2017-02-23
Jacksonville State,Eastern Kentucky,65,68,1,-3,2017-02-23
Weber State,Eastern Washington,72,82,1,-10,2017-02-23
Northeastern,Elon,105,104,0,1,2017-02-23
UTEP,Florida Atlantic,60,55,0,5,2017-02-23
Stetson,Florida Gulf Coast,70,80,1,-10,2017-02-23
UTSA,Florida International,69,67,0,2,2017-02-23
UNC Asheville,Gardner-Webb,76,81,1,-5,2017-02-23
UMass,George Washington,67,83,1,-16,2017-02-23
Chicago State,Grand Canyon,59,82,1,-23,2017-02-23
Campbell,High Point,49,59,1,-10,2017-02-23
Idaho State,Idaho,61,69,1,-8,2017-02-23
Nicholls State,Incarnate Word,77,68,0,9,2017-02-23
Purdue-Fort Wayne,IUPUI,82,83,1,-1,2017-02-23
Lipscomb,Kennesaw State,85,74,0,11,2017-02-23
Longwood,Liberty,45,61,1,-16,2017-02-23
Cal Poly,Long Beach State,78,71,0,7,2017-02-23
San Francisco,Loyola Marymount,51,53,1,-2,2017-02-23
Quinnipiac,Marist,74,87,1,-13,2017-02-23
Houston Baptist,McNeese State,81,79,0,2,2017-02-23
Nebraska,Michigan State,72,88,1,-16,2017-02-23
Tennessee Tech,Morehead State,68,73,1,-5,2017-02-23
LIU-Brooklyn,Mount St. Mary's,62,58,0,4,2017-02-23
Utah Valley,New Mexico State,84,72,0,12,2017-02-23
Stephen F. Austin,New Orleans,65,82,1,-17,2017-02-23
USC Upstate,NJIT,87,88,1,-1,2017-02-23
Towson,UNC Wilmington,78,83,1,-5,2017-02-23
Jacksonville,North Florida,69,73,1,-4,2017-02-23
Louisiana Tech,North Texas,85,67,0,18,2017-02-23
Wisconsin,Ohio State,73,83,1,-10,2017-02-23
Marshall,Old Dominion,65,86,1,-21,2017-02-23
Saint Mary's,Pepperdine,78,49,0,29,2017-02-23
BYU,Portland,97,78,0,19,2017-02-23
Southern Utah,Portland State,86,93,1,-7,2017-02-23
Presbyterian,Radford,57,59,1,-2,2017-02-23
Southern Miss,Rice,71,72,1,-1,2017-02-23
Fairleigh Dickinson,Robert Morris,76,77,1,-1,2017-02-23
Northern Arizona,Sacramento State,73,69,0,4,2017-02-23
Sacred Heart,Saint Francis (PA),64,73,1,-9,2017-02-23
Gonzaga,San Diego,96,38,0,58,2017-02-23
Pacific,Santa Clara,68,69,1,-1,2017-02-23
Murray State,Southeast Missouri State,69,82,1,-13,2017-02-23
Austin Peay,UT-Martin,72,76,1,-4,2017-02-23
Seattle,Texas-Rio Grande Valley,86,77,0,9,2017-02-23
South Florida,Tulsa,68,82,1,-14,2017-02-23
Bryant,Wagner,66,69,1,-3,2017-02-23
South Dakota,Western Illinois,92,81,0,11,2017-02-23
Hofstra,William & Mary,96,82,0,14,2017-02-23
Charleston Southern,Winthrop,72,86,1,-14,2017-02-23
Akron,Buffalo,89,83,0,6,2017-02-24
Oregon State,California,46,76,1,-30,2017-02-24
Fairfield,Canisius,58,55,0,3,2017-02-24
Princeton,Columbia,64,45,0,19,2017-02-24
Penn,Cornell,69,66,0,3,2017-02-24
Brown,Dartmouth,80,75,0,5,2017-02-24
Dayton,Davidson,89,82,0,7,2017-02-24
Oakland,Green Bay,85,72,0,13,2017-02-24
Yale,Harvard,64,77,1,-13,2017-02-24
Manhattan,Iona,51,72,1,-21,2017-02-24
Detroit,Milwaukee,81,74,0,7,2017-02-24
Siena,Monmouth,73,77,1,-4,2017-02-24
St. Peter's,Niagara,66,53,0,13,2017-02-24
UIC,Northern Kentucky,82,90,1,-8,2017-02-24
Central Michigan,Toledo,66,87,1,-21,2017-02-24
Valparaiso,Wright State,84,74,0,10,2017-02-24
Prairie View,Alabama A&M,74,87,1,-13,2017-02-25
Texas Southern,Alabama State,86,73,0,13,2017-02-25
Hartford,Albany (NY),62,80,1,-18,2017-02-25
Louisiana-Monroe,Appalachian State,75,64,0,11,2017-02-25
UCLA,Arizona,77,72,0,5,2017-02-25
Georgia State,Little Rock,71,54,0,17,2017-02-25
Grambling,Arkansas-Pine Bluff,78,58,0,20,2017-02-25
Georgia Southern,Arkansas State,72,60,0,12,2017-02-25
Arkansas,Auburn,79,68,0,11,2017-02-25
Tennessee State,Belmont,63,68,1,-5,2017-02-25
Maine,Binghamton,72,71,0,1,2017-02-25
San Jose State,Boise State,78,85,1,-7,2017-02-25
Virginia Tech,Boston College,91,75,0,16,2017-02-25
Central Connecticut,Bryant,77,91,1,-14,2017-02-25
Navy,Bucknell,60,82,1,-22,2017-02-25
Chicago State,Cal State Bakersfield,49,69,1,-20,2017-02-25
Long Beach State,UC-Davis,71,75,1,-4,2017-02-25
Cal State Northridge,UC-Irvine,80,83,1,-3,2017-02-25
Cal Poly,UC-Riverside,84,77,0,7,2017-02-25
Radford,Campbell,58,61,1,-3,2017-02-25
Stephen F. Austin,Central Arkansas,90,85,0,5,2017-02-25
Marshall,Charlotte,93,89,0,4,2017-02-25
Mercer,Chattanooga,64,54,0,10,2017-02-25
Florida State,Clemson,76,74,0,2,2017-02-25
Youngstown State,Cleveland State,55,69,1,-14,2017-02-25
Louisiana,Coastal Carolina,79,77,0,2,2017-02-25
Lafayette,Colgate,73,69,0,4,2017-02-25
Drexel,College of Charleston,67,80,1,-13,2017-02-25
San Diego State,Colorado State,55,56,1,-1,2017-02-25
Penn,Columbia,67,70,1,-3,2017-02-25
SMU,UConn,69,61,0,8,2017-02-25
Princeton,Cornell,75,60,0,15,2017-02-25
Yale,Dartmouth,99,86,0,13,2017-02-25
Maryland-Eastern Shore,Delaware State,65,64,0,1,2017-02-25
Seton Hall,DePaul,82,79,0,3,2017-02-25
Bradley,Drake,82,74,0,8,2017-02-25
Tennessee Tech,Eastern Kentucky,71,75,1,-4,2017-02-25
Northern Illinois,Eastern Michigan,68,84,1,-16,2017-02-25
Idaho State,Eastern Washington,77,89,1,-12,2017-02-25
Delaware,Elon,59,81,1,-22,2017-02-25
Indiana State,Evansville,63,65,1,-2,2017-02-25
UTSA,Florida Atlantic,66,73,1,-7,2017-02-25
UTEP,Florida International,90,76,0,14,2017-02-25
Richmond,Fordham,70,48,0,22,2017-02-25
Wofford,Furman,69,78,1,-9,2017-02-25
LSU,Georgia,80,82,1,-2,2017-02-25
BYU,Gonzaga,79,71,0,8,2017-02-25
UMKC,Grand Canyon,77,84,1,-7,2017-02-25
Brown,Harvard,58,77,1,-19,2017-02-25
Cal State Fullerton,Hawaii,58,64,1,-6,2017-02-25
Gardner-Webb,High Point,88,86,0,2,2017-02-25
Boston University,Holy Cross,71,68,0,3,2017-02-25
Weber State,Idaho,78,83,1,-5,2017-02-25
Northwestern,Indiana,62,63,1,-1,2017-02-25
Baylor,Iowa State,69,72,1,-3,2017-02-25
South Dakota,IUPUI,92,85,0,7,2017-02-25
Hofstra,James Madison,71,66,0,5,2017-02-25
Ohio,Kent State,67,70,1,-3,2017-02-25
Florida,Kentucky,66,76,1,-10,2017-02-25
Houston Baptist,Lamar,75,68,0,7,2017-02-25
Army,Lehigh,69,83,1,-14,2017-02-25
Charleston Southern,Longwood,86,78,0,8,2017-02-25
American,Loyola (MD),64,62,0,2,2017-02-25
Iowa,Maryland,83,69,0,14,2017-02-25
Duke,Miami (FL),50,55,1,-5,2017-02-25
Bowling Green State,Miami (OH),70,54,0,16,2017-02-25
Purdue,Michigan,70,82,1,-12,2017-02-25
Penn State,Minnesota,71,81,1,-10,2017-02-25
Missouri,Ole Miss,77,80,1,-3,2017-02-25
Jackson State,Mississippi Valley State,67,70,1,-3,2017-02-25
Wichita State,Missouri State,86,67,0,19,2017-02-25
Montana,Montana State,69,78,1,-9,2017-02-25
Jacksonville State,Morehead State,70,61,0,9,2017-02-25
Hampton,Morgan State,70,77,1,-7,2017-02-25
St. Francis (NY),Mount St. Mary's,62,77,1,-15,2017-02-25
North Dakota State,Omaha,92,96,1,-4,2017-02-25
Nevada,UNLV,94,58,0,36,2017-02-25
UMBC,New Hampshire,90,94,1,-4,2017-02-25
Seattle,New Mexico State,53,86,1,-33,2017-02-25
Southeastern Louisiana,Nicholls State,71,77,1,-6,2017-02-25
Howard,Norfolk State,65,73,1,-8,2017-02-25
Liberty,UNC Asheville,45,63,1,-18,2017-02-25
Savannah State,North Carolina A&T,110,91,0,19,2017-02-25
Bethune-Cookman,North Carolina Central,63,78,1,-15,2017-02-25
VMI,UNC Greensboro,67,74,1,-7,2017-02-25
Virginia,NC State,70,55,0,15,2017-02-25
Northeastern,UNC Wilmington,65,74,1,-9,2017-02-25
Southern Miss,North Texas,76,53,0,23,2017-02-25
North Dakota,Northern Colorado,84,81,0,3,2017-02-25
Illinois State,Northern Iowa,63,42,0,21,2017-02-25
New Orleans,Northwestern State,82,83,1,-1,2017-02-25
Kansas State,Oklahoma,51,81,1,-30,2017-02-25
Texas Tech,Oklahoma State,63,80,1,-17,2017-02-25
Western Kentucky,Old Dominion,53,67,1,-14,2017-02-25
Loyola Marymount,Pacific,67,66,0,1,2017-02-25
San Francisco,Pepperdine,76,65,0,11,2017-02-25
UNC,Pitt,85,67,0,18,2017-02-25
Northern Arizona,Portland State,72,84,1,-12,2017-02-25
Winthrop,Presbyterian,93,56,0,37,2017-02-25
Marquette,Providence,69,73,1,-4,2017-02-25
VCU,Rhode Island,59,69,1,-10,2017-02-25
Louisiana Tech,Rice,81,88,1,-7,2017-02-25
Sacred Heart,Robert Morris,72,79,1,-7,2017-02-25
Southern Utah,Sacramento State,76,86,1,-10,2017-02-25
Fairleigh Dickinson,Saint Francis (PA),64,70,1,-6,2017-02-25
St. Joseph's,Saint Louis,60,61,1,-1,2017-02-25
Santa Clara,Saint Mary's,56,70,1,-14,2017-02-25
Abilene Christian,Sam Houston State,84,81,0,3,2017-02-25
Citadel,Samford,102,96,0,6,2017-02-25
Portland,San Diego,82,85,1,-3,2017-02-25
Tennessee,South Carolina,55,82,1,-27,2017-02-25
Florida A&M,South Carolina State,64,75,1,-11,2017-02-25
Denver,South Dakota State,64,88,1,-24,2017-02-25
Austin Peay,Southeast Missouri State,88,79,0,9,2017-02-25
Alcorn State,Southern,68,67,0,1,2017-02-25
Loyola (IL),Southern Illinois,70,72,1,-2,2017-02-25
Eastern Illinois,SIU-Edwardsville,59,78,1,-19,2017-02-25
Duquesne,St. Bonaventure,77,80,1,-3,2017-02-25
Georgetown,St. John's (NY),80,86,1,-6,2017-02-25
Oregon,Stanford,75,73,0,2,2017-02-25
Tulane,Temple,76,86,1,-10,2017-02-25
Murray State,UT-Martin,76,83,1,-7,2017-02-25
Kansas,Texas,77,67,0,10,2017-02-25
Alabama,Texas A&M,53,56,1,-3,2017-02-25
McNeese State,Texas A&M-Corpus Christi,70,81,1,-11,2017-02-25
South Alabama,Texas-Arlington,75,86,1,-11,2017-02-25
West Virginia,TCU,61,60,0,1,2017-02-25
Utah Valley,Texas-Rio Grande Valley,88,68,0,20,2017-02-25
Troy,Texas State,59,63,1,-4,2017-02-25
Air Force,Utah State,58,89,1,-31,2017-02-25
Mississippi State,Vanderbilt,48,77,1,-29,2017-02-25
Stony Brook,Vermont,51,66,1,-15,2017-02-25
Creighton,Villanova,63,79,1,-16,2017-02-25
LIU-Brooklyn,Wagner,88,84,0,4,2017-02-25
ETSU,Western Carolina,68,52,0,16,2017-02-25
Purdue-Fort Wayne,Western Illinois,96,92,0,4,2017-02-25
Ball State,Western Michigan,55,80,1,-25,2017-02-25
Towson,William & Mary,79,83,1,-4,2017-02-25
New Mexico,Wyoming,71,82,1,-11,2017-02-25
Middle Tennessee,Alabama-Birmingham,66,64,0,2,2017-02-26
USC,Arizona State,82,83,1,-1,2017-02-26
St. Peter's,Canisius,72,65,0,7,2017-02-26
Cincinnati,UCF,49,53,1,-4,2017-02-26
George Mason,George Washington,74,83,1,-9,2017-02-26
Detroit,Green Bay,81,89,1,-8,2017-02-26
Monmouth,Iona,79,73,0,6,2017-02-26
Syracuse,Louisville,68,88,1,-20,2017-02-26
La Salle,UMass,71,84,1,-13,2017-02-26
Houston,Memphis,72,71,0,1,2017-02-26
Wisconsin,Michigan State,74,84,1,-10,2017-02-26
Oakland,Milwaukee,86,75,0,11,2017-02-26
Illinois,Nebraska,73,57,0,16,2017-02-26
Fairfield,Niagara,62,58,0,4,2017-02-26
Valparaiso,Northern Kentucky,78,82,1,-4,2017-02-26
Georgia Tech,Notre Dame,60,64,1,-4,2017-02-26
Rider,Quinnipiac,99,82,0,17,2017-02-26
Marist,Siena,64,80,1,-16,2017-02-26
East Carolina,Tulsa,66,74,1,-8,2017-02-26
Washington,Washington State,71,79,1,-8,2017-02-26
UIC,Wright State,49,87,1,-38,2017-02-26
Butler,Xavier,88,79,0,9,2017-02-26
Texas Southern,Alabama A&M,74,64,0,10,2017-02-27
Prairie View,Alabama State,77,58,0,19,2017-02-27
Louisiana,Appalachian State,77,62,0,15,2017-02-27
Georgia Southern,Little Rock,54,56,1,-2,2017-02-27
Jackson State,Arkansas-Pine Bluff,62,51,0,11,2017-02-27
Georgia State,Arkansas State,67,78,1,-11,2017-02-27
West Virginia,Baylor,62,71,1,-9,2017-02-27
Chattanooga,Citadel,76,85,1,-9,2017-02-27
Louisiana-Monroe,Coastal Carolina,72,77,1,-5,2017-02-27
Stetson,Florida Gulf Coast,57,87,1,-30,2017-02-27
Norfolk State,Hampton,59,63,1,-4,2017-02-27
Maryland-Eastern Shore,Howard,69,79,1,-10,2017-02-27
Oklahoma,Kansas,63,73,1,-10,2017-02-27
NJIT,Lipscomb,66,97,1,-31,2017-02-27
Samford,Mercer,79,88,1,-9,2017-02-27
Grambling,Mississippi Valley State,80,84,1,-4,2017-02-27
Coppin State,Morgan State,66,71,1,-5,2017-02-27
Bethune-Cookman,North Carolina A&T,73,70,0,3,2017-02-27
Savannah State,North Carolina Central,74,73,0,1,2017-02-27
ETSU,UNC Greensboro,66,72,1,-6,2017-02-27
Jacksonville,North Florida,74,77,1,-3,2017-02-27
Kennesaw State,USC Upstate,80,78,0,2,2017-02-27
Troy,Texas-Arlington,67,82,1,-15,2017-02-27
South Alabama,Texas State,64,90,1,-26,2017-02-27
UNC,Virginia,43,53,1,-10,2017-02-27
Miami (FL),Virginia Tech,61,66,1,-5,2017-02-27
VMI,Western Carolina,68,81,1,-13,2017-02-27
Miami (OH),Akron,79,75,0,4,2017-02-28
American,Army,58,74,1,-16,2017-02-28
Fresno State,Boise State,74,67,0,7,2017-02-28
Kent State,Bowling Green State,74,67,0,7,2017-02-28
Presbyterian,Campbell,62,81,1,-19,2017-02-28
Eastern Michigan,Central Michigan,109,81,0,28,2017-02-28
Longwood,Charleston Southern,74,79,1,-5,2017-02-28
Wyoming,Colorado State,76,78,1,-2,2017-02-28
St. John's (NY),Creighton,68,82,1,-14,2017-02-28
St. Bonaventure,Davidson,63,68,1,-5,2017-02-28
Florida State,Duke,70,75,1,-5,2017-02-28
Pitt,Georgia Tech,52,61,1,-9,2017-02-28
Oklahoma State,Iowa State,83,86,1,-3,2017-02-28
Vanderbilt,Kentucky,67,73,1,-6,2017-02-28
Lafayette,Loyola (MD),64,67,1,-3,2017-02-28
Texas A&M,Missouri,60,43,0,17,2017-02-28
Western Michigan,Northern Illinois,70,56,0,14,2017-02-28
Buffalo,Ohio,83,79,0,4,2017-02-28
Ohio State,Penn State,71,70,0,1,2017-02-28
DePaul,Providence,64,73,1,-9,2017-02-28
Indiana,Purdue,75,86,1,-11,2017-02-28
Maryland,Rutgers,79,59,0,20,2017-02-28
Georgetown,Seton Hall,59,62,1,-3,2017-02-28
Mississippi State,South Carolina,57,63,1,-6,2017-02-28
Ball State,Toledo,82,74,0,8,2017-02-28
Incarnate Word,Abilene Christian,89,75,0,14,2017-03-01
Ole Miss,Alabama,55,70,1,-15,2017-03-01
Hartford,Albany (NY),71,100,1,-29,2017-03-01
UC-Irvine,UC-Riverside,68,56,0,12,2017-03-01
NC State,Clemson,74,78,1,-4,2017-03-01
VCU,Dayton,72,79,1,-7,2017-03-01
UConn,East Carolina,62,66,1,-4,2017-03-01
Arkansas,Florida,65,78,1,-13,2017-03-01
George Washington,Fordham,67,66,0,1,2017-03-01
Duquesne,George Mason,62,63,1,-1,2017-03-01
Auburn,Georgia,78,79,1,-1,2017-03-01
Texas A&M-Corpus Christi,Houston Baptist,80,94,1,-14,2017-03-01
Michigan State,Illinois,70,73,1,-3,2017-03-01
Robert Morris,LIU-Brooklyn,69,68,0,1,2017-03-01
Tennessee,LSU,82,92,1,-10,2017-03-01
Richmond,UMass,75,64,0,11,2017-03-01
Sacred Heart,Mount St. Mary's,73,76,1,-3,2017-03-01
Utah State,UNLV,59,66,1,-7,2017-03-01
UMBC,New Hampshire,65,74,1,-9,2017-03-01
Michigan,Northwestern,65,67,1,-2,2017-03-01
Boston College,Notre Dame,66,82,1,-16,2017-03-01
Bryant,Saint Francis (PA),78,100,1,-22,2017-03-01
Rhode Island,St. Joseph's,68,49,0,19,2017-03-01
La Salle,Saint Louis,55,70,1,-15,2017-03-01
Air Force,San Diego State,38,51,1,-13,2017-03-01
Nevada,San Jose State,82,67,0,15,2017-03-01
Tennessee State,Southeast Missouri State,75,78,1,-3,2017-03-01
Washington State,USC,64,87,1,-23,2017-03-01
Binghamton,Stony Brook,60,70,1,-10,2017-03-01
Murray State,Tennessee Tech,85,84,0,1,2017-03-01
Kansas State,TCU,75,74,0,1,2017-03-01
Texas,Texas Tech,57,67,1,-10,2017-03-01
Washington,UCLA,66,98,1,-32,2017-03-01
Maine,Vermont,41,86,1,-45,2017-03-01
Fairleigh Dickinson,Wagner,70,72,1,-2,2017-03-01
Louisville,Wake Forest,81,88,1,-7,2017-03-01
Marquette,Xavier,95,84,0,11,2017-03-01
Florida Atlantic,Alabama-Birmingham,59,79,1,-20,2017-03-02
Bucknell,Army,78,62,0,16,2017-03-02
Florida A&M,Bethune-Cookman,59,69,1,-10,2017-03-02
Drake,Bradley,58,67,1,-9,2017-03-02
Cal State Northridge,Cal Poly,70,76,1,-6,2017-03-02
UCSB,Cal State Fullerton,54,65,1,-11,2017-03-02
Hawaii,UC-Davis,59,68,1,-9,2017-03-02
UNC Asheville,Campbell,79,81,1,-2,2017-03-02
Marist,Canisius,73,77,1,-4,2017-03-02
Winthrop,Charleston Southern,92,78,0,14,2017-03-02
Houston,Cincinnati,47,65,1,-18,2017-03-02
Stanford,Colorado,72,91,1,-19,2017-03-02
Hampton,Coppin State,89,82,0,7,2017-03-02
Howard,Delaware State,56,66,1,-10,2017-03-02
Indiana State,Evansville,72,83,1,-11,2017-03-02
Kennesaw State,Florida Gulf Coast,62,74,1,-12,2017-03-02
High Point,Gardner-Webb,55,91,1,-36,2017-03-02
Alabama State,Grambling,69,82,1,-13,2017-03-02
Montana State,Idaho State,79,68,0,11,2017-03-02
Alabama A&M,Jackson State,64,72,1,-8,2017-03-02
Southeast Missouri State,Jacksonville State,51,74,1,-23,2017-03-02
Nicholls State,Lamar,75,87,1,-12,2017-03-02
Colgate,Lehigh,72,77,1,-5,2017-03-02
Radford,Liberty,56,52,0,4,2017-03-02
North Florida,Lipscomb,91,85,0,6,2017-03-02
Texas State,Louisiana,84,94,1,-10,2017-03-02
Texas-Arlington,Louisiana-Monroe,72,57,0,15,2017-03-02
Boston University,Loyola (MD),64,60,0,4,2017-03-02
Rice,Marshall,89,88,0,1,2017-03-02
Morgan State,Maryland-Eastern Shore,66,67,1,-1,2017-03-02
Tulane,Memphis,70,92,1,-22,2017-03-02
Florida International,Middle Tennessee,67,70,1,-3,2017-03-02
Nebraska,Minnesota,73,88,1,-15,2017-03-02
Murray State,Morehead State,75,69,0,6,2017-03-02
Holy Cross,Navy,42,49,1,-7,2017-03-02
Southeastern Louisiana,New Orleans,63,58,0,5,2017-03-02
North Carolina Central,North Carolina A&T,63,68,1,-5,2017-03-02
Sacramento State,North Dakota,57,53,0,4,2017-03-02
Idaho,Northern Arizona,77,75,0,2,2017-03-02
Portland State,Northern Colorado,84,87,1,-3,2017-03-02
Southern,Prairie View,64,70,1,-6,2017-03-02
Niagara,Quinnipiac,88,69,0,19,2017-03-02
Manhattan,Rider,68,69,1,-1,2017-03-02
McNeese State,Sam Houston State,74,79,1,-5,2017-03-02
South Carolina State,Savannah State,88,95,1,-7,2017-03-02
Little Rock,South Alabama,62,57,0,5,2017-03-02
UCF,South Florida,59,56,0,3,2017-03-02
Tulsa,SMU,70,93,1,-23,2017-03-02
Eastern Washington,Southern Utah,91,75,0,16,2017-03-02
Northwestern State,Stephen F. Austin,72,67,0,5,2017-03-02
Old Dominion,UTEP,62,61,0,1,2017-03-02
Charlotte,UTSA,76,75,0,1,2017-03-02
Alcorn State,Texas Southern,88,94,1,-6,2017-03-02
Arkansas State,Troy,72,81,1,-9,2017-03-02
California,Utah,44,74,1,-30,2017-03-02
Montana,Weber State,78,74,0,4,2017-03-02
North Texas,Western Kentucky,63,74,1,-11,2017-03-02
Iowa,Wisconsin,59,57,0,2,2017-03-02
Northern Illinois,Ball State,82,87,1,-5,2017-03-03
Jacksonville State,Belmont,65,59,0,6,2017-03-03
Columbia,Brown,68,88,1,-20,2017-03-03
Bowling Green State,Buffalo,68,80,1,-12,2017-03-03
Youngstown State,Cleveland State,84,69,0,15,2017-03-03
Milwaukee,Detroit,85,60,0,25,2017-03-03
Toledo,Eastern Michigan,60,56,0,4,2017-03-03
Delaware,Hofstra,81,76,0,5,2017-03-03
Evansville,Illinois State,69,80,1,-11,2017-03-03
Drexel,James Madison,70,80,1,-10,2017-03-03
Akron,Kent State,66,56,0,10,2017-03-03
Niagara,Monmouth,59,84,1,-25,2017-03-03
Missouri State,Northern Iowa,70,64,0,6,2017-03-03
Miami (OH),Ohio,55,69,1,-14,2017-03-03
Dartmouth,Penn,76,74,0,2,2017-03-03
Pacific,Pepperdine,89,84,0,5,2017-03-03
Harvard,Princeton,69,73,1,-4,2017-03-03
Campbell,Radford,66,50,0,16,2017-03-03
Canisius,St. Peter's,58,61,1,-3,2017-03-03
VMI,Samford,61,79,1,-18,2017-03-03
Portland,San Diego,60,55,0,5,2017-03-03
Loyola (IL),Southern Illinois,50,55,1,-5,2017-03-03
Murray State,UT-Martin,67,73,1,-6,2017-03-03
Iowa State,West Virginia,76,87,1,-11,2017-03-03
Citadel,Western Carolina,78,72,0,6,2017-03-03
Central Michigan,Western Michigan,80,88,1,-8,2017-03-03
Bradley,Wichita State,56,82,1,-26,2017-03-03
Gardner-Webb,Winthrop,77,80,1,-3,2017-03-03
Cornell,Yale,63,90,1,-27,2017-03-03
Boise State,Air Force,98,70,0,28,2017-03-04
Florida International,Alabama-Birmingham,68,56,0,12,2017-03-04
Coastal Carolina,Appalachian State,73,77,1,-4,2017-03-04
Arizona,Arizona State,73,60,0,13,2017-03-04
Georgia,Arkansas,67,85,1,-18,2017-03-04
Missouri,Auburn,78,89,1,-11,2017-03-04
Loyola Marymount,BYU,81,89,1,-8,2017-03-04
Cornell,Brown,92,78,0,14,2017-03-04
Seton Hall,Butler,70,64,0,6,2017-03-04
UCSB,Cal Poly,57,44,0,13,2017-03-04
Grand Canyon,Cal State Bakersfield,58,52,0,6,2017-03-04
Cal State Fullerton,Cal State Northridge,86,78,0,8,2017-03-04
UC-Davis,UC-Irvine,49,79,1,-30,2017-03-04
Wofford,Chattanooga,79,67,0,12,2017-03-04
UMKC,Chicago State,87,82,0,5,2017-03-04
Boston College,Clemson,68,82,1,-14,2017-03-04
James Madison,College of Charleston,62,67,1,-5,2017-03-04
California,Colorado,46,54,1,-8,2017-03-04
Xavier,DePaul,79,65,0,14,2017-03-04
St. Joseph's,Duquesne,63,60,0,3,2017-03-04
Mercer,ETSU,66,73,1,-7,2017-03-04
Miami (FL),Florida State,57,66,1,-9,2017-03-04
UNLV,Fresno State,59,72,1,-13,2017-03-04
Samford,Furman,67,63,0,4,2017-03-04
Dayton,George Washington,81,87,1,-6,2017-03-04
Villanova,Georgetown,81,55,0,26,2017-03-04
Georgia Southern,Georgia State,67,72,1,-5,2017-03-04
Pacific,Gonzaga,50,82,1,-32,2017-03-04
Alabama A&M,Grambling,57,78,1,-21,2017-03-04
Abilene Christian,Houston Baptist,72,81,1,-9,2017-03-04
Montana,Idaho State,95,76,0,19,2017-03-04
Southern Illinois,Illinois State,50,63,1,-13,2017-03-04
Rider,Iona,70,88,1,-18,2017-03-04
Alabama State,Jackson State,59,65,1,-6,2017-03-04
Texas Tech,Kansas State,48,61,1,-13,2017-03-04
Fordham,La Salle,54,66,1,-12,2017-03-04
Hawaii,Long Beach State,75,84,1,-9,2017-03-04
Texas-Arlington,Louisiana,81,83,1,-2,2017-03-04
Texas State,Louisiana-Monroe,70,65,0,5,2017-03-04
Southern Miss,Louisiana Tech,65,93,1,-28,2017-03-04
Notre Dame,Louisville,64,71,1,-7,2017-03-04
Creighton,Marquette,83,91,1,-8,2017-03-04
North Texas,Marshall,104,106,1,-2,2017-03-04
Michigan State,Maryland,60,63,1,-3,2017-03-04
Lamar,McNeese State,90,83,0,7,2017-03-04
Florida Atlantic,Middle Tennessee,59,93,1,-34,2017-03-04
South Carolina,Ole Miss,70,75,1,-5,2017-03-04
LSU,Mississippi State,76,88,1,-12,2017-03-04
Arkansas-Pine Bluff,Mississippi Valley State,77,88,1,-11,2017-03-04
Robert Morris,Mount St. Mary's,66,75,1,-9,2017-03-04
Colorado State,Nevada,72,85,1,-13,2017-03-04
San Diego State,New Mexico,59,64,1,-5,2017-03-04
Texas-Rio Grande Valley,New Mexico State,81,107,1,-26,2017-03-04
New Orleans,Nicholls State,74,64,0,10,2017-03-04
Duke,UNC,83,90,1,-7,2017-03-04
Citadel,UNC Greensboro,67,76,1,-9,2017-03-04
Delaware,UNC Wilmington,82,91,1,-9,2017-03-04
Portland State,North Dakota,73,82,1,-9,2017-03-04
IUPUI,North Dakota State,76,57,0,19,2017-03-04
Eastern Washington,Northern Arizona,61,76,1,-15,2017-03-04
Sacramento State,Northern Colorado,67,70,1,-3,2017-03-04
Central Arkansas,Northwestern State,83,97,1,-14,2017-03-04
Youngstown State,Oakland,81,80,0,1,2017-03-04
Indiana,Ohio State,96,92,0,4,2017-03-04
TCU,Oklahoma,68,73,1,-5,2017-03-04
Kansas,Oklahoma State,90,85,0,5,2017-03-04
Oregon,Oregon State,80,59,0,21,2017-03-04
Harvard,Penn,72,75,1,-3,2017-03-04
Alcorn State,Prairie View,60,66,1,-6,2017-03-04
Dartmouth,Princeton,48,85,1,-37,2017-03-04
Davidson,Rhode Island,70,73,1,-3,2017-03-04
Saint Louis,Richmond,62,72,1,-10,2017-03-04
Illinois,Rutgers,59,62,1,-3,2017-03-04
Portland,Saint Mary's,58,81,1,-23,2017-03-04
San Francisco,Santa Clara,69,76,1,-7,2017-03-04
Fairfield,Siena,66,78,1,-12,2017-03-04
Arkansas State,South Alabama,70,73,1,-3,2017-03-04
Western Illinois,South Dakota,69,78,1,-9,2017-03-04
Washington,USC,58,74,1,-16,2017-03-04
Memphis,SMU,62,103,1,-41,2017-03-04
Idaho,Southern Utah,84,75,0,9,2017-03-04
UMass,St. Bonaventure,56,60,1,-4,2017-03-04
Providence,St. John's (NY),86,75,0,11,2017-03-04
Sam Houston State,Stephen F. Austin,56,64,1,-8,2017-03-04
Georgia Tech,Syracuse,61,90,1,-29,2017-03-04
Alabama,Tennessee,54,59,1,-5,2017-03-04
Jacksonville State,UT-Martin,66,55,0,11,2017-03-04
Baylor,Texas,75,64,0,11,2017-03-04
Kentucky,Texas A&M,71,63,0,8,2017-03-04
Incarnate Word,Texas A&M-Corpus Christi,64,81,1,-17,2017-03-04
Charlotte,UTEP,67,74,1,-7,2017-03-04
Old Dominion,UTSA,55,73,1,-18,2017-03-04
Southern,Texas Southern,69,82,1,-13,2017-03-04
Northeastern,Towson,54,82,1,-28,2017-03-04
Little Rock,Troy,54,57,1,-3,2017-03-04
Washington State,UCLA,68,77,1,-9,2017-03-04
Stanford,Utah,59,67,1,-8,2017-03-04
Seattle,Utah Valley,54,61,1,-7,2017-03-04
Milwaukee,Valparaiso,43,41,0,2,2017-03-04
Florida,Vanderbilt,71,73,1,-2,2017-03-04
Pitt,Virginia,42,67,1,-25,2017-03-04
George Mason,VCU,60,72,1,-12,2017-03-04
Wake Forest,Virginia Tech,89,84,0,5,2017-03-04
Saint Francis (PA),Wagner,71,70,0,1,2017-03-04
Montana State,Weber State,67,76,1,-9,2017-03-04
Rice,Western Kentucky,72,79,1,-7,2017-03-04
Missouri State,Wichita State,63,78,1,-15,2017-03-04
Elon,William & Mary,66,71,1,-5,2017-03-04
San Jose State,Wyoming,62,74,1,-12,2017-03-04
Columbia,Yale,71,75,1,-4,2017-03-04
Lehigh,Boston University,91,88,0,3,2017-03-05
Navy,Bucknell,65,70,1,-5,2017-03-05
Towson,College of Charleston,59,67,1,-8,2017-03-05
Cincinnati,UConn,67,47,0,20,2017-03-05
Samford,ETSU,72,81,1,-9,2017-03-05
North Florida,Florida Gulf Coast,61,77,1,-16,2017-03-05
UIC,Green Bay,79,70,0,9,2017-03-05
East Carolina,Houston,51,73,1,-22,2017-03-05
Wichita State,Illinois State,71,51,0,20,2017-03-05
Penn State,Iowa,79,90,1,-11,2017-03-05
Siena,Monmouth,89,85,0,4,2017-03-05
Michigan,Nebraska,93,57,0,36,2017-03-05
Purdue-Fort Wayne,Omaha,80,84,1,-4,2017-03-05
Wofford,UNC Greensboro,73,77,1,-4,2017-03-05
William & Mary,UNC Wilmington,94,105,1,-11,2017-03-05
Wright State,Northern Kentucky,77,82,1,-5,2017-03-05
Purdue,Northwestern,69,65,0,4,2017-03-05
Iona,St. Peter's,73,65,0,8,2017-03-05
Denver,South Dakota State,73,83,1,-10,2017-03-05
Temple,South Florida,72,60,0,12,2017-03-05
Tulsa,Tulane,69,81,1,-12,2017-03-05
Campbell,Winthrop,59,76,1,-17,2017-03-05
Minnesota,Wisconsin,49,66,1,-17,2017-03-05
Howard,Coppin State,79,73,0,6,2017-03-06
Northern Illinois,Eastern Michigan,69,72,1,-3,2017-03-06
Santa Clara,Gonzaga,68,77,1,-9,2017-03-06
Milwaukee,UIC,74,68,0,6,2017-03-06
Siena,Iona,86,87,1,-1,2017-03-06
Central Michigan,Kent State,106,116,1,-10,2017-03-06
North Carolina A&T,Maryland-Eastern Shore,65,75,1,-10,2017-03-06
IUPUI,Omaha,62,90,1,-28,2017-03-06
ETSU,UNC Greensboro,79,74,0,5,2017-03-06
College of Charleston,UNC Wilmington,69,78,1,-9,2017-03-06
Youngstown State,Northern Kentucky,74,84,1,-10,2017-03-06
BYU,Saint Mary's,50,81,1,-31,2017-03-06
South Dakota State,South Dakota,74,71,0,3,2017-03-06
Albany (NY),Stony Brook,63,56,0,7,2017-03-06
Bowling Green State,Toledo,62,77,1,-15,2017-03-06
New Hampshire,Vermont,41,74,1,-33,2017-03-06
Miami (OH),Western Michigan,61,65,1,-4,2017-03-06
Mississippi Valley State,Alcorn State,60,63,1,-3,2017-03-07
NC State,Clemson,61,75,1,-14,2017-03-07
Bethune-Cookman,Delaware State,69,62,0,7,2017-03-07
Pitt,Georgia Tech,61,59,0,2,2017-03-07
Saint Mary's,Gonzaga,56,74,1,-18,2017-03-07
Southern Utah,Montana State,109,105,0,4,2017-03-07
Saint Francis (PA),Mount St. Mary's,61,71,1,-10,2017-03-07
South Dakota State,Omaha,79,77,0,2,2017-03-07
Milwaukee,Northern Kentucky,53,59,1,-6,2017-03-07
Northern Arizona,Portland State,67,80,1,-13,2017-03-07
Grambling,Prairie View,81,77,0,4,2017-03-07
Idaho State,Sacramento State,76,91,1,-15,2017-03-07
Florida A&M,South Carolina State,78,82,1,-4,2017-03-07
Jackson State,Southern,63,69,1,-6,2017-03-07
Alabama State,Texas Southern,72,87,1,-15,2017-03-07
Boston College,Wake Forest,78,92,1,-14,2017-03-07
Charlotte,Alabama-Birmingham,73,74,1,-1,2017-03-08
Stanford,Arizona State,88,98,1,-10,2017-03-08
Louisiana-Monroe,Arkansas State,73,70,0,3,2017-03-08
Missouri,Auburn,86,83,0,3,2017-03-08
Lehigh,Bucknell,65,81,1,-16,2017-03-08
Oregon State,California,62,67,1,-5,2017-03-08
South Alabama,Coastal Carolina,67,80,1,-13,2017-03-08
Washington State,Colorado,63,73,1,-10,2017-03-08
Clemson,Duke,72,79,1,-7,2017-03-08
Southeastern Louisiana,Lamar,65,77,1,-12,2017-03-08
Little Rock,Louisiana,71,78,1,-7,2017-03-08
Florida Atlantic,Marshall,74,89,1,-15,2017-03-08
St. Joseph's,UMass,63,70,1,-7,2017-03-08
LSU,Mississippi State,52,79,1,-27,2017-03-08
Penn State,Nebraska,76,67,0,9,2017-03-08
South Carolina State,Norfolk State,88,93,1,-5,2017-03-08
Bethune-Cookman,North Carolina Central,60,95,1,-35,2017-03-08
Rutgers,Ohio State,66,57,0,9,2017-03-08
Southern Miss,Rice,75,86,1,-11,2017-03-08
Duquesne,Saint Louis,71,72,1,-1,2017-03-08
Central Arkansas,Sam Houston State,69,77,1,-8,2017-03-08
UNLV,San Diego State,52,62,1,-10,2017-03-08
Washington,USC,73,78,1,-5,2017-03-08
Georgetown,St. John's (NY),73,74,1,-1,2017-03-08
Miami (FL),Syracuse,62,57,0,5,2017-03-08
Oklahoma,TCU,63,82,1,-19,2017-03-08
Texas,Texas Tech,61,52,0,9,2017-03-08
Appalachian State,Troy,64,84,1,-20,2017-03-08
San Jose State,Utah State,64,90,1,-26,2017-03-08
Pitt,Virginia,63,75,1,-12,2017-03-08
Wake Forest,Virginia Tech,90,99,1,-9,2017-03-08
UTSA,Western Kentucky,56,52,0,4,2017-03-08
Air Force,Wyoming,83,68,0,15,2017-03-08
DePaul,Xavier,64,75,1,-11,2017-03-08
Eastern Michigan,Akron,62,79,1,-17,2017-03-09
Mississippi State,Alabama,55,75,1,-20,2017-03-09
Colorado,Arizona,78,92,1,-14,2017-03-09
Western Michigan,Ball State,63,66,1,-3,2017-03-09
Kansas State,Baylor,70,64,0,6,2017-03-09
San Diego State,Boise State,87,68,0,19,2017-03-09
Kent State,Buffalo,68,65,0,3,2017-03-09
Xavier,Butler,62,57,0,5,2017-03-09
Cal State Northridge,Cal State Fullerton,68,81,1,-13,2017-03-09
Cal Poly,UC-Davis,55,66,1,-11,2017-03-09
UC-Riverside,UC-Irvine,67,76,1,-9,2017-03-09
Air Force,Colorado State,55,81,1,-26,2017-03-09
South Florida,UConn,66,77,1,-11,2017-03-09
Sacramento State,Eastern Washington,70,89,1,-19,2017-03-09
Virginia Tech,Florida State,68,74,1,-6,2017-03-09
New Mexico,Fresno State,60,65,1,-5,2017-03-09
Fordham,George Mason,71,82,1,-11,2017-03-09
Saint Louis,George Washington,46,53,1,-7,2017-03-09
Tennessee,Georgia,57,59,1,-2,2017-03-09
Maryland-Eastern Shore,Hampton,68,66,0,2,2017-03-09
Sam Houston State,Houston Baptist,63,59,0,4,2017-03-09
Montana,Idaho,77,81,1,-4,2017-03-09
Indiana,Iowa,95,73,0,22,2017-03-09
Oklahoma State,Iowa State,83,92,1,-9,2017-03-09
TCU,Kansas,85,82,0,3,2017-03-09
Davidson,La Salle,82,73,0,9,2017-03-09
Hawaii,Long Beach State,62,73,1,-11,2017-03-09
Alabama-Birmingham,Louisiana Tech,57,69,1,-12,2017-03-09
Duke,Louisville,81,77,0,4,2017-03-09
Seton Hall,Marquette,82,76,0,6,2017-03-09
Illinois,Michigan,55,75,1,-20,2017-03-09
Penn State,Michigan State,51,78,1,-27,2017-03-09
UTSA,Middle Tennessee,70,86,1,-16,2017-03-09
Missouri,Ole Miss,74,86,1,-12,2017-03-09
Texas-Rio Grande Valley,UMKC,78,82,1,-4,2017-03-09
Howard,Morgan State,68,65,0,3,2017-03-09
Utah State,Nevada,69,83,1,-14,2017-03-09
Chicago State,New Mexico State,53,67,1,-14,2017-03-09
Miami (FL),UNC,53,78,1,-25,2017-03-09
Portland State,North Dakota,72,95,1,-23,2017-03-09
Rutgers,Northwestern,61,83,1,-22,2017-03-09
Virginia,Notre Dame,58,71,1,-13,2017-03-09
Toledo,Ohio,66,67,1,-1,2017-03-09
Marshall,Old Dominion,64,63,0,1,2017-03-09
Arizona State,Oregon,57,80,1,-23,2017-03-09
Creighton,Providence,70,58,0,12,2017-03-09
UMass,St. Bonaventure,60,73,1,-13,2017-03-09
Lamar,Stephen F. Austin,59,75,1,-16,2017-03-09
East Carolina,Temple,80,69,0,11,2017-03-09
Rice,UTEP,76,86,1,-10,2017-03-09
Tulane,Tulsa,60,66,1,-6,2017-03-09
USC,UCLA,74,76,1,-2,2017-03-09
California,Utah,78,75,0,3,2017-03-09
Seattle,Utah Valley,53,65,1,-12,2017-03-09
Texas A&M,Vanderbilt,41,66,1,-25,2017-03-09
St. John's (NY),Villanova,67,108,1,-41,2017-03-09
Southern Utah,Weber State,70,90,1,-20,2017-03-09
Texas,West Virginia,53,63,1,-10,2017-03-09
Ball State,Akron,70,74,1,-4,2017-03-10
Southern,Alcorn State,59,81,1,-22,2017-03-10
UCLA,Arizona,75,86,1,-11,2017-03-10
Ole Miss,Arkansas,72,73,1,-1,2017-03-10
Utah Valley,Cal State Bakersfield,80,81,1,-1,2017-03-10
Cal State Fullerton,UC-Davis,64,66,1,-2,2017-03-10
Long Beach State,UC-Irvine,57,62,1,-5,2017-03-10
Memphis,UCF,54,84,1,-30,2017-03-10
Tulsa,Cincinnati,61,80,1,-19,2017-03-10
San Diego State,Colorado State,63,71,1,-8,2017-03-10
Xavier,Creighton,72,75,1,-3,2017-03-10
Davidson,Dayton,73,67,0,6,2017-03-10
Weber State,Eastern Washington,80,72,0,8,2017-03-10
Vanderbilt,Florida,72,62,0,10,2017-03-10
Notre Dame,Florida State,77,73,0,4,2017-03-10
Troy,Georgia Southern,90,70,0,20,2017-03-10
Louisiana,Georgia State,76,86,1,-10,2017-03-10
UConn,Houston,74,65,0,9,2017-03-10
TCU,Iowa State,63,84,1,-21,2017-03-10
Georgia,Kentucky,60,71,1,-11,2017-03-10
Marshall,Louisiana Tech,93,77,0,16,2017-03-10
Northwestern,Maryland,72,64,0,8,2017-03-10
UTEP,Middle Tennessee,56,82,1,-26,2017-03-10
Michigan State,Minnesota,58,63,1,-5,2017-03-10
Fresno State,Nevada,72,83,1,-11,2017-03-10
UMKC,New Mexico State,60,78,1,-18,2017-03-10
Sam Houston State,New Orleans,63,75,1,-12,2017-03-10
Howard,Norfolk State,53,68,1,-15,2017-03-10
Duke,UNC,93,83,0,10,2017-03-10
Maryland-Eastern Shore,North Carolina Central,49,77,1,-28,2017-03-10
Idaho,North Dakota,64,69,1,-5,2017-03-10
Kent State,Ohio,68,66,0,2,2017-03-10
California,Oregon,65,73,1,-8,2017-03-10
Michigan,Purdue,74,70,0,4,2017-03-10
St. Bonaventure,Rhode Island,63,74,1,-11,2017-03-10
George Washington,Richmond,67,70,1,-3,2017-03-10
Alabama,South Carolina,64,53,0,11,2017-03-10
East Carolina,SMU,77,81,1,-4,2017-03-10
Stephen F. Austin,Texas A&M-Corpus Christi,69,77,1,-8,2017-03-10
Coastal Carolina,Texas-Arlington,51,74,1,-23,2017-03-10
Grambling,Texas Southern,57,62,1,-5,2017-03-10
Louisiana-Monroe,Texas State,51,63,1,-12,2017-03-10
Seton Hall,Villanova,53,55,1,-2,2017-03-10
George Mason,VCU,60,71,1,-11,2017-03-10
Kansas State,West Virginia,50,51,1,-1,2017-03-10
Indiana,Wisconsin,60,70,1,-10,2017-03-10
Kent State,Akron,70,65,0,5,2017-03-11
Vanderbilt,Arkansas,62,76,1,-14,2017-03-11
New Mexico State,Cal State Bakersfield,70,60,0,10,2017-03-11
UC-Davis,UC-Irvine,50,47,0,3,2017-03-11
UConn,Cincinnati,71,81,1,-10,2017-03-11
Troy,Georgia State,74,63,0,11,2017-03-11
Yale,Harvard,73,71,0,2,2017-03-11
Alabama,Kentucky,74,79,1,-5,2017-03-11
Marshall,Middle Tennessee,72,83,1,-11,2017-03-11
Michigan,Minnesota,84,77,0,7,2017-03-11
Colorado State,Nevada,71,79,1,-8,2017-03-11
Texas A&M-Corpus Christi,New Orleans,65,68,1,-3,2017-03-11
Norfolk State,North Carolina Central,59,67,1,-8,2017-03-11
Weber State,North Dakota,89,93,1,-4,2017-03-11
Duke,Notre Dame,75,69,0,6,2017-03-11
Arizona,Oregon,83,80,0,3,2017-03-11
Penn,Princeton,64,72,1,-8,2017-03-11
Davidson,Rhode Island,60,84,1,-24,2017-03-11
UCF,SMU,59,70,1,-11,2017-03-11
Texas State,Texas-Arlington,83,62,0,21,2017-03-11
Alcorn State,Texas Southern,50,53,1,-3,2017-03-11
Albany (NY),Vermont,53,56,1,-3,2017-03-11
Creighton,Villanova,60,74,1,-14,2017-03-11
Richmond,VCU,77,87,1,-10,2017-03-11
Iowa State,West Virginia,80,74,0,6,2017-03-11
Northwestern,Wisconsin,48,76,1,-28,2017-03-11
Arkansas,Kentucky,65,82,1,-17,2017-03-12
Yale,Princeton,59,71,1,-12,2017-03-12
Cincinnati,SMU,56,71,1,-15,2017-03-12
Troy,Texas State,59,53,0,6,2017-03-12
Rhode Island,VCU,70,63,0,7,2017-03-12
Michigan,Wisconsin,71,56,0,15,2017-03-12
Norfolk State,Liberty,64,73,1,-9,2017-03-13
Richmond,Alabama,71,64,0,7,2017-03-14
Cal State Bakersfield,California,73,66,0,7,2017-03-14
Houston Baptist,Campbell,79,98,1,-19,2017-03-14
Oakland,Clemson,74,69,0,5,2017-03-14
College of Charleston,Colorado State,74,81,1,-7,2017-03-14
Indiana,Georgia Tech,63,75,1,-12,2017-03-14
Valparaiso,Illinois,57,82,1,-25,2017-03-14
Saint Francis (PA),Jacksonville,78,76,0,2,2017-03-14
Wake Forest,Kansas State,88,95,1,-7,2017-03-14
Ole Miss,Monmouth,91,83,0,8,2017-03-14
New Orleans,Mount St. Mary's,66,67,1,-1,2017-03-14
Canisius,Samford,74,78,1,-4,2017-03-14
Boise State,Utah,73,68,0,5,2017-03-14
Texas-Arlington,BYU,105,89,0,16,2017-03-15
Colorado,UCF,74,79,1,-5,2017-03-15
Hampton,Coastal Carolina,67,83,1,-16,2017-03-15
Loyola (MD),George Mason,73,58,0,15,2017-03-15
Toledo,George Washington,69,73,1,-4,2017-03-15
Belmont,Georgia,78,69,0,9,2017-03-15
Utah Valley,Georgia Southern,74,49,0,25,2017-03-15
Akron,Houston,78,75,0,3,2017-03-15
Stephen F. Austin,Idaho,50,73,1,-23,2017-03-15
UC-Irvine,Illinois State,71,85,1,-14,2017-03-15
South Dakota,Iowa,75,87,1,-12,2017-03-15
Ball State,Purdue-Fort Wayne,80,88,1,-8,2017-03-15
Fairfield,UMBC,83,88,1,-5,2017-03-15
Green Bay,UMKC,82,92,1,-10,2017-03-15
UC-Davis,North Carolina Central,67,63,0,4,2017-03-15
USC,Providence,75,71,0,4,2017-03-15
San Francisco,Rice,76,85,1,-9,2017-03-15
UNC Greensboro,Syracuse,77,90,1,-13,2017-03-15
Georgia State,Texas A&M-Corpus Christi,64,80,1,-16,2017-03-15
Fresno State,TCU,59,66,1,-7,2017-03-15
Eastern Washington,Wyoming,81,91,1,-10,2017-03-15
St. Peter's,Albany (NY),59,55,0,4,2017-03-16
North Dakota,Arizona,82,100,1,-18,2017-03-16
Winthrop,Butler,64,76,1,-12,2017-03-16
Weber State,Cal State Fullerton,80,76,0,4,2017-03-16
ETSU,Florida,65,80,1,-15,2017-03-16
Florida Gulf Coast,Florida State,80,86,1,-6,2017-03-16
South Dakota State,Gonzaga,46,66,1,-20,2017-03-16
Stony Brook,UIC,69,71,1,-2,2017-03-16
Nevada,Iowa State,73,84,1,-11,2017-03-16
Xavier,Maryland,76,65,0,11,2017-03-16
Middle Tennessee,Minnesota,81,72,0,9,2017-03-16
Vanderbilt,Northwestern,66,68,1,-2,2017-03-16
Princeton,Notre Dame,58,60,1,-2,2017-03-16
Vermont,Purdue,70,80,1,-10,2017-03-16
VCU,Saint Mary's,77,85,1,-8,2017-03-16
Furman,USC Upstate,79,57,0,22,2017-03-16
UNC Asheville,UT-Martin,75,89,1,-14,2017-03-16
Lamar,Texas State,60,70,1,-10,2017-03-16
Mount St. Mary's,Villanova,56,76,1,-20,2017-03-16
UNC Wilmington,Virginia,71,76,1,-5,2017-03-16
Bucknell,West Virginia,80,86,1,-6,2017-03-16
Virginia Tech,Wisconsin,74,84,1,-10,2017-03-16
Seton Hall,Arkansas,71,77,1,-6,2017-03-17
New Mexico State,Baylor,73,91,1,-18,2017-03-17
Kansas State,Cincinnati,61,75,1,-14,2017-03-17
Rhode Island,Creighton,84,72,0,12,2017-03-17
Wichita State,Dayton,64,58,0,6,2017-03-17
Troy,Duke,65,87,1,-22,2017-03-17
UC-Davis,Kansas,62,100,1,-38,2017-03-17
Northern Kentucky,Kentucky,70,79,1,-9,2017-03-17
Jacksonville State,Louisville,63,78,1,-15,2017-03-17
Michigan State,Miami (FL),78,58,0,20,2017-03-17
Oklahoma State,Michigan,91,92,1,-1,2017-03-17
Texas Southern,UNC,64,103,1,-39,2017-03-17
Iona,Oregon,77,93,1,-16,2017-03-17
Marquette,South Carolina,73,93,1,-20,2017-03-17
USC,SMU,66,65,0,1,2017-03-17
Kent State,UCLA,80,97,1,-17,2017-03-17
Saint Mary's,Arizona,60,69,1,-9,2017-03-18
Middle Tennessee,Butler,65,74,1,-9,2017-03-18
Virginia,Florida,39,65,1,-26,2017-03-18
Xavier,Florida State,91,66,0,25,2017-03-18
Northwestern,Gonzaga,73,79,1,-6,2017-03-18
Saint Francis (PA),UMBC,79,87,1,-8,2017-03-18
Iowa State,Purdue,76,80,1,-4,2017-03-18
Ole Miss,Syracuse,85,80,0,5,2017-03-18
Wisconsin,Villanova,65,62,0,3,2017-03-18
Notre Dame,West Virginia,71,83,1,-12,2017-03-18
USC,Baylor,78,82,1,-4,2017-03-19
South Carolina,Duke,88,81,0,7,2017-03-19
Belmont,Georgia Tech,57,71,1,-14,2017-03-19
TCU,Iowa,94,92,0,2,2017-03-19
Michigan State,Kansas,70,90,1,-20,2017-03-19
Wichita State,Kentucky,62,65,1,-3,2017-03-19
Michigan,Louisville,73,69,0,4,2017-03-19
Arkansas,UNC,65,72,1,-7,2017-03-19
Rhode Island,Oregon,72,75,1,-3,2017-03-19
Oakland,Richmond,83,87,1,-4,2017-03-19
Cincinnati,UCLA,67,79,1,-12,2017-03-19
UT-Martin,Campbell,56,73,1,-17,2017-03-20
Loyola (MD),Coastal Carolina,63,72,1,-9,2017-03-20
Cal State Bakersfield,Colorado State,81,63,0,18,2017-03-20
Boise State,Illinois,56,71,1,-15,2017-03-20
George Washington,UIC,71,80,1,-9,2017-03-20
UCF,Illinois State,63,62,0,1,2017-03-20
Samford,Liberty,58,66,1,-8,2017-03-20
Utah Valley,Rice,85,79,0,6,2017-03-20
Weber State,Texas A&M-Corpus Christi,73,82,1,-9,2017-03-20
Akron,Texas-Arlington,69,85,1,-16,2017-03-20
UMKC,Wyoming,61,72,1,-11,2017-03-20
Georgia Tech,Ole Miss,74,66,0,8,2017-03-21
Richmond,TCU,68,86,1,-18,2017-03-21
Illinois,UCF,58,68,1,-10,2017-03-22
UIC,Coastal Carolina,78,89,1,-11,2017-03-22
Cal State Bakersfield,Texas-Arlington,80,76,0,4,2017-03-22
Idaho,Texas State,55,64,1,-9,2017-03-22
Utah Valley,Wyoming,68,74,1,-6,2017-03-22
Xavier,Arizona,73,71,0,2,2017-03-23
West Virginia,Gonzaga,58,61,1,-3,2017-03-23
Purdue,Kansas,66,98,1,-32,2017-03-23
Michigan,Oregon,68,69,1,-1,2017-03-23
South Carolina,Baylor,70,50,0,20,2017-03-24
Wisconsin,Florida,83,84,1,-1,2017-03-24
UCLA,Kentucky,75,86,1,-11,2017-03-24
Butler,UNC,80,92,1,-12,2017-03-24
Furman,Campbell,79,64,0,15,2017-03-25
Xavier,Gonzaga,59,83,1,-24,2017-03-25
Oregon,Kansas,74,60,0,14,2017-03-25
St. Peter's,Texas State,49,44,0,5,2017-03-25
South Carolina,Florida,77,70,0,7,2017-03-26
Liberty,UMBC,68,80,1,-12,2017-03-26
Kentucky,UNC,73,75,1,-2,2017-03-26
Purdue-Fort Wayne,Texas A&M-Corpus Christi,62,78,1,-16,2017-03-26
Wyoming,Coastal Carolina,81,91,1,-10,2017-03-27
TCU,UCF,68,53,0,15,2017-03-28
Cal State Bakersfield,Georgia Tech,61,76,1,-15,2017-03-28
Texas A&M-Corpus Christi,UMBC,79,61,0,18,2017-03-29
Furman,St. Peter's,51,77,1,-26,2017-03-29
Coastal Carolina,Wyoming,57,81,1,-24,2017-03-29
Georgia Tech,TCU,56,88,1,-32,2017-03-30
St. Peter's,Texas A&M-Corpus Christi,62,61,0,1,2017-03-31
Coastal Carolina,Wyoming,59,83,1,-24,2017-03-31
South Carolina,Gonzaga,73,77,1,-4,2017-04-01
Oregon,UNC,76,77,1,-1,2017-04-01
Gonzaga,UNC,65,71,1,-6,2017-04-03
