Road,Home,Road_score,Home_score,Home_w,margin,Date
Army,Air Force,68,79,1,-11,2013-11-08
Coastal Carolina,Akron,63,72,1,-9,2013-11-08
Oklahoma,Alabama,82,73,0,9,2013-11-08
Columbus State,Alabama-Birmingham,56,76,1,-20,2013-11-08
Cal Poly,Arizona,62,73,1,-11,2013-11-08
UMBC,Arizona State,61,96,1,-35,2013-11-08
SIU-Edwardsville,Arkansas,65,99,1,-34,2013-11-08
Nicholls State,Auburn,54,76,1,-22,2013-11-08
Oakland City,Austin Peay,69,84,1,-15,2013-11-08
Colorado,Baylor,60,72,1,-12,2013-11-08
Loyola (MD),Binghamton,79,74,0,5,2013-11-08
Texas-Arlington,Boise State,87,116,1,-29,2013-11-08
Jacksonville State,Bradley,65,72,1,-7,2013-11-08
Weber State,BYU,72,81,1,-9,2013-11-08
Hope International,Cal State Northridge,74,86,1,-12,2013-11-08
Coppin State,California,64,83,1,-19,2013-11-08
Fresno State,UC-Irvine,98,97,0,1,2013-11-08
Hawaii Pacific,UCSB,50,76,1,-26,2013-11-08
Shenandoah,Campbell,62,87,1,-25,2013-11-08
Tampa,UCF,72,97,1,-25,2013-11-08
Manchester,Central Michigan,49,101,1,-52,2013-11-08
Johnson University,Charleston Southern,51,130,1,-79,2013-11-08
ETSU,Charlotte,75,80,1,-5,2013-11-08
Covenant,Chattanooga,56,119,1,-63,2013-11-08
North Carolina Central,Cincinnati,61,74,1,-13,2013-11-08
Stetson,Clemson,51,71,1,-20,2013-11-08
Colorado-Colorado Springs,Colorado State,70,99,1,-29,2013-11-08
Maryland,UConn,77,78,1,-1,2013-11-08
Alcorn State,Creighton,61,107,1,-46,2013-11-08
Davidson,Duke,77,111,1,-34,2013-11-08
North Carolina Wesleyan,East Carolina,51,97,1,-46,2013-11-08
Florida International,Eastern Kentucky,61,83,1,-22,2013-11-08
Albion,Eastern Michigan,45,77,1,-32,2013-11-08
Washington & Lee,Elon,64,114,1,-50,2013-11-08
Caldwell,Fairleigh Dickinson,71,89,1,-18,2013-11-08
North Florida,Florida,69,77,1,-8,2013-11-08
Ave Maria,Florida Atlantic,51,86,1,-35,2013-11-08
Jacksonville,Florida State,67,91,1,-24,2013-11-08
Saint Francis (PA),Fordham,67,87,1,-20,2013-11-08
Sewanee,Furman,49,66,1,-17,2013-11-08
American,George Mason,60,63,1,-3,2013-11-08
Radford,George Washington,54,76,1,-22,2013-11-08
Oregon,Georgetown,82,75,0,7,2013-11-08
Wofford,Georgia,52,72,1,-20,2013-11-08
Columbia International,Georgia Southern,74,110,1,-36,2013-11-08
Presbyterian,Georgia Tech,57,88,1,-31,2013-11-08
Loyola Marymount,Grand Canyon,78,75,0,3,2013-11-08
William & Mary,Hampton,69,77,1,-8,2013-11-08
Tennessee State,Hawaii,55,85,1,-30,2013-11-08
Monmouth,Hofstra,88,84,0,4,2013-11-08
Texas State,Houston,70,76,1,-6,2013-11-08
Washington College,Howard,52,69,1,-17,2013-11-08
Alabama State,Illinois,63,80,1,-17,2013-11-08
Chicago State,Indiana,72,100,1,-28,2013-11-08
UNC Wilmington,Iowa,39,82,1,-43,2013-11-08
Louisiana-Monroe,Kansas,63,80,1,-17,2013-11-08
Northern Colorado,Kansas State,60,58,0,2,2013-11-08
Youngstown State,Kennesaw State,73,57,0,16,2013-11-08
Ohio Northern,Kent State,48,84,1,-36,2013-11-08
UNC Asheville,Kentucky,57,89,1,-32,2013-11-08
Randolph,Liberty,53,74,1,-21,2013-11-08
Belmont,Lipscomb,87,83,0,4,2013-11-08
Milwaukee,Loyola (IL),72,76,1,-4,2013-11-08
Southern,Marquette,56,63,1,-7,2013-11-08
South Carolina State,Marshall,69,85,1,-16,2013-11-08
St. Francis (NY),Miami (FL),66,62,0,4,2013-11-08
UMass-Lowell,Michigan,42,69,1,-27,2013-11-08
McNeese State,Michigan State,56,98,1,-42,2013-11-08
Lehigh,Minnesota,62,81,1,-19,2013-11-08
Troy,Ole Miss,54,69,1,-15,2013-11-08
Prairie View,Mississippi State,56,71,1,-15,2013-11-08
Southeastern Louisiana,Missouri,53,89,1,-36,2013-11-08
Emporia State,UMKC,81,76,0,5,2013-11-08
Florida Gulf Coast,Nebraska,55,79,1,-24,2013-11-08
Pacific,Nevada,80,78,0,2,2013-11-08
Portland State,UNLV,48,67,1,-19,2013-11-08
Western Michigan,New Mexico State,70,64,0,6,2013-11-08
Oakland,UNC,61,84,1,-23,2013-11-08
Greensboro,North Carolina A&T,64,91,1,-27,2013-11-08
High Point,UNC Greensboro,74,82,1,-8,2013-11-08
Appalachian State,NC State,77,98,1,-21,2013-11-08
Viterbo University,North Dakota State,49,93,1,-44,2013-11-08
Northwood (TX),North Texas,67,72,1,-5,2013-11-08
Omaha,Northern Illinois,68,66,0,2,2013-11-08
LeTourneau,Northwestern State,76,92,1,-16,2013-11-08
Miami (OH),Notre Dame,62,74,1,-12,2013-11-08
Mississippi Valley State,Oklahoma State,62,117,1,-55,2013-11-08
Missouri State,Old Dominion,79,67,0,12,2013-11-08
Savannah State,Pitt,55,88,1,-33,2013-11-08
UC-Davis,Portland,83,100,1,-17,2013-11-08
Boston College,Providence,78,82,1,-4,2013-11-08
Northern Kentucky,Purdue,76,77,1,-1,2013-11-08
Maine,Rhode Island,77,97,1,-20,2013-11-08
Delaware,Richmond,69,71,1,-2,2013-11-08
Florida A&M,Rutgers,84,92,1,-8,2013-11-08
UC-Santa Cruz,Sacramento State,43,73,1,-30,2013-11-08
Southeast Missouri State,Saint Louis,64,87,1,-23,2013-11-08
Louisiana Tech,Saint Mary's,70,83,1,-13,2013-11-08
Martin Methodist,Samford,62,79,1,-17,2013-11-08
South Dakota State,San Diego,70,74,1,-4,2013-11-08
UC-Riverside,San Diego State,41,77,1,-36,2013-11-08
Notre Dame de Namur,San Francisco,57,95,1,-38,2013-11-08
Bethesda,Santa Clara,39,84,1,-45,2013-11-08
Albany (NY),Siena,74,62,0,12,2013-11-08
Detroit,South Alabama,58,74,1,-16,2013-11-08
TCU,SMU,61,69,1,-8,2013-11-08
Jackson State,Southern Miss,51,67,1,-16,2013-11-08
Arizona Christian,Southern Utah,78,85,1,-7,2013-11-08
Wisconsin,St. John's (NY),86,75,0,11,2013-11-08
Bucknell,Stanford,68,72,1,-4,2013-11-08
Texas-Tyler,Stephen F. Austin,64,90,1,-26,2013-11-08
Marist,Stony Brook,55,71,1,-16,2013-11-08
Cornell,Syracuse,60,82,1,-22,2013-11-08
Mercer,Texas,73,76,1,-3,2013-11-08
Buffalo,Texas A&M,58,82,1,-24,2013-11-08
Huston-Tillotson,Texas A&M-Corpus Christi,45,79,1,-34,2013-11-08
Sam Houston State,Texas-Rio Grande Valley,77,73,0,4,2013-11-08
Houston Baptist,Texas Tech,61,76,1,-15,2013-11-08
Navy,Towson,45,72,1,-27,2013-11-08
NJIT,Tulane,64,75,1,-11,2013-11-08
Drexel,UCLA,67,72,1,-5,2013-11-08
Evergreen State,Utah,44,128,1,-84,2013-11-08
USC,Utah State,65,78,1,-13,2013-11-08
IUPUI,Utah Valley,66,74,1,-8,2013-11-08
Murray State,Valparaiso,74,77,1,-3,2013-11-08
Lafayette,Villanova,59,75,1,-16,2013-11-08
James Madison,Virginia,41,61,1,-20,2013-11-08
Illinois State,VCU,58,96,1,-38,2013-11-08
Citadel,VMI,71,82,1,-11,2013-11-08
Colgate,Wake Forest,78,89,1,-11,2013-11-08
Cal State Bakersfield,Washington State,56,62,1,-6,2013-11-08
Mount St. Mary's,West Virginia,62,77,1,-15,2013-11-08
Wittenberg,Western Carolina,55,77,1,-22,2013-11-08
UT-Martin,Wyoming,60,78,1,-18,2013-11-08
Gardner-Webb,Xavier,59,83,1,-24,2013-11-08
Citadel,Army,69,84,1,-15,2013-11-09
Trinity Baptist,Bethune-Cookman,74,91,1,-17,2013-11-09
Earlham (IN),Bowling Green State,49,102,1,-53,2013-11-09
Lamar,Butler,58,89,1,-31,2013-11-09
Yale,Central Connecticut,93,77,0,16,2013-11-09
Urbana,Chicago State,52,77,1,-25,2013-11-09
Iona,Cleveland State,69,73,1,-4,2013-11-09
Maryland-Eastern Shore,Columbia,54,73,1,-19,2013-11-09
Purdue-Fort Wayne,Dayton,80,81,1,-1,2013-11-09
Cairn,Delaware State,48,107,1,-59,2013-11-09
Grambling,DePaul,58,96,1,-38,2013-11-09
Abilene Christian,Duquesne,75,94,1,-19,2013-11-09
Martin Methodist,Evansville,69,87,1,-18,2013-11-09
Sacred Heart,Fairfield,54,67,1,-13,2013-11-09
Youngstown State,Florida International,74,72,0,2,2013-11-09
Southern Tech,Georgia State,78,97,1,-19,2013-11-09
Bryant,Gonzaga,76,100,1,-24,2013-11-09
Northern Michigan,Green Bay,49,71,1,-22,2013-11-09
Quinnipiac,Hartford,82,77,0,5,2013-11-09
Western Illinois,Idaho,63,67,1,-4,2013-11-09
Evergreen State,Idaho State,62,99,1,-37,2013-11-09
Drake,UIC,61,59,0,2,2013-11-09
Ball State,Indiana State,73,82,1,-9,2013-11-09
Eastern Kentucky,Kennesaw State,68,60,0,8,2013-11-09
Manhattan,La Salle,99,90,0,9,2013-11-09
Hawaii Pacific,Long Beach State,59,71,1,-12,2013-11-09
St. Peter's,LIU-Brooklyn,80,87,1,-7,2013-11-09
Louisiana College,Louisiana,67,101,1,-34,2013-11-09
College of Charleston,Louisville,48,70,1,-22,2013-11-09
South Dakota State,Loyola Marymount,89,98,1,-9,2013-11-09
Cal State Fullerton,Montana State,84,55,0,29,2013-11-09
Mid-Continent,Morehead State,60,107,1,-47,2013-11-09
Suffolk,New Hampshire,70,94,1,-24,2013-11-09
Alabama A&M,New Mexico,52,88,1,-36,2013-11-09
Tennessee State,New Mexico State,55,70,1,-15,2013-11-09
Eastern Illinois,Northwestern,55,72,1,-17,2013-11-09
Incarnate Word,Northwood (TX),88,72,0,16,2013-11-09
Northern Iowa,Ohio,64,75,1,-11,2013-11-09
Morgan State,Ohio State,50,89,1,-39,2013-11-09
Wagner,Penn State,62,74,1,-12,2013-11-09
Temple,Penn,78,73,0,5,2013-11-09
San Diego Christian,Pepperdine,68,81,1,-13,2013-11-09
St. Thomas (TX),Rice,60,69,1,-9,2013-11-09
Savannah State,Robert Morris,66,86,1,-20,2013-11-09
Grand Canyon,San Diego,59,70,1,-11,2013-11-09
Niagara,Seton Hall,72,83,1,-11,2013-11-09
Longwood,South Carolina,44,82,1,-38,2013-11-09
Tennessee Tech,South Florida,62,72,1,-10,2013-11-09
South Dakota,St. Bonaventure,46,68,1,-22,2013-11-09
Loyola (LA),UTEP,49,84,1,-35,2013-11-09
Northern Arizona,UTSA,74,63,0,11,2013-11-09
Norfolk State,Texas Southern,83,95,1,-12,2013-11-09
Northwestern Ohio,Toledo,55,102,1,-47,2013-11-09
St. Joseph's,Vermont,74,64,0,10,2013-11-09
Air Force,VMI,63,71,1,-8,2013-11-09
USC Upstate,Virginia Tech,64,63,0,1,2013-11-09
Emporia State,Wichita State,50,93,1,-43,2013-11-09
Roanoke,Winthrop,74,93,1,-19,2013-11-09
Tougaloo,Alcorn State,68,73,1,-5,2013-11-10
Tuskegee,Arkansas-Pine Bluff,64,66,1,-2,2013-11-10
UMass,Boston College,86,73,0,13,2013-11-10
Northeastern,Boston University,69,72,1,-3,2013-11-10
Alabama State,Bradley,59,85,1,-26,2013-11-10
Binghamton,Brown,57,74,1,-17,2013-11-10
UT-Martin,Colorado,65,91,1,-26,2013-11-10
Loyola (MD),Cornell,93,89,0,4,2013-11-10
Lyndon State,Dartmouth,61,106,1,-45,2013-11-10
Charleston Southern,Delaware,95,93,0,2,2013-11-10
Youngstown State,Eastern Kentucky,75,67,0,8,2013-11-10
Pacific (OR),Eastern Washington,58,87,1,-29,2013-11-10
Holy Cross,Harvard,72,82,1,-10,2013-11-10
Western Michigan,Hawaii,68,78,1,-10,2013-11-10
Fairleigh Dickinson,Hofstra,58,80,1,-22,2013-11-10
Gwynedd-Mercy,Howard,66,83,1,-17,2013-11-10
Jacksonville State,Illinois,62,86,1,-24,2013-11-10
Omaha,Iowa,75,83,1,-8,2013-11-10
UNC Wilmington,Iowa State,62,95,1,-33,2013-11-10
Florida International,Kennesaw State,66,58,0,8,2013-11-10
Northern Kentucky,Kentucky,63,93,1,-30,2013-11-10
Fisher College,Maine,64,111,1,-47,2013-11-10
Elon,Marist,75,48,0,27,2013-11-10
Southern,Middle Tennessee,75,78,1,-3,2013-11-10
Stetson,Notre Dame,49,80,1,-31,2013-11-10
Coppin State,Oregon State,78,73,0,5,2013-11-10
Florida A&M,Princeton,50,67,1,-17,2013-11-10
St. Andrews,South Carolina State,55,59,1,-4,2013-11-10
Haverford,Stony Brook,65,81,1,-16,2013-11-10
Oral Roberts,Tulsa,74,68,0,6,2013-11-10
North Park,Valparaiso,50,113,1,-63,2013-11-10
Seattle,Washington,78,88,1,-10,2013-11-10
Mount St. Joseph,Wright State,49,82,1,-33,2013-11-10
Rutgers,Alabama-Birmingham,76,79,1,-3,2013-11-11
Long Beach State,Arizona,57,91,1,-34,2013-11-11
North Florida,Little Rock,72,70,0,2,2013-11-11
UC-Merced,Cal State Bakersfield,54,97,1,-43,2013-11-11
Holy Names,UC-Davis,54,80,1,-26,2013-11-11
South Dakota,Canisius,66,71,1,-5,2013-11-11
Guilford,Coastal Carolina,49,76,1,-27,2013-11-11
Yale,UConn,62,80,1,-18,2013-11-11
UMKC,Creighton,70,96,1,-26,2013-11-11
Milwaukee,Davidson,81,77,0,4,2013-11-11
Michigan-Dearborn,Detroit,51,106,1,-55,2013-11-11
St. Francis (NY),Florida Atlantic,59,57,0,2,2013-11-11
Delaware State,Georgia Tech,50,68,1,-18,2013-11-11
Colorado State,Gonzaga,61,93,1,-32,2013-11-11
Crowley's Ridge,Houston Baptist,61,75,1,-14,2013-11-11
Indiana-Kokomo,Purdue-Fort Wayne,62,90,1,-28,2013-11-11
Arkansas State,Jackson State,65,61,0,4,2013-11-11
Warren Wilson,Kennesaw State,48,92,1,-44,2013-11-11
Oakland City,Lipscomb,78,88,1,-10,2013-11-11
Eastern,UMBC,79,84,1,-5,2013-11-11
Georgia Southern,Miami (FL),80,81,1,-1,2013-11-11
Arkansas-Pine Bluff,Morehouse,67,54,0,13,2013-11-11
Johnson & Wales (NC),North Carolina Central,47,98,1,-51,2013-11-11
Coe,Northern Iowa,52,86,1,-34,2013-11-11
North Texas,Oklahoma,82,95,1,-13,2013-11-11
Schreiner,Prairie View,73,100,1,-27,2013-11-11
Chattanooga,Radford,78,89,1,-11,2013-11-11
Belmont,Richmond,61,69,1,-8,2013-11-11
Navy,Saint Francis (PA),57,60,1,-3,2013-11-11
Hillsdale Baptist/Randall (Ok.),Sam Houston State,54,116,1,-62,2013-11-11
Central Baptist,Southeast Missouri State,56,118,1,-62,2013-11-11
Rhode Island,SMU,58,89,1,-31,2013-11-11
Abilene Christian,St. Bonaventure,47,75,1,-28,2013-11-11
BYU,Stanford,112,103,0,9,2013-11-11
Kent State,Temple,81,77,0,4,2013-11-11
Western Michigan,Tennessee State,63,52,0,11,2013-11-11
Mississippi Valley State,Texas A&M,67,91,1,-24,2013-11-11
Houston,Texas-Rio Grande Valley,77,65,0,12,2013-11-11
Wiley,Texas Southern,96,113,1,-17,2013-11-11
Northern Arizona,Texas Tech,68,88,1,-20,2013-11-11
Incarnate Word,Trinity (TX),74,62,0,12,2013-11-11
LaGrange,Troy,69,102,1,-33,2013-11-11
North Carolina A&T,Utah Valley,71,78,1,-7,2013-11-11
UNC Asheville,Western Carolina,67,74,1,-7,2013-11-11
Emory & Henry,Wofford,58,83,1,-25,2013-11-11
NJIT,Albany (NY),65,71,1,-6,2013-11-12
Mississippi College,Alcorn State,61,87,1,-26,2013-11-12
Campbell,Appalachian State,73,66,0,7,2013-11-12
Miami (OH),Arizona State,54,90,1,-36,2013-11-12
Taylor (IN),Ball State,53,73,1,-20,2013-11-12
South Carolina,Baylor,64,66,1,-2,2013-11-12
Central Michigan,Bradley,70,80,1,-10,2013-11-12
Nevada,Cal Poly,60,58,0,2,2013-11-12
Denver,California,50,77,1,-27,2013-11-12
Hendrix,Central Arkansas,59,109,1,-50,2013-11-12
Jacksonville State,Chicago State,75,79,1,-4,2013-11-12
NC State,Cincinnati,57,68,1,-11,2013-11-12
Presbyterian,Citadel,68,82,1,-14,2013-11-12
Charlotte,College of Charleston,82,83,1,-1,2013-11-12
Manhattan,Columbia,71,70,0,1,2013-11-12
Iowa Wesleyan,Drake,49,104,1,-55,2013-11-12
Kansas,Duke,94,83,0,11,2013-11-12
Morehead State,ETSU,71,63,0,8,2013-11-12
Concordia (MI),Eastern Michigan,50,95,1,-45,2013-11-12
Hartford,Florida Gulf Coast,51,65,1,-14,2013-11-12
Warren Wilson,Florida International,56,93,1,-37,2013-11-12
Gardner-Webb,Furman,64,75,1,-11,2013-11-12
Maine,George Washington,81,108,1,-27,2013-11-12
MIT,Harvard,37,79,1,-42,2013-11-12
New Mexico State,Hawaii,95,88,0,7,2013-11-12
Ferrum,High Point,64,94,1,-30,2013-11-12
Drexel,Illinois State,78,70,0,8,2013-11-12
LIU-Brooklyn,Indiana,72,73,1,-1,2013-11-12
Texas A&M-Corpus Christi,Iowa State,50,80,1,-30,2013-11-12
Evansville,IUPUI,84,78,0,6,2013-11-12
Florida College,Jacksonville,72,101,1,-29,2013-11-12
Michigan State,Kentucky,78,74,0,4,2013-11-12
Quinnipiac,La Salle,67,73,1,-6,2013-11-12
Robert Morris,Lafayette,90,81,0,9,2013-11-12
George Mason,Lamar,68,54,0,14,2013-11-12
Rider,Lehigh,78,92,1,-14,2013-11-12
McNeese State,Louisiana,66,92,1,-26,2013-11-12
Hofstra,Louisville,69,97,1,-28,2013-11-12
Grambling,Marquette,71,114,1,-43,2013-11-12
Rio Grande,Marshall,77,119,1,-42,2013-11-12
Salisbury,Maryland-Eastern Shore,55,95,1,-40,2013-11-12
LSU,UMass,90,92,1,-2,2013-11-12
South Carolina State,Michigan,59,93,1,-34,2013-11-12
Montana,Minnesota,58,84,1,-26,2013-11-12
Southern Illinois,Missouri,59,72,1,-13,2013-11-12
Penn,Monmouth,79,73,0,6,2013-11-12
Brescia,Murray State,69,97,1,-28,2013-11-12
Western Illinois,Nebraska,47,62,1,-15,2013-11-12
UCSB,UNLV,86,65,0,21,2013-11-12
Millsaps,New Orleans,45,81,1,-36,2013-11-12
East Carolina,UNC Greensboro,85,84,0,1,2013-11-12
Colorado Christian,Northern Colorado,74,98,1,-24,2013-11-12
Ohio,Ohio State,69,79,1,-10,2013-11-12
Utah Valley,Oklahoma State,40,93,1,-53,2013-11-12
UC-Irvine,Pacific,79,84,1,-5,2013-11-12
Fresno State,Pitt,54,75,1,-21,2013-11-12
Southeastern Louisiana,Rice,63,62,0,1,2013-11-12
Akron,Saint Mary's,63,85,1,-22,2013-11-12
Hampton,St. Peter's,64,59,0,5,2013-11-12
San Jose State,Santa Clara,77,89,1,-12,2013-11-12
Tennessee Temple,Savannah State,63,73,1,-10,2013-11-12
Bethune-Cookman,South Florida,65,91,1,-26,2013-11-12
Cal State Northridge,USC,79,95,1,-16,2013-11-12
Fordham,Syracuse,74,89,1,-15,2013-11-12
Loyola (IL),Tennessee Tech,69,74,1,-5,2013-11-12
South Alabama,Texas,77,84,1,-7,2013-11-12
Samford,Texas-Arlington,75,88,1,-13,2013-11-12
Longwood,TCU,82,79,0,3,2013-11-12
Stephen F. Austin,Texas State,64,57,0,7,2013-11-12
Morgan State,Towson,75,95,1,-20,2013-11-12
Oakland,UCLA,60,91,1,-31,2013-11-12
Southern Utah,Utah State,57,90,1,-33,2013-11-12
Georgia State,Vanderbilt,80,86,1,-6,2013-11-12
Siena,Vermont,66,77,1,-11,2013-11-12
VCU,Virginia,59,56,0,3,2013-11-12
West Virginia,Virginia Tech,82,87,1,-5,2013-11-12
Chestnut Hill,Wagner,67,75,1,-8,2013-11-12
VMI,Wake Forest,71,98,1,-27,2013-11-12
Western Kentucky,Wichita State,49,66,1,-17,2013-11-12
Liberty,William & Mary,72,84,1,-12,2013-11-12
Florida,Wisconsin,53,59,1,-6,2013-11-12
Tennessee,Xavier,63,67,1,-4,2013-11-12
Mobile,Alabama State,58,88,1,-30,2013-11-13
UT-Martin,Arkansas State,62,72,1,-10,2013-11-13
UMass-Lowell,Boston University,65,91,1,-26,2013-11-13
Sacramento State,Cal State Bakersfield,66,74,1,-8,2013-11-13
Pepperdine,UC-Riverside,69,66,0,3,2013-11-13
Florida State,UCF,80,68,0,12,2013-11-13
UNC Wilmington,Charleston Southern,80,78,0,2,2013-11-13
Delaware State,Clemson,37,58,1,-21,2013-11-13
Wyoming,Colorado,58,63,1,-5,2013-11-13
Binghamton,Cornell,89,79,0,10,2013-11-13
Bryant,Dartmouth,87,77,0,10,2013-11-13
Saint Francis (PA),Dayton,56,70,1,-14,2013-11-13
Southern Miss,DePaul,75,68,0,7,2013-11-13
New Hampshire,Duquesne,84,81,0,3,2013-11-13
Olivet Nazarene,Eastern Illinois,60,67,1,-7,2013-11-13
Warren Wilson,Eastern Kentucky,45,114,1,-69,2013-11-13
Hartford,Fairfield,63,53,0,10,2013-11-13
Wright State,Georgetown,70,88,1,-18,2013-11-13
Sacred Heart,Holy Cross,118,122,1,-4,2013-11-13
Valparaiso,Illinois,52,64,1,-12,2013-11-13
Roosevelt,UIC,65,87,1,-22,2013-11-13
Oral Roberts,Kansas State,63,71,1,-8,2013-11-13
Centenary (LA),Louisiana Tech,59,106,1,-47,2013-11-13
Abilene Christian,Maryland,44,67,1,-23,2013-11-13
Reinhardt,Mercer,53,95,1,-42,2013-11-13
North Florida,Middle Tennessee,70,77,1,-7,2013-11-13
Goucher,Navy,47,98,1,-51,2013-11-13
UMKC,Omaha,71,101,1,-30,2013-11-13
Buffalo,Niagara,81,92,1,-11,2013-11-13
Newberry,Norfolk State,95,115,1,-20,2013-11-13
Minnesota-Morris,North Dakota,69,110,1,-41,2013-11-13
Idaho,Oklahoma,65,85,1,-20,2013-11-13
Howard,Old Dominion,57,77,1,-20,2013-11-13
Western Carolina,Oregon,83,107,1,-24,2013-11-13
Portland,Oregon State,73,79,1,-6,2013-11-13
Bucknell,Penn State,90,80,0,10,2013-11-13
Pacific Lutheran,Portland State,43,79,1,-36,2013-11-13
Brown,Providence,69,73,1,-4,2013-11-13
Central Connecticut,Purdue,73,109,1,-36,2013-11-13
Marist,St. Joseph's,62,81,1,-19,2013-11-13
Cleveland State,San Francisco,82,91,1,-9,2013-11-13
Cal State Fullerton,Seattle,71,75,1,-4,2013-11-13
Kent State,Seton Hall,76,78,1,-2,2013-11-13
Tulane,Southern,79,73,0,6,2013-11-13
Saint Louis,SIU-Edwardsville,82,58,0,24,2013-11-13
Northeastern,Stony Brook,66,73,1,-7,2013-11-13
Howard Payne,Texas-Arlington,64,111,1,-47,2013-11-13
Huston-Tillotson,Texas-Rio Grande Valley,62,94,1,-32,2013-11-13
Mount St. Mary's,Villanova,59,90,1,-31,2013-11-13
USC Upstate,Winthrop,74,82,1,-8,2013-11-13
Jackson State,Air Force,84,82,0,2,2013-11-14
Texas Tech,Alabama,64,76,1,-12,2013-11-14
Alabama-Huntsville,Alabama A&M,73,79,1,-6,2013-11-14
Troy,Alabama-Birmingham,69,81,1,-12,2013-11-14
UMBC,American,61,63,1,-2,2013-11-14
Indiana State,Belmont,95,96,1,-1,2013-11-14
Toledo,Boston College,95,92,0,3,2013-11-14
Detroit,UConn,55,101,1,-46,2013-11-14
Chowan,East Carolina,45,95,1,-50,2013-11-14
Robert Morris,Eastern Michigan,64,69,1,-5,2013-11-14
Stetson,Florida A&M,60,63,1,-3,2013-11-14
Florida College,Florida International,39,85,1,-46,2013-11-14
UTSA,Houston,62,80,1,-18,2013-11-14
Maryland-Eastern Shore,Iowa,63,109,1,-46,2013-11-14
Loyola Marymount,Long Beach State,74,73,0,1,2013-11-14
Austin Peay,Memphis,69,95,1,-26,2013-11-14
Texas Southern,Miami (FL),69,84,1,-15,2013-11-14
Kennesaw State,Mississippi State,55,78,1,-23,2013-11-14
San Diego,Morgan State,68,61,0,7,2013-11-14
Nicholls State,North Texas,78,92,1,-14,2013-11-14
Sam Houston State,Prairie View,108,103,0,5,2013-11-14
Yale,Rutgers,71,72,1,-1,2013-11-14
North Dakota State,Saint Mary's,65,78,1,-13,2013-11-14
Arizona,San Diego State,69,60,0,9,2013-11-14
Florida National University,Savannah State,60,87,1,-27,2013-11-14
Montana,South Dakota State,77,69,0,8,2013-11-14
Champion Baptist,Southeastern Louisiana,54,108,1,-54,2013-11-14
Northwestern,Stanford,58,71,1,-13,2013-11-14
Temple,Towson,69,75,1,-6,2013-11-14
UC-Irvine,Washington,86,72,0,14,2013-11-14
William & Mary,Wichita State,62,79,1,-17,2013-11-14
Warren Wilson,Youngstown State,58,104,1,-46,2013-11-14
Idaho State,Arizona State,60,88,1,-28,2013-11-15
Louisiana,Arkansas,63,76,1,-13,2013-11-15
NJIT,Army,89,85,0,4,2013-11-15
Northwestern State,Auburn,111,92,0,19,2013-11-15
Simpson (CA),Boise State,53,110,1,-57,2013-11-15
South Florida,Bowling Green State,75,61,0,14,2013-11-15
Chicago State,Bradley,64,77,1,-13,2013-11-15
Mount St. Mary's,BYU,76,108,1,-32,2013-11-15
Oakland,California,60,64,1,-4,2013-11-15
Elon,Charlotte,69,83,1,-14,2013-11-15
UNC Asheville,College of Charleston,67,58,0,9,2013-11-15
Florida Atlantic,Duke,64,97,1,-33,2013-11-15
Lehigh,Fordham,72,80,1,-8,2013-11-15
Florida Gulf Coast,Furman,70,69,0,1,2013-11-15
Georgia Tech,Georgia,80,71,0,9,2013-11-15
Fairleigh Dickinson,Hartford,60,74,1,-14,2013-11-15
Howard,Harvard,44,76,1,-32,2013-11-15
Samford,Indiana,59,105,1,-46,2013-11-15
Cornell,Louisville,54,99,1,-45,2013-11-15
Louisiana College,McNeese State,83,92,1,-9,2013-11-15
Columbia,Michigan State,53,62,1,-9,2013-11-15
San Jose State,Milwaukee,61,64,1,-3,2013-11-15
Champion Baptist,Mississippi Valley State,48,108,1,-60,2013-11-15
Omaha,UNLV,70,73,1,-3,2013-11-15
UTEP,New Mexico State,73,86,1,-13,2013-11-15
Virginia Union,Norfolk State,84,92,1,-8,2013-11-15
Holy Cross,UNC,54,62,1,-8,2013-11-15
James Madison,Northern Illinois,60,55,0,5,2013-11-15
Arkansas-Pine Bluff,Oklahoma State,63,97,1,-34,2013-11-15
Murray State,Old Dominion,60,70,1,-10,2013-11-15
North Carolina A&T,Rhode Island,59,72,1,-13,2013-11-15
Nevada,San Francisco,92,90,0,2,2013-11-15
Northern Arizona,USC,63,67,1,-4,2013-11-15
Wagner,St. John's (NY),57,73,1,-16,2013-11-15
Rochester (MI),UT-Martin,64,79,1,-15,2013-11-15
Texas-Rio Grande Valley,Tennessee Tech,81,78,0,3,2013-11-15
Stephen F. Austin,Texas,62,72,1,-10,2013-11-15
Rice,Texas A&M,65,68,1,-3,2013-11-15
Purdue-Fort Wayne,Texas A&M-Corpus Christi,71,72,1,-1,2013-11-15
Cleveland State,Texas-Arlington,83,73,0,10,2013-11-15
UC-Davis,Utah,60,94,1,-34,2013-11-15
Lipscomb,Vanderbilt,69,80,1,-11,2013-11-15
Western Carolina,Virginia Tech,61,79,1,-18,2013-11-15
Presbyterian,Wake Forest,48,69,1,-21,2013-11-15
Morehead State,Xavier,56,79,1,-23,2013-11-15
Navy,Binghamton,68,50,0,18,2013-11-16
Mesa State,BYU,60,84,1,-24,2013-11-16
Vermont,Bryant,64,87,1,-23,2013-11-16
Saint Francis (PA),Bucknell,50,72,1,-22,2013-11-16
West Virginia Wesleyan,Buffalo,60,80,1,-20,2013-11-16
Princeton,Butler,67,70,1,-3,2013-11-16
Santa Clara,Cal State Fullerton,73,86,1,-13,2013-11-16
Montana State,UC-Riverside,67,72,1,-5,2013-11-16
Utah State,UCSB,71,64,0,7,2013-11-16
Pepperdine,Central Michigan,88,71,0,17,2013-11-16
Montreat,Chattanooga,51,108,1,-57,2013-11-16
Appalachian State,Cincinnati,49,77,1,-28,2013-11-16
North Greenville,Citadel,53,83,1,-30,2013-11-16
Ole Miss,Coastal Carolina,72,70,0,2,2013-11-16
Jackson State,Colorado,70,94,1,-24,2013-11-16
Weber State,Colorado State,67,88,1,-21,2013-11-16
UMass-Lowell,Dartmouth,59,77,1,-18,2013-11-16
Virginia,Davidson,70,57,0,13,2013-11-16
St. Francis (NY),Dayton,58,78,1,-20,2013-11-16
Wright State,DePaul,72,81,1,-9,2013-11-16
High Point,Eastern Kentucky,67,74,1,-7,2013-11-16
Little Rock,Florida,56,86,1,-30,2013-11-16
Texas Southern,Florida International,68,70,1,-2,2013-11-16
Cal State Northridge,Fresno State,64,80,1,-16,2013-11-16
Jacksonville,Gardner-Webb,78,87,1,-9,2013-11-16
Northern Iowa,George Mason,70,76,1,-6,2013-11-16
Toccoa Falls,Georgia Southern,50,104,1,-54,2013-11-16
Western New Mexico,Grand Canyon,41,91,1,-50,2013-11-16
Wisconsin,Green Bay,69,66,0,3,2013-11-16
Missouri,Hawaii,92,80,0,12,2013-11-16
Incarnate Word,Huston-Tillotson,85,78,0,7,2013-11-16
Northwest Nazarene,Idaho,64,78,1,-14,2013-11-16
Eastern Illinois,UIC,86,66,0,20,2013-11-16
Wofford,Iona,55,76,1,-21,2013-11-16
Texas-Rio Grande Valley,Purdue-Fort Wayne,60,66,1,-6,2013-11-16
Southeast Missouri State,IUPUI,76,68,0,8,2013-11-16
Alabama State,Jacksonville State,84,73,0,11,2013-11-16
Milwaukee,James Madison,77,66,0,11,2013-11-16
Siena,La Salle,74,78,1,-4,2013-11-16
Western Carolina,Liberty,68,63,0,5,2013-11-16
Mars Hill,Longwood,70,88,1,-18,2013-11-16
Northwestern State,LSU,74,88,1,-14,2013-11-16
Fairfield,Loyola (MD),52,59,1,-7,2013-11-16
George Washington,Manhattan,80,74,0,6,2013-11-16
Ohio State,Marquette,52,35,0,17,2013-11-16
Seton Hall,Mercer,74,77,1,-3,2013-11-16
Akron,Middle Tennessee,73,80,1,-7,2013-11-16
Tulsa,Missouri State,93,96,1,-3,2013-11-16
Campbell,NC State,66,81,1,-15,2013-11-16
Wingate,UNC Wilmington,61,80,1,-19,2013-11-16
Southern,North Florida,87,78,0,9,2013-11-16
Central Connecticut,Northeastern,69,83,1,-14,2013-11-16
San Jose State,Northern Illinois,59,60,1,-1,2013-11-16
San Diego,Northern Kentucky,75,44,0,31,2013-11-16
Texas State,Oral Roberts,65,82,1,-17,2013-11-16
Penn State,Penn,83,71,0,12,2013-11-16
Marist,Providence,48,93,1,-45,2013-11-16
Albany (NY),Quinnipiac,69,79,1,-10,2013-11-16
Brevard,Radford,57,105,1,-48,2013-11-16
Minnesota,Richmond,74,59,0,15,2013-11-16
Brown,Sacred Heart,85,73,0,12,2013-11-16
Creighton,St. Joseph's,83,79,0,4,2013-11-16
Drake,Saint Mary's,63,67,1,-4,2013-11-16
Evergreen State,Seattle,59,100,1,-41,2013-11-16
Saint Louis,Southern Illinois,76,67,0,9,2013-11-16
Central Arkansas,SIU-Edwardsville,93,100,1,-7,2013-11-16
Canisius,St. Bonaventure,64,86,1,-22,2013-11-16
Colgate,Syracuse,50,69,1,-19,2013-11-16
USC Upstate,Tennessee,65,74,1,-9,2013-11-16
Tennessee Tech,Texas A&M-Corpus Christi,62,60,0,2,2013-11-16
Loyola (IL),Tulane,59,65,1,-6,2013-11-16
Winthrop,VCU,71,92,1,-21,2013-11-16
Bluefield State,VMI,80,121,1,-41,2013-11-16
ETSU,Western Kentucky,50,57,1,-7,2013-11-16
Tennessee State,Wichita State,71,85,1,-14,2013-11-16
Arkansas State,Wyoming,64,85,1,-21,2013-11-16
Arkansas-Pine Bluff,Air Force,64,67,1,-3,2013-11-17
Louisiana,Baylor,68,87,1,-19,2013-11-17
Florida Atlantic,Boston College,79,82,1,-3,2013-11-17
Pacifica,UC-Irvine,73,110,1,-37,2013-11-17
Bethune-Cookman,UCF,63,83,1,-20,2013-11-17
South Carolina,Clemson,57,71,1,-14,2013-11-17
Boston University,UConn,60,77,1,-17,2013-11-17
Stanford,Denver,66,57,0,9,2013-11-17
UT-Martin,Florida State,61,89,1,-28,2013-11-17
Oakland,Gonzaga,67,82,1,-15,2013-11-17
Delaware,Hampton,90,79,0,11,2013-11-17
Lehigh,Houston,66,80,1,-14,2013-11-17
Bradley,Illinois,55,81,1,-26,2013-11-17
Stony Brook,Indiana,74,90,1,-16,2013-11-17
Abilene Christian,Iowa,41,103,1,-62,2013-11-17
Michigan,Iowa State,70,77,1,-7,2013-11-17
Tennessee Tech,Purdue-Fort Wayne,66,69,1,-3,2013-11-17
San Jose State,James Madison,66,79,1,-13,2013-11-17
Long Beach State,Kansas State,58,71,1,-13,2013-11-17
St. Peter's,Kent State,58,75,1,-17,2013-11-17
Robert Morris,Kentucky,49,87,1,-38,2013-11-17
Northern Arizona,Loyola Marymount,78,90,1,-12,2013-11-17
Oregon State,Maryland,90,83,0,7,2013-11-17
Mount St. Mary's,UMBC,84,90,1,-6,2013-11-17
Youngstown State,UMass,69,85,1,-16,2013-11-17
Marshall,Morehead State,94,102,1,-8,2013-11-17
South Carolina State,Nebraska,57,83,1,-26,2013-11-17
NJIT,New Hampshire,71,63,0,8,2013-11-17
Charleston Southern,New Mexico,93,109,1,-16,2013-11-17
Belmont,UNC,83,80,0,3,2013-11-17
Chowan,UNC Greensboro,58,97,1,-39,2013-11-17
Milwaukee,Northern Illinois,82,69,0,13,2013-11-17
Illinois State,Northwestern,68,64,0,4,2013-11-17
Indiana State,Notre Dame,83,70,0,13,2013-11-17
Valparaiso,Ohio,72,76,1,-4,2013-11-17
Western Illinois,Pacific,52,66,1,-14,2013-11-17
Howard,Pitt,52,84,1,-32,2013-11-17
Rider,Purdue,77,81,1,-4,2013-11-17
Texas-Rio Grande Valley,Texas A&M-Corpus Christi,61,72,1,-11,2013-11-17
West Alabama,UTEP,46,67,1,-21,2013-11-17
Towson,Villanova,44,78,1,-34,2013-11-17
Eastern Washington,Washington,80,92,1,-12,2013-11-17
Lamar,Washington State,64,84,1,-20,2013-11-17
Duquesne,West Virginia,83,96,1,-13,2013-11-17
Alabama A&M,Western Michigan,69,73,1,-4,2013-11-17
Stillman,Alabama,65,102,1,-37,2013-11-18
Chicago State,Alabama State,75,79,1,-4,2013-11-18
Dillard,Alcorn State,51,91,1,-40,2013-11-18
Fairleigh Dickinson,Arizona,50,100,1,-50,2013-11-18
SMU,Arkansas,78,89,1,-11,2013-11-18
Southeast Missouri State,Ball State,83,87,1,-4,2013-11-18
Nevada,Cal State Bakersfield,66,74,1,-8,2013-11-18
Southern Utah,California,47,75,1,-28,2013-11-18
North Carolina Central,Campbell,62,43,0,19,2013-11-18
Miami (FL),College of Charleston,70,54,0,16,2013-11-18
Arkansas State,Colorado,70,93,1,-23,2013-11-18
Wagner,Coppin State,102,87,0,15,2013-11-18
Elon,Drexel,64,71,1,-7,2013-11-18
UNC Asheville,Duke,55,91,1,-36,2013-11-18
Norfolk State,East Carolina,74,76,1,-2,2013-11-18
Cleveland State,Eastern Michigan,69,81,1,-12,2013-11-18
Mercer,Evansville,76,89,1,-13,2013-11-18
Southern,Florida,53,67,1,-14,2013-11-18
Eckerd,Florida Gulf Coast,55,72,1,-17,2013-11-18
Stetson,Florida International,66,75,1,-9,2013-11-18
McNeese State,Georgia State,70,96,1,-26,2013-11-18
UNC Wilmington,Liberty,87,76,0,11,2013-11-18
Samford,Louisiana-Monroe,52,86,1,-34,2013-11-18
Rhode Island,Metropolitan State,66,63,0,3,2013-11-18
Portland,Michigan State,67,82,1,-15,2013-11-18
Little Rock,Middle Tennessee,59,76,1,-17,2013-11-18
Southern Miss,North Dakota State,70,69,0,1,2013-11-18
Savannah State,North Florida,63,66,1,-3,2013-11-18
Toccoa Falls,Presbyterian,76,86,1,-10,2013-11-18
Vermont,Providence,49,70,1,-21,2013-11-18
Canisius,Rutgers,51,66,1,-15,2013-11-18
Idaho State,San Francisco,93,90,0,3,2013-11-18
Monmouth,Seton Hall,66,82,1,-16,2013-11-18
William Carey,South Alabama,53,76,1,-23,2013-11-18
Southwest State (MN),South Dakota State,62,83,1,-21,2013-11-18
St. Francis (NY),Syracuse,50,56,1,-6,2013-11-18
Citadel,Tennessee,60,86,1,-26,2013-11-18
Lipscomb,Tennessee State,75,70,0,5,2013-11-18
Houston Baptist,Texas,61,89,1,-28,2013-11-18
McMurry,UTSA,73,71,0,2,2013-11-18
Texas Southern,Texas Tech,71,80,1,-9,2013-11-18
Florida A&M,Toledo,69,79,1,-10,2013-11-18
Sacramento State,UCLA,50,86,1,-36,2013-11-18
VMI,Virginia Tech,92,105,1,-13,2013-11-18
Jacksonville,Wake Forest,83,90,1,-7,2013-11-18
Manchester,Wright State,33,83,1,-50,2013-11-18
Jackson State,Wyoming,65,73,1,-8,2013-11-18
Georgia State,Alabama,58,75,1,-17,2013-11-19
Lees-McRae,Appalachian State,63,91,1,-28,2013-11-19
Rhode Island,Arizona,59,87,1,-28,2013-11-19
Delaware,Army,89,74,0,15,2013-11-19
Jacksonville State,Auburn,54,78,1,-24,2013-11-19
Southern Illinois,Austin Peay,70,72,1,-2,2013-11-19
Trinity (FL),Bethune-Cookman,55,98,1,-43,2013-11-19
Seattle,Boise State,68,86,1,-18,2013-11-19
Vanderbilt,Butler,77,85,1,-8,2013-11-19
Elon,Canisius,85,86,1,-1,2013-11-19
Kennesaw State,Chattanooga,73,69,0,4,2013-11-19
East Carolina,Duke,74,83,1,-9,2013-11-19
Winthrop,ETSU,76,66,0,10,2013-11-19
Alabama A&M,Eastern Kentucky,68,82,1,-14,2013-11-19
Walla Walla,Eastern Washington,44,82,1,-38,2013-11-19
Metropolitan State,Fairleigh Dickinson,87,76,0,11,2013-11-19
Allen,Gardner-Webb,51,92,1,-41,2013-11-19
Saint Francis (PA),George Mason,46,58,1,-12,2013-11-19
Delaware State,George Washington,50,94,1,-44,2013-11-19
Northwood (TX),Incarnate Word,94,106,1,-12,2013-11-19
Indiana-Northwest,IUPUI,53,88,1,-35,2013-11-19
Detroit,James Madison,71,67,0,4,2013-11-19
Iona,Kansas,66,86,1,-20,2013-11-19
Texas-Arlington,Kentucky,76,105,1,-29,2013-11-19
New Orleans,LSU,54,81,1,-27,2013-11-19
Hartford,Louisville,48,87,1,-39,2013-11-19
Rockhurst,Loyola (IL),65,83,1,-18,2013-11-19
NJIT,Maine,88,82,0,6,2013-11-19
Brown,UMass-Lowell,87,76,0,11,2013-11-19
Stillman,McNeese State,72,81,1,-9,2013-11-19
DePaul,Milwaukee,80,71,0,9,2013-11-19
Coastal Carolina,Minnesota,72,82,1,-10,2013-11-19
Mississippi Valley State,Mississippi State,72,94,1,-22,2013-11-19
Bethel (TN),Murray State,64,91,1,-27,2013-11-19
South Carolina State,Omaha,59,91,1,-32,2013-11-19
Arizona State,UNLV,86,80,0,6,2013-11-19
UNC Asheville,Norfolk State,78,80,1,-2,2013-11-19
Morehead State,Northern Kentucky,74,61,0,13,2013-11-19
Memphis,Oklahoma State,80,101,1,-21,2013-11-19
Utah Valley,Oregon,54,69,1,-15,2013-11-19
La Salle,Penn State,72,79,1,-7,2013-11-19
Hofstra,Richmond,63,74,1,-11,2013-11-19
Drexel,Rutgers,70,59,0,11,2013-11-19
St. Bonaventure,Siena,70,72,1,-2,2013-11-19
Cal State Fullerton,USC,62,76,1,-14,2013-11-19
Bucknell,St. John's (NY),63,67,1,-4,2013-11-19
Prairie View,Texas A&M,65,75,1,-10,2013-11-19
Abilene Christian,TCU,64,71,1,-7,2013-11-19
Colorado State,UTEP,74,82,1,-8,2013-11-19
Nicholls State,Troy,62,77,1,-15,2013-11-19
Navy,Virginia,42,67,1,-25,2013-11-19
North Dakota,Wisconsin,85,103,1,-18,2013-11-19
Sacred Heart,Yale,65,80,1,-15,2013-11-19
Colorado Christian,Air Force,51,78,1,-27,2013-11-20
Charleston Southern,Baylor,64,69,1,-5,2013-11-20
Lipscomb,Belmont,64,94,1,-30,2013-11-20
Iowa State,BYU,90,88,0,2,2013-11-20
Louisiana Tech,Central Arkansas,94,57,0,37,2013-11-20
Campbell,Cincinnati,62,81,1,-19,2013-11-20
Cornell,Colgate,58,81,1,-23,2013-11-20
Albany (NY),Duquesne,59,70,1,-11,2013-11-20
Valparaiso,Evansville,92,100,1,-8,2013-11-20
Holy Cross,Fairfield,63,49,0,14,2013-11-20
Cal Poly,Fresno State,46,63,1,-17,2013-11-20
Dayton,Georgia Tech,82,72,0,10,2013-11-20
Bryant,Harvard,68,86,1,-18,2013-11-20
Northwestern,UIC,93,58,0,35,2013-11-20
Manhattan,Illinois State,79,70,0,9,2013-11-20
Purdue Calumet,Purdue-Fort Wayne,72,106,1,-34,2013-11-20
Loyola (MD),UMBC,89,83,0,6,2013-11-20
Mount St. Mary's,Maryland-Eastern Shore,71,78,1,-7,2013-11-20
Johnson & Wales (NC),Mercer,56,109,1,-53,2013-11-20
Grambling,Missouri State,67,97,1,-30,2013-11-20
Ohio,Morgan State,65,62,0,3,2013-11-20
Northern Colorado,New Mexico State,63,67,1,-4,2013-11-20
Greensboro,UNC Greensboro,62,92,1,-30,2013-11-20
North Carolina Central,NC State,82,72,0,10,2013-11-20
American,Ohio State,52,63,1,-11,2013-11-20
San Jose State,Pepperdine,83,77,0,6,2013-11-20
Lehigh,Pitt,58,77,1,-19,2013-11-20
Lafayette,Princeton,80,81,1,-1,2013-11-20
Eastern Illinois,Purdue,55,83,1,-28,2013-11-20
Hampton,Quinnipiac,68,71,1,-3,2013-11-20
Jarvis Christian,Sam Houston State,48,98,1,-50,2013-11-20
San Diego Christian,San Diego State,41,93,1,-52,2013-11-20
Texas State,SMU,49,70,1,-21,2013-11-20
UMKC,UT-Martin,79,67,0,12,2013-11-20
Rice,Texas A&M-Corpus Christi,63,61,0,2,2013-11-20
Cedarville,Tulane,58,68,1,-10,2013-11-20
Wichita State,Tulsa,77,54,0,23,2013-11-20
Bridgewater (VA),VMI,86,112,1,-26,2013-11-20
North Dakota State,Western Michigan,83,74,0,9,2013-11-20
High Point,William & Mary,80,69,0,11,2013-11-20
Miami (OH),Xavier,51,77,1,-26,2013-11-20
Thiel,Youngstown State,58,82,1,-24,2013-11-20
New Mexico,Alabama-Birmingham,97,94,0,3,2013-11-21
Florida International,Bethune-Cookman,82,67,0,15,2013-11-21
UConn,Boston College,72,70,0,2,2013-11-21
Montana State,Cal State Northridge,73,74,1,-1,2013-11-21
Austin Peay,Central Michigan,75,90,1,-15,2013-11-21
Kansas State,Charlotte,61,68,1,-7,2013-11-21
Temple,Clemson,58,72,1,-14,2013-11-21
UCSB,Colorado,68,76,1,-8,2013-11-21
North Texas,Columbia,66,70,1,-4,2013-11-21
Georgia,Davidson,82,94,1,-12,2013-11-21
Samford,ETSU,75,89,1,-14,2013-11-21
Middle Tennessee,Florida,59,79,1,-20,2013-11-21
VCU,Florida State,67,85,1,-18,2013-11-21
Northeastern,Georgetown,63,56,0,7,2013-11-21
Washington State,Gonzaga,74,90,1,-16,2013-11-21
Hawaii-Hilo,Hawaii,63,114,1,-51,2013-11-21
Howard,Houston,62,75,1,-13,2013-11-21
Washington,Indiana,84,102,1,-18,2013-11-21
Western Carolina,Kent State,59,72,1,-13,2013-11-21
Savannah State,Lamar,66,75,1,-9,2013-11-21
Michigan,Long Beach State,85,61,0,24,2013-11-21
New Hampshire,Marquette,53,58,1,-5,2013-11-21
Stephen F. Austin,Marshall,80,73,0,7,2013-11-21
Nebraska,UMass,90,96,1,-6,2013-11-21
UCF,Miami (FL),63,58,0,5,2013-11-21
Wofford,Minnesota,57,79,1,-22,2013-11-21
USC Upstate,Niagara,83,74,0,9,2013-11-21
Webber,North Florida,64,109,1,-45,2013-11-21
Louisiana-Monroe,Northwestern State,84,80,0,4,2013-11-21
Presbyterian,Old Dominion,51,69,1,-18,2013-11-21
Idaho,Portland,74,88,1,-14,2013-11-21
Texas-Arlington,Robert Morris,81,88,1,-7,2013-11-21
Oral Roberts,Saint Louis,55,72,1,-17,2013-11-21
San Diego Christian,San Diego,46,82,1,-36,2013-11-21
West Alabama,USC,57,73,1,-16,2013-11-21
Missouri S&T,Southern Illinois,74,96,1,-22,2013-11-21
Texas Southern,Stanford,71,97,1,-26,2013-11-21
Indiana-Kokomo,Tennessee Tech,39,92,1,-53,2013-11-21
Texas-Rio Grande Valley,UTSA,70,55,0,15,2013-11-21
South Dakota State,Texas Tech,54,68,1,-14,2013-11-21
Grand Canyon,Utah,54,79,1,-25,2013-11-21
Vermont,Wagner,61,68,1,-7,2013-11-21
Citadel,Wake Forest,54,82,1,-28,2013-11-21
Georgia Southern,West Virginia,68,101,1,-33,2013-11-21
Eureka,Western Illinois,52,79,1,-27,2013-11-21
UNC Wilmington,Western Kentucky,58,73,1,-15,2013-11-21
Bowling Green State,Wisconsin,64,88,1,-24,2013-11-21
Western New Mexico,Abilene Christian,44,62,1,-18,2013-11-22
Nebraska,Alabama-Birmingham,74,87,1,-13,2013-11-22
Bradley,Arizona State,58,70,1,-12,2013-11-22
Cal State Northridge,Austin Peay,80,77,0,3,2013-11-22
Washington,Boston College,78,89,1,-11,2013-11-22
Eastern Washington,Boston University,80,68,0,12,2013-11-22
SIU-Edwardsville,UC-Davis,75,80,1,-5,2013-11-22
LIU-Brooklyn,UC-Irvine,64,84,1,-20,2013-11-22
Montana State,Central Michigan,59,54,0,5,2013-11-22
Northeastern,Charlotte,77,86,1,-9,2013-11-22
Davidson,Clemson,54,85,1,-31,2013-11-22
Northern Colorado,Colorado State,65,72,1,-7,2013-11-22
Indiana,UConn,58,59,1,-1,2013-11-22
Siena,Cornell,71,70,0,1,2013-11-22
Florida Atlantic,Detroit,44,77,1,-33,2013-11-22
Brescia,Eastern Kentucky,56,95,1,-39,2013-11-22
Michigan,Florida State,82,80,0,2,2013-11-22
Kansas State,Georgetown,63,90,1,-27,2013-11-22
Temple,Georgia,83,81,0,2,2013-11-22
Savannah State,Grand Canyon,71,72,1,-1,2013-11-22
Wright State,Houston Baptist,75,59,0,16,2013-11-22
North Texas,Idaho,76,87,1,-11,2013-11-22
Chicago State,Illinois,53,77,1,-24,2013-11-22
Truman State,Indiana State,69,80,1,-11,2013-11-22
Penn,Iowa,55,86,1,-31,2013-11-22
Dalton State,Jacksonville State,61,85,1,-24,2013-11-22
Towson,Kansas,58,88,1,-30,2013-11-22
USC Upstate,Kent State,78,79,1,-1,2013-11-22
Morgan State,La Salle,59,78,1,-19,2013-11-22
VCU,Long Beach State,73,67,0,6,2013-11-22
Brown,Longwood,81,69,0,12,2013-11-22
Southeastern Louisiana,LSU,66,89,1,-23,2013-11-22
Northern Iowa,Loyola Marymount,90,81,0,9,2013-11-22
Maryland,Marist,68,43,0,25,2013-11-22
New Mexico,UMass,65,81,1,-16,2013-11-22
Virginia Tech,Michigan State,77,96,1,-19,2013-11-22
Mississippi Valley State,Ole Miss,82,111,1,-29,2013-11-22
San Francisco,Montana,75,74,0,1,2013-11-22
Chattanooga,Nevada,81,83,1,-2,2013-11-22
Western Carolina,Niagara,98,90,0,8,2013-11-22
Appalachian State,North Carolina Central,70,76,1,-6,2013-11-22
IUPUI,Northwestern,61,63,1,-2,2013-11-22
Santa Clara,Notre Dame,69,84,1,-15,2013-11-22
Seton Hall,Oklahoma,85,86,1,-1,2013-11-22
Columbia,Portland,52,69,1,-17,2013-11-22
Loyola (IL),Portland State,63,67,1,-4,2013-11-22
Vanderbilt,Providence,60,67,1,-7,2013-11-22
Southern Miss,South Alabama,66,59,0,7,2013-11-22
Stetson,South Florida,63,72,1,-9,2013-11-22
Mid-Continent,Southeast Missouri State,64,109,1,-45,2013-11-22
Little Rock,Southern,85,82,0,3,2013-11-22
Incarnate Word,Southwestern (TX),80,61,0,19,2013-11-22
Monmouth,St. John's (NY),54,64,1,-10,2013-11-22
Toledo,Stony Brook,103,99,0,4,2013-11-22
Tennessee State,Tennessee,67,88,1,-21,2013-11-22
Jackson State,UT-Martin,68,64,0,4,2013-11-22
Morehead State,UCLA,70,81,1,-11,2013-11-22
Lamar,Utah,57,84,1,-27,2013-11-22
Delaware,Villanova,80,84,1,-4,2013-11-22
South Dakota,Wyoming,53,70,1,-17,2013-11-22
Northern New Mexico,Abilene Christian,56,78,1,-22,2013-11-23
Bucknell,Albany (NY),77,64,0,13,2013-11-23
Murray State,Auburn,67,75,1,-8,2013-11-23
Montana State,Austin Peay,72,78,1,-6,2013-11-23
Butler,Ball State,59,58,0,1,2013-11-23
Holy Cross,Belmont,70,81,1,-11,2013-11-23
Radford,Binghamton,69,63,0,6,2013-11-23
Bethesda,Cal Poly,39,78,1,-39,2013-11-23
Idaho State,Cal State Bakersfield,69,71,1,-2,2013-11-23
Loyola (IL),UC-Davis,61,64,1,-3,2013-11-23
Boston University,UC-Irvine,74,68,0,6,2013-11-23
Rider,Central Connecticut,89,73,0,16,2013-11-23
Cal State Northridge,Central Michigan,76,90,1,-14,2013-11-23
Robert Morris,Cleveland State,74,87,1,-13,2013-11-23
St. Francis (NY),Coastal Carolina,59,70,1,-11,2013-11-23
Saint Francis (PA),Colgate,64,81,1,-17,2013-11-23
Furman,College of Charleston,55,89,1,-34,2013-11-23
Idaho,Columbia,60,65,1,-5,2013-11-23
Tulsa,Creighton,72,82,1,-10,2013-11-23
Toledo,Detroit,80,78,0,2,2013-11-23
Omaha,Drake,80,88,1,-8,2013-11-23
Stephen F. Austin,ETSU,58,66,1,-8,2013-11-23
Roosevelt,Eastern Illinois,67,89,1,-22,2013-11-23
Texas-Arlington,Eastern Michigan,69,74,1,-5,2013-11-23
LIU-Brooklyn,Eastern Washington,70,102,1,-32,2013-11-23
Anderson (IN),Evansville,68,91,1,-23,2013-11-23
Louisville,Fairfield,71,57,0,14,2013-11-23
St. Peter's,Fairleigh Dickinson,67,63,0,4,2013-11-23
Stony Brook,Florida Atlantic,67,61,0,6,2013-11-23
Ave Maria,Florida Gulf Coast,56,79,1,-23,2013-11-23
Sacred Heart,Fordham,85,73,0,12,2013-11-23
Lamar,Grand Canyon,69,78,1,-9,2013-11-23
Minnesota-Duluth,Green Bay,57,92,1,-35,2013-11-23
Hofstra,Hartford,81,78,0,3,2013-11-23
Southern Miss,Houston Baptist,67,62,0,5,2013-11-23
George Mason,Iona,73,89,1,-16,2013-11-23
Florida A&M,Jacksonville,72,76,1,-4,2013-11-23
Niagara,Kent State,97,102,1,-5,2013-11-23
Oakland,Louisiana,75,84,1,-9,2013-11-23
Marist,Loyola Marymount,70,76,1,-6,2013-11-23
UNC Wilmington,Marshall,78,96,1,-18,2013-11-23
Nicholls State,Memphis,59,98,1,-39,2013-11-23
Yale,Mercer,54,81,1,-27,2013-11-23
Wilmington (OH),Miami (OH),65,63,0,2,2013-11-23
Oklahoma,Michigan State,76,87,1,-11,2013-11-23
Gardner-Webb,Missouri,63,72,1,-9,2013-11-23
Vanderbilt,Morgan State,75,66,0,9,2013-11-23
American,Mount St. Mary's,64,68,1,-4,2013-11-23
UMBC,Navy,58,73,1,-15,2013-11-23
Boise State,New Orleans,100,80,0,20,2013-11-23
Lafayette,NJIT,88,91,1,-3,2013-11-23
Richmond,UNC,72,82,1,-10,2013-11-23
San Diego Christian,Northern Arizona,59,83,1,-24,2013-11-23
Heidelberg,Ohio,57,85,1,-28,2013-11-23
Georgia Southern,Old Dominion,69,86,1,-17,2013-11-23
Fresno State,Pacific,77,86,1,-9,2013-11-23
Utah Valley,Pepperdine,53,58,1,-5,2013-11-23
North Texas,Portland,77,72,0,5,2013-11-23
SIU-Edwardsville,Portland State,74,77,1,-3,2013-11-23
UMass-Lowell,Rhode Island,68,79,1,-11,2013-11-23
Princeton,Rice,70,56,0,14,2013-11-23
William & Mary,Rutgers,72,62,0,10,2013-11-23
Bowling Green State,Saint Louis,47,74,1,-27,2013-11-23
Cal State Fullerton,San Jose State,59,81,1,-22,2013-11-23
Virginia Tech,Seton Hall,67,68,1,-1,2013-11-23
Wright State,South Alabama,70,74,1,-4,2013-11-23
Voorhees,South Carolina State,74,88,1,-14,2013-11-23
Western Carolina,USC Upstate,58,72,1,-14,2013-11-23
UC-Riverside,Southern Utah,74,59,0,15,2013-11-23
Milwaukee,Tennessee Tech,70,63,0,7,2013-11-23
New Mexico State,UTEP,77,68,0,9,2013-11-23
Texas A&M-Corpus Christi,UTSA,76,87,1,-11,2013-11-23
Northern Kentucky,Tulane,91,86,0,5,2013-11-23
Savannah State,Utah,57,71,1,-14,2013-11-23
Mississippi State,Utah State,68,87,1,-19,2013-11-23
James Madison,Valparaiso,49,81,1,-32,2013-11-23
Liberty,Virginia,53,75,1,-22,2013-11-23
Presbyterian,West Virginia,55,88,1,-33,2013-11-23
Samford,Western Kentucky,64,67,1,-3,2013-11-23
Virginia Intermont,Winthrop,62,96,1,-34,2013-11-23
Oral Roberts,Wisconsin,67,76,1,-9,2013-11-23
Westminster (PA),Youngstown State,57,108,1,-51,2013-11-23
Temple,Alabama-Birmingham,87,66,0,21,2013-11-24
Central Arkansas,Arkansas State,56,99,1,-43,2013-11-24
Hofstra,Belmont,75,85,1,-10,2013-11-24
LIU-Brooklyn,Boston University,57,72,1,-15,2013-11-24
Eastern Washington,UC-Irvine,58,81,1,-23,2013-11-24
Michigan,Charlotte,61,63,1,-2,2013-11-24
UMass,Clemson,62,56,0,6,2013-11-24
Louisiana,Coastal Carolina,73,69,0,4,2013-11-24
Harvard,Colorado,62,70,1,-8,2013-11-24
New Mexico,Davidson,79,58,0,21,2013-11-24
Stony Brook,Detroit,104,102,0,2,2013-11-24
Vermont,Duke,90,91,1,-1,2013-11-24
Richmond,Fairfield,68,47,0,21,2013-11-24
Toledo,Florida Atlantic,94,74,0,20,2013-11-24
Northeastern,Florida State,60,62,1,-2,2013-11-24
VCU,Georgetown,80,84,1,-4,2013-11-24
Nebraska,Georgia,73,65,0,8,2013-11-24
North Carolina A&T,Georgia Tech,71,78,1,-7,2013-11-24
Holy Cross,Hartford,80,55,0,25,2013-11-24
Wofford,High Point,56,66,1,-10,2013-11-24
Long Beach State,Kansas State,38,52,1,-14,2013-11-24
Purdue-Fort Wayne,Kennesaw State,76,66,0,10,2013-11-24
Providence,La Salle,71,63,0,8,2013-11-24
UNC,Louisville,93,84,0,9,2013-11-24
SIU-Edwardsville,Loyola (IL),72,73,1,-1,2013-11-24
Northern Iowa,Maryland,66,80,1,-14,2013-11-24
Hampton,Missouri State,67,81,1,-14,2013-11-24
Morehead State,Nevada,63,58,0,5,2013-11-24
Bryant,New Hampshire,60,55,0,5,2013-11-24
North Dakota State,North Dakota,77,95,1,-18,2013-11-24
Saint Joseph's (IN),Northern Illinois,61,111,1,-50,2013-11-24
Army,Notre Dame,60,93,1,-33,2013-11-24
St. Francis (NY),Oakland,68,62,0,6,2013-11-24
San Francisco,Oregon,82,100,1,-18,2013-11-24
Longwood,Penn State,67,93,1,-26,2013-11-24
UC-Davis,Portland State,63,79,1,-16,2013-11-24
Siena,Purdue,73,81,1,-8,2013-11-24
Alcorn State,Saint Mary's,55,72,1,-17,2013-11-24
Houston Baptist,South Alabama,59,79,1,-20,2013-11-24
Florida International,South Carolina,72,84,1,-12,2013-11-24
Arkansas-Pine Bluff,SMU,61,87,1,-26,2013-11-24
William Carey,Southern Miss,54,99,1,-45,2013-11-24
Sam Houston State,Texas A&M,62,79,1,-17,2013-11-24
Chattanooga,UCLA,65,106,1,-41,2013-11-24
TCU,Washington State,64,62,0,2,2013-11-24
Jacksonville State,Alabama A&M,76,69,0,7,2013-11-25
Marquette,Arizona State,77,79,1,-2,2013-11-25
California,Arkansas,85,77,0,8,2013-11-25
Texas,BYU,82,86,1,-4,2013-11-25
Georgia State,Canisius,71,79,1,-8,2013-11-25
Baylor,Chaminade,93,77,0,16,2013-11-25
Montreat,Citadel,64,109,1,-45,2013-11-25
Prairie View,Colorado State,68,95,1,-27,2013-11-25
Ohio Valley,Coppin State,79,96,1,-17,2013-11-25
Radford,Cornell,86,71,0,15,2013-11-25
Gonzaga,Dayton,79,84,1,-5,2013-11-25
Delaware,Delaware State,80,70,0,10,2013-11-25
Wichita State,DePaul,90,72,0,18,2013-11-25
McNeese State,East Carolina,62,91,1,-29,2013-11-25
Metropolitan State,Elon,75,74,0,1,2013-11-25
Norfolk State,Fairleigh Dickinson,70,62,0,8,2013-11-25
San Diego Christian,Fresno State,59,92,1,-33,2013-11-25
Stanford,Houston,86,76,0,10,2013-11-25
San Diego,UIC,70,74,1,-4,2013-11-25
UMKC,Iowa State,51,110,1,-59,2013-11-25
Florida,Jacksonville,86,60,0,26,2013-11-25
Cleveland State,Kentucky,61,68,1,-7,2013-11-25
Northern Iowa,La Salle,65,50,0,15,2013-11-25
Texas Southern,Lehigh,63,67,1,-4,2013-11-25
UNC Greensboro,Louisiana Tech,62,99,1,-37,2013-11-25
Vanderbilt,Loyola Marymount,77,68,0,9,2013-11-25
Quinnipiac,Maine,102,61,0,41,2013-11-25
Morgan State,Marist,74,67,0,7,2013-11-25
Providence,Maryland,52,56,1,-4,2013-11-25
Syracuse,Minnesota,75,67,0,8,2013-11-25
IUPUI,Missouri,64,78,1,-14,2013-11-25
Bethune-Cookman,New Mexico State,56,79,1,-23,2013-11-25
Gardner-Webb,Northwestern,59,72,1,-13,2013-11-25
Wyoming,Ohio State,50,65,1,-15,2013-11-25
Texas Tech,Pitt,53,76,1,-23,2013-11-25
UNC Asheville,Rhode Island,56,73,1,-17,2013-11-25
Stillman,Rutgers,89,116,1,-27,2013-11-25
UC-Riverside,Seattle,68,69,1,-1,2013-11-25
Omaha,South Carolina State,83,67,0,16,2013-11-25
Bob Jones University,USC Upstate,67,94,1,-27,2013-11-25
Howard,South Dakota State,65,77,1,-12,2013-11-25
Oklahoma State,South Florida,93,67,0,26,2013-11-25
Blue Mountain College,Southern,59,76,1,-17,2013-11-25
St. Bonaventure,Southern Illinois,83,71,0,12,2013-11-25
Wagner,Stetson,81,64,0,17,2013-11-25
Lipscomb,UT-Martin,95,84,0,11,2013-11-25
South Dakota,Texas State,57,56,0,1,2013-11-25
Abilene Christian,Xavier,65,93,1,-28,2013-11-25
Minnesota,Arkansas,73,87,1,-14,2013-11-26
Southern Arkansas,Little Rock,58,90,1,-32,2013-11-26
Tennessee State,Auburn,73,78,1,-5,2013-11-26
Dayton,Baylor,66,67,1,-1,2013-11-26
Brescia,Belmont,68,102,1,-34,2013-11-26
Sacred Heart,Boston College,67,75,1,-8,2013-11-26
Presbyterian,Bowling Green State,45,67,1,-22,2013-11-26
Wichita State,BYU,75,62,0,13,2013-11-26
Robert Morris,Buffalo,66,81,1,-15,2013-11-26
Syracuse,California,92,81,0,11,2013-11-26
Sacramento State,UC-Davis,73,67,0,6,2013-11-26
Metropolitan State,Canisius,83,69,0,14,2013-11-26
Troy,Central Arkansas,53,60,1,-7,2013-11-26
Gonzaga,Chaminade,113,81,0,32,2013-11-26
Trinity (FL),Charleston Southern,58,105,1,-47,2013-11-26
UMass-Lowell,Cincinnati,49,79,1,-30,2013-11-26
American,Columbia,47,61,1,-14,2013-11-26
Loyola (MD),UConn,66,76,1,-10,2013-11-26
Texas,DePaul,77,59,0,18,2013-11-26
UNC Asheville,East Carolina,70,81,1,-11,2013-11-26
Georgia State,Elon,85,90,1,-5,2013-11-26
Oral Roberts,Georgia Southern,67,65,0,2,2013-11-26
Mississippi Valley State,Georgia Tech,59,76,1,-17,2013-11-26
Texas Tech,Houston,76,64,0,12,2013-11-26
Texas Southern,Howard,63,54,0,9,2013-11-26
Louisiana Tech,UIC,103,78,0,25,2013-11-26
Evansville,Indiana,46,77,1,-31,2013-11-26
Truett-McConnell,Kennesaw State,54,73,1,-19,2013-11-26
Yale,Lafayette,79,76,0,3,2013-11-26
South Dakota State,Lehigh,74,61,0,13,2013-11-26
Fordham,Manhattan,79,75,0,4,2013-11-26
Western Kentucky,Marshall,64,74,1,-10,2013-11-26
Judson,Milwaukee,56,89,1,-33,2013-11-26
North Carolina A&T,Ole Miss,50,84,1,-34,2013-11-26
Liberty,Missouri State,52,54,1,-2,2013-11-26
Cal State Northridge,Montana State,62,77,1,-15,2013-11-26
Bucknell,Mount St. Mary's,64,69,1,-5,2013-11-26
Middle Tennessee,Murray State,80,62,0,18,2013-11-26
Maryland-Eastern Shore,Navy,59,67,1,-8,2013-11-26
Illinois,UNLV,61,59,0,2,2013-11-26
UTSA,Nicholls State,73,79,1,-6,2013-11-26
Central Connecticut,NJIT,74,71,0,3,2013-11-26
Stillman,Norfolk State,83,105,1,-22,2013-11-26
Barber-Scotia,North Carolina Central,46,101,1,-55,2013-11-26
San Diego,UNC Greensboro,83,71,0,12,2013-11-26
Florida Gulf Coast,NC State,62,82,1,-20,2013-11-26
Campbellsville,UNC Wilmington,55,72,1,-17,2013-11-26
Incarnate Word,North Texas,67,84,1,-17,2013-11-26
Mercer,Ohio,67,76,1,-9,2013-11-26
West Virginia,Old Dominion,78,60,0,18,2013-11-26
SIU-Edwardsville,Oregon State,81,101,1,-20,2013-11-26
Monmouth,Penn State,52,84,1,-32,2013-11-26
Niagara,Penn,66,85,1,-19,2013-11-26
Stanford,Pitt,67,88,1,-21,2013-11-26
George Mason,Princeton,66,71,1,-5,2013-11-26
McNeese State,Rhode Island,71,76,1,-5,2013-11-26
Albany (NY),Rider,70,59,0,11,2013-11-26
Fairleigh Dickinson,Rutgers,73,72,0,1,2013-11-26
Wisconsin,Saint Louis,63,57,0,6,2013-11-26
Binghamton,St. Peter's,57,70,1,-13,2013-11-26
North Florida,Savannah State,65,61,0,4,2013-11-26
Western Illinois,Southeastern Louisiana,52,62,1,-10,2013-11-26
Stetson,Southern Illinois,48,67,1,-19,2013-11-26
Sam Houston State,SMU,53,72,1,-19,2013-11-26
Wagner,St. Bonaventure,67,70,1,-3,2013-11-26
Longwood,St. John's (NY),47,65,1,-18,2013-11-26
Samford,Stephen F. Austin,78,98,1,-20,2013-11-26
Arkansas-Pine Bluff,Texas A&M,55,88,1,-33,2013-11-26
Central Michigan,Texas A&M-Corpus Christi,68,64,0,4,2013-11-26
UMBC,Towson,60,75,1,-15,2013-11-26
Colgate,Tulane,98,86,0,12,2013-11-26
UCF,Valparaiso,70,85,1,-15,2013-11-26
Hampton,Virginia,40,69,1,-29,2013-11-26
Furman,Virginia Tech,54,75,1,-21,2013-11-26
Montana,Washington,79,83,1,-4,2013-11-26
Utah State,Weber State,77,71,0,6,2013-11-26
Limestone,Western Carolina,69,78,1,-9,2013-11-26
Oakland,Western Michigan,88,99,1,-11,2013-11-26
Richmond,Air Force,83,60,0,23,2013-11-27
Duke,Alabama,74,64,0,10,2013-11-27
Florida A&M,Alabama-Birmingham,73,85,1,-12,2013-11-27
Drexel,Arizona,62,66,1,-4,2013-11-27
Gonzaga,Arkansas,91,81,0,10,2013-11-27
Syracuse,Baylor,74,67,0,7,2013-11-27
Idaho,Boise State,89,98,1,-9,2013-11-27
Oral Roberts,Bowling Green State,63,56,0,7,2013-11-27
Brown,Bryant,67,70,1,-3,2013-11-27
Dayton,California,82,64,0,18,2013-11-27
St. Andrews,Campbell,55,62,1,-7,2013-11-27
Minnesota,Chaminade,83,68,0,15,2013-11-27
Bethune-Cookman,Colorado State,52,66,1,-14,2013-11-27
Purdue-Fort Wayne,Eastern Illinois,71,65,0,6,2013-11-27
Presbyterian,Georgia Southern,66,76,1,-10,2013-11-27
New Orleans,Hawaii,58,91,1,-33,2013-11-27
Wagner,UIC,76,94,1,-18,2013-11-27
Vermont,Illinois State,87,76,0,11,2013-11-27
Tulsa,Indiana State,63,62,0,1,2013-11-27
Fort Valley State,Jacksonville State,66,78,1,-12,2013-11-27
Youngstown State,Kent State,79,83,1,-4,2013-11-27
Eastern Michigan,Kentucky,63,81,1,-18,2013-11-27
Texas-Rio Grande Valley,Lamar,66,61,0,5,2013-11-27
Northwestern State,Louisiana,74,105,1,-31,2013-11-27
St. Bonaventure,Louisiana Tech,72,76,1,-4,2013-11-27
Jackson State,Mississippi State,56,58,1,-2,2013-11-27
Prairie View,New Mexico State,60,91,1,-31,2013-11-27
Stetson,UNC Greensboro,68,75,1,-7,2013-11-27
Saint Louis,Old Dominion,62,52,0,10,2013-11-27
San Jose State,Portland,69,86,1,-17,2013-11-27
Southern Illinois,San Diego,56,59,1,-3,2013-11-27
Sonoma State,San Francisco,73,96,1,-23,2013-11-27
Mount Saint Vincent,St. Francis (NY),54,83,1,-29,2013-11-27
Bethel (TN),UT-Martin,82,95,1,-13,2013-11-27
ETSU,Tennessee Tech,83,98,1,-15,2013-11-27
Ball State,Utah,69,88,1,-19,2013-11-27
Wisconsin,West Virginia,70,63,0,7,2013-11-27
VMI,William & Mary,67,97,1,-30,2013-11-27
James Madison,Winthrop,57,69,1,-12,2013-11-27
Alcorn State,Wright State,55,73,1,-18,2013-11-27
TCU,Alaska-Anchorage,73,70,0,3,2013-11-28
Creighton,Arizona State,88,60,0,28,2013-11-28
Washington State,Butler,69,76,1,-7,2013-11-28
Marquette,Cal State Fullerton,86,66,0,20,2013-11-28
Morehead State,Chattanooga,88,75,0,13,2013-11-28
San Diego State,College of Charleston,72,52,0,20,2013-11-28
Harvard,Denver,68,60,0,8,2013-11-28
IUPUI,Gardner-Webb,54,61,1,-7,2013-11-28
Miami (FL),George Washington,63,71,1,-8,2013-11-28
Pepperdine,Green Bay,89,97,1,-8,2013-11-28
Xavier,Iowa,74,77,1,-3,2013-11-28
Wake Forest,Kansas,78,87,1,-9,2013-11-28
St. Joseph's,LSU,65,82,1,-17,2013-11-28
Siena,Memphis,60,87,1,-27,2013-11-28
Northwestern,Missouri,67,78,1,-11,2013-11-28
UCLA,Nevada,105,84,0,21,2013-11-28
Purdue,Oklahoma State,87,97,1,-10,2013-11-28
Villanova,USC,94,79,0,15,2013-11-28
UTEP,Tennessee,78,70,0,8,2013-11-28
West Alabama,Abilene Christian,77,67,0,10,2013-11-29
Drexel,Alabama,85,83,0,2,2013-11-29
Indiana State,Alaska-Anchorage,97,87,0,10,2013-11-29
Duke,Arizona,66,72,1,-6,2013-11-29
College of Charleston,Arizona State,58,80,1,-22,2013-11-29
Sam Houston State,Arkansas-Pine Bluff,75,49,0,26,2013-11-29
Portland State,Boise State,60,76,1,-16,2013-11-29
Oklahoma State,Butler,69,67,0,2,2013-11-29
North Dakota,Cal Poly,43,70,1,-27,2013-11-29
Northern Arizona,Cal State Bakersfield,50,61,1,-11,2013-11-29
Miami (FL),Cal State Fullerton,48,46,0,2,2013-11-29
South Dakota State,UCSB,64,83,1,-19,2013-11-29
IUPUI,Chattanooga,76,87,1,-11,2013-11-29
Kennesaw State,Cincinnati,67,95,1,-28,2013-11-29
Coastal Carolina,Clemson,40,69,1,-29,2013-11-29
San Diego State,Creighton,86,80,0,6,2013-11-29
Pepperdine,Denver,68,56,0,12,2013-11-29
Seattle,Eastern Washington,75,82,1,-7,2013-11-29
Florida State,Florida,66,67,1,-1,2013-11-29
Drake,Fresno State,84,74,0,10,2013-11-29
Morehead State,Gardner-Webb,82,86,1,-4,2013-11-29
Marquette,George Washington,76,60,0,16,2013-11-29
Appalachian State,Georgia,53,71,1,-18,2013-11-29
Ole Miss,Georgia Tech,77,67,0,10,2013-11-29
San Diego Christian,Grand Canyon,61,91,1,-30,2013-11-29
Harvard,Green Bay,76,64,0,12,2013-11-29
Liberty,Hampton,70,53,0,17,2013-11-29
Purdue-Fort Wayne,Illinois,55,57,1,-2,2013-11-29
Sonoma State,Illinois State,58,75,1,-17,2013-11-29
UTEP,Iowa,53,89,1,-36,2013-11-29
Villanova,Kansas,63,59,0,4,2013-11-29
North Carolina A&T,Longwood,85,78,0,7,2013-11-29
Memphis,LSU,76,69,0,7,2013-11-29
Southern Miss,Louisville,38,69,1,-31,2013-11-29
Morgan State,Maryland,62,89,1,-27,2013-11-29
Coppin State,Michigan,45,87,1,-42,2013-11-29
Mount St. Mary's,Michigan State,65,98,1,-33,2013-11-29
Nevada,Missouri,70,83,1,-13,2013-11-29
Texas A&M,Missouri State,67,73,1,-6,2013-11-29
Mississippi Valley State,Monmouth,79,81,1,-2,2013-11-29
Stephen F. Austin,UNC Wilmington,60,55,0,5,2013-11-29
Southeast Missouri State,Northern Kentucky,79,65,0,14,2013-11-29
UCLA,Northwestern,95,79,0,16,2013-11-29
North Florida,Ohio State,64,99,1,-35,2013-11-29
Little Rock,Oklahoma,81,101,1,-20,2013-11-29
Pacific,Oregon,62,85,1,-23,2013-11-29
St. John's (NY),Penn State,82,89,1,-7,2013-11-29
Bethune-Cookman,Prairie View,80,89,1,-9,2013-11-29
Fairfield,Providence,69,78,1,-9,2013-11-29
Washington State,Purdue,69,54,0,15,2013-11-29
Rider,Rice,97,93,0,4,2013-11-29
Siena,St. Joseph's,66,78,1,-12,2013-11-29
Campbellsville,Samford,68,79,1,-11,2013-11-29
Vermont,San Francisco,61,72,1,-11,2013-11-29
North Dakota State,Santa Clara,91,85,0,6,2013-11-29
Wake Forest,USC,77,63,0,14,2013-11-29
Virginia,SMU,76,73,0,3,2013-11-29
Xavier,Tennessee,49,64,1,-15,2013-11-29
Texas-Arlington,Texas,69,72,1,-3,2013-11-29
Tulsa,TCU,65,72,1,-7,2013-11-29
Tulane,Texas State,52,70,1,-18,2013-11-29
UTSA,Texas Tech,64,94,1,-30,2013-11-29
Citadel,Towson,59,84,1,-25,2013-11-29
Mercer,Valparaiso,117,108,0,9,2013-11-29
Northeastern,VCU,66,79,1,-13,2013-11-29
Radford,Virginia Tech,56,81,1,-25,2013-11-29
Cornell,Western Michigan,70,83,1,-13,2013-11-29
Colorado,Air Force,81,57,0,24,2013-11-30
Denver,Alaska-Anchorage,78,71,0,7,2013-11-30
Hampton,Arkansas-Pine Bluff,72,65,0,7,2013-11-30
Houston Baptist,Army,74,72,0,2,2013-11-30
St. Peter's,Boston University,65,66,1,-1,2013-11-30
Texas-Rio Grande Valley,Bradley,54,74,1,-20,2013-11-30
Utah State,BYU,74,85,1,-11,2013-11-30
Central Connecticut,Brown,61,72,1,-11,2013-11-30
Salve Regina,Bryant,55,82,1,-27,2013-11-30
Princeton,Bucknell,66,53,0,13,2013-11-30
Delaware State,Buffalo,55,65,1,-10,2013-11-30
Pacific,Cal Poly,73,71,0,2,2013-11-30
Idaho,UC-Davis,80,76,0,4,2013-11-30
Jacksonville State,Central Michigan,61,66,1,-5,2013-11-30
Southern Illinois,Chicago State,84,88,1,-4,2013-11-30
West Alabama,Citadel,90,77,0,13,2013-11-30
Ball State,Cleveland State,55,78,1,-23,2013-11-30
New Mexico State,Colorado State,83,85,1,-2,2013-11-30
Robert Morris,Delaware,67,86,1,-19,2013-11-30
Northern Arizona,Drake,56,76,1,-20,2013-11-30
Pitt,Duquesne,84,67,0,17,2013-11-30
Marshall,ETSU,78,88,1,-10,2013-11-30
Florida Memorial,Florida A&M,82,100,1,-18,2013-11-30
Georgia State,Florida International,60,61,1,-1,2013-11-30
Cal State Bakersfield,Fresno State,86,96,1,-10,2013-11-30
Brevard,Furman,72,89,1,-17,2013-11-30
Rhode Island,George Mason,54,61,1,-7,2013-11-30
Lipscomb,Georgetown,49,70,1,-21,2013-11-30
Campbell,Georgia Southern,75,73,0,2,2013-11-30
St. John's (NY),Georgia Tech,69,58,0,11,2013-11-30
Tulsa,Green Bay,59,67,1,-8,2013-11-30
Yale,Hartford,54,49,0,5,2013-11-30
Montana,Hawaii,61,72,1,-11,2013-11-30
Manhattan,Hofstra,66,59,0,7,2013-11-30
Texas A&M-Corpus Christi,Houston,67,78,1,-11,2013-11-30
William & Mary,Howard,84,79,0,5,2013-11-30
Texas A&M-International,Incarnate Word,56,75,1,-19,2013-11-30
Pepperdine,Indiana State,70,73,1,-3,2013-11-30
Villanova,Iowa,88,83,0,5,2013-11-30
UTEP,Kansas,63,67,1,-4,2013-11-30
Penn,Lafayette,76,79,1,-3,2013-11-30
Arkansas State,Lamar,95,89,0,6,2013-11-30
Sam Houston State,Liberty,58,62,1,-4,2013-11-30
Mississippi Valley State,Longwood,90,89,0,1,2013-11-30
South Alabama,Middle Tennessee,55,65,1,-10,2013-11-30
Penn State,Ole Miss,76,79,1,-3,2013-11-30
Milwaukee,UMKC,84,79,0,5,2013-11-30
Virginia,Missouri State,83,63,0,20,2013-11-30
North Carolina A&T,Monmouth,61,76,1,-15,2013-11-30
Northern Illinois,Nebraska,58,63,1,-5,2013-11-30
Iowa Wesleyan,Omaha,36,86,1,-50,2013-11-30
UT-Martin,UNLV,55,85,1,-30,2013-11-30
Holy Cross,New Hampshire,63,52,0,11,2013-11-30
San Diego,New Mexico,66,73,1,-7,2013-11-30
Eastern Kentucky,NC State,56,75,1,-19,2013-11-30
Rider,North Dakota State,70,87,1,-17,2013-11-30
Southeastern Louisiana,North Texas,61,75,1,-14,2013-11-30
Bethune-Cookman,Northern Colorado,60,65,1,-5,2013-11-30
Texas State,Northern Kentucky,70,61,0,9,2013-11-30
Niagara,Northwestern State,100,107,1,-7,2013-11-30
Rochester (MI),Oakland,51,86,1,-35,2013-11-30
Evansville,Ohio,59,81,1,-22,2013-11-30
North Dakota,Oregon,76,91,1,-15,2013-11-30
Santa Clara,Rice,66,67,1,-1,2013-11-30
James Madison,Richmond,53,68,1,-15,2013-11-30
UC-Irvine,Sacramento State,79,53,0,26,2013-11-30
American,Saint Francis (PA),75,43,0,32,2013-11-30
Murray State,Saint Mary's,64,89,1,-25,2013-11-30
Illinois State,San Francisco,90,76,0,14,2013-11-30
Vermont,Sonoma State,73,61,0,12,2013-11-30
Tennessee State,USC Upstate,64,73,1,-9,2013-11-30
Graceland (IA),South Dakota,85,112,1,-27,2013-11-30
Detroit,South Florida,65,60,0,5,2013-11-30
Tulane,Southeast Missouri State,72,102,1,-30,2013-11-30
Xavier,USC,78,84,1,-6,2013-11-30
Texas A&M,SMU,52,55,1,-3,2013-11-30
Davidson,Stetson,86,80,0,6,2013-11-30
Wake Forest,Tennessee,63,82,1,-19,2013-11-30
Utah Valley,Tennessee Tech,71,74,1,-3,2013-11-30
Abilene Christian,Towson,47,74,1,-27,2013-11-30
Cincinnati Christian,Valparaiso,58,94,1,-36,2013-11-30
Long Beach State,Washington,89,92,1,-3,2013-11-30
San Jose State,Weber State,55,72,1,-17,2013-11-30
Greenville (IL),Western Illinois,49,76,1,-27,2013-11-30
Eastern Illinois,Western Kentucky,53,68,1,-15,2013-11-30
Johnson & Wales (NC),Wofford,48,90,1,-42,2013-11-30
Western Carolina,Wright State,77,85,1,-8,2013-11-30
Montana State,Wyoming,54,79,1,-25,2013-11-30
Austin Peay,Youngstown State,88,86,0,2,2013-11-30
UNC,Alabama-Birmingham,59,63,1,-4,2013-12-01
Miami (FL),Arizona State,60,57,0,3,2013-12-01
Hardin-Simmons,Baylor,59,104,1,-45,2013-12-01
VCU,Belmont,81,68,0,13,2013-12-01
Colgate,Binghamton,93,64,0,29,2013-12-01
LSU,Butler,70,68,0,2,2013-12-01
Drake,Cal State Bakersfield,65,57,0,8,2013-12-01
College of Charleston,Cal State Fullerton,61,48,0,13,2013-12-01
La Sierra,Cal State Northridge,79,97,1,-18,2013-12-01
UNC Asheville,Charlotte,56,77,1,-21,2013-12-01
George Washington,Creighton,60,53,0,7,2013-12-01
Oregon State,DePaul,81,93,1,-12,2013-12-01
UNC Wilmington,East Carolina,70,68,0,2,2013-12-01
Columbia,Elon,65,68,1,-3,2013-12-01
Iona,Florida Gulf Coast,90,72,0,18,2013-12-01
Northern Arizona,Fresno State,67,71,1,-4,2013-12-01
Coppin State,Gonzaga,51,86,1,-35,2013-12-01
TCU,Harvard,50,71,1,-21,2013-12-01
Stephen F. Austin,High Point,71,68,0,3,2013-12-01
Louisiana Tech,Jackson State,72,61,0,11,2013-12-01
Central Arkansas,Kansas State,54,87,1,-33,2013-12-01
Kennesaw State,Kent State,51,68,1,-17,2013-12-01
Providence,Kentucky,65,79,1,-14,2013-12-01
Sacred Heart,Lehigh,64,76,1,-12,2013-12-01
Norfolk State,LIU-Brooklyn,72,74,1,-2,2013-12-01
Dartmouth,Maine,81,56,0,25,2013-12-01
San Diego State,Marquette,67,59,0,8,2013-12-01
Mount Ida College,UMass-Lowell,45,73,1,-28,2013-12-01
Oklahoma State,Memphis,68,73,1,-5,2013-12-01
Loyola (IL),Mississippi State,64,65,1,-1,2013-12-01
Albany (NY),NJIT,66,55,0,11,2013-12-01
Pacific,North Dakota,93,76,0,17,2013-12-01
Prairie View,Northern Colorado,70,87,1,-17,2013-12-01
Cornell,Notre Dame,67,101,1,-34,2013-12-01
Cal Poly,Oregon,61,82,1,-21,2013-12-01
Southern Utah,Portland,57,86,1,-29,2013-12-01
Siena,Purdue,63,68,1,-5,2013-12-01
Washington State,St. Joseph's,67,72,1,-5,2013-12-01
Wichita State,Saint Louis,70,65,0,5,2013-12-01
Kentucky State,Samford,73,76,1,-3,2013-12-01
Fairleigh Dickinson,Seton Hall,58,54,0,4,2013-12-01
Texas State,Southeast Missouri State,74,82,1,-8,2013-12-01
South Dakota State,Stanford,60,92,1,-32,2013-12-01
St. Francis (NY),Stony Brook,70,68,0,2,2013-12-01
Niagara,Arkansas State,61,86,1,-25,2013-12-02
Western Kentucky,Bowling Green State,62,74,1,-12,2013-12-02
UC-Irvine,California,56,73,1,-17,2013-12-02
Loyola Marymount,UC-Riverside,73,69,0,4,2013-12-02
Florida,UConn,64,65,1,-1,2013-12-02
Baptist Bible (PA),Delaware State,47,72,1,-25,2013-12-02
Chattanooga,Georgia,56,87,1,-31,2013-12-02
Auburn,Iowa State,70,99,1,-29,2013-12-02
Maryland-Eastern Shore,UMBC,59,64,1,-5,2013-12-02
Wright State,Morehead State,69,74,1,-5,2013-12-02
Valley City State,North Dakota State,43,86,1,-43,2013-12-02
Edward Waters,North Florida,68,90,1,-22,2013-12-02
Mercer,Oklahoma,82,96,1,-14,2013-12-02
Boston University,Quinnipiac,69,66,0,3,2013-12-02
UC-Davis,Seattle,53,77,1,-24,2013-12-02
Spring Hill,South Alabama,41,91,1,-50,2013-12-02
Utah Valley,South Dakota,67,71,1,-4,2013-12-02
Texas-Rio Grande Valley,SIU-Edwardsville,49,55,1,-6,2013-12-02
McNeese State,SMU,59,88,1,-29,2013-12-02
Vanderbilt,Texas,64,70,1,-6,2013-12-02
Alcorn State,Troy,70,73,1,-3,2013-12-02
Loyola (MD),West Virginia,47,96,1,-49,2013-12-02
Black Hills State,Wyoming,65,79,1,-14,2013-12-02
Hillsdale Baptist/Randall (Ok.),Abilene Christian,53,93,1,-40,2013-12-03
Texas Tech,Arizona,58,79,1,-21,2013-12-03
Southeastern Louisiana,Arkansas,65,111,1,-46,2013-12-03
Arkansas-Fort Smith,Little Rock,74,88,1,-14,2013-12-03
Utah,Boise State,67,69,1,-2,2013-12-03
North Texas,BYU,67,97,1,-30,2013-12-03
Southern Utah,Cal State Northridge,57,84,1,-27,2013-12-03
Delaware,Charleston Southern,85,80,0,5,2013-12-03
USC Upstate,Cincinnati,50,86,1,-36,2013-12-03
South Carolina State,Clemson,49,65,1,-16,2013-12-03
Colorado,Colorado State,67,62,0,5,2013-12-03
Southern,Denver,74,75,1,-1,2013-12-03
Michigan,Duke,69,79,1,-10,2013-12-03
Fayetteville State,East Carolina,78,96,1,-18,2013-12-03
UMass,Eastern Michigan,69,57,0,12,2013-12-03
VMI,Elon,70,87,1,-17,2013-12-03
UCF,Florida Atlantic,64,75,1,-11,2013-12-03
Nova Southeastern,Florida International,77,59,0,18,2013-12-03
Illinois,Georgia Tech,64,67,1,-3,2013-12-03
Vanguard,Grand Canyon,73,82,1,-9,2013-12-03
Notre Dame,Iowa,93,98,1,-5,2013-12-03
Trinity Baptist,Jacksonville,75,88,1,-13,2013-12-03
Creighton,Long Beach State,78,61,0,17,2013-12-03
Purdue-Fort Wayne,Miami (OH),87,94,1,-7,2013-12-03
Belmont,Middle Tennessee,70,58,0,12,2013-12-03
Northern Iowa,Milwaukee,72,83,1,-11,2013-12-03
Florida State,Minnesota,61,71,1,-10,2013-12-03
Waldorf,Omaha,66,100,1,-34,2013-12-03
Presbyterian,UNC Greensboro,87,66,0,21,2013-12-03
Campbell,UNC Wilmington,50,69,1,-19,2013-12-03
North Carolina Central,Old Dominion,76,69,0,7,2013-12-03
Cameron,Oral Roberts,64,74,1,-10,2013-12-03
Penn State,Pitt,69,78,1,-9,2013-12-03
Rockhurst,Saint Louis,43,68,1,-25,2013-12-03
UMass-Lowell,St. Bonaventure,58,67,1,-9,2013-12-03
Bethune-Cookman,Stetson,52,56,1,-4,2013-12-03
Indiana,Syracuse,52,69,1,-17,2013-12-03
Alabama A&M,Tennessee State,66,65,0,1,2013-12-03
Dallas Baptist,Texas-Arlington,53,81,1,-28,2013-12-03
UCSB,UCLA,76,89,1,-13,2013-12-03
Winthrop,Virginia Tech,63,81,1,-18,2013-12-03
Lafayette,Wagner,77,65,0,12,2013-12-03
North Florida,Alabama,48,76,1,-28,2013-12-04
Howard,American,53,76,1,-23,2013-12-04
North Greenville,Appalachian State,70,78,1,-8,2013-12-04
ETSU,Austin Peay,80,74,0,6,2013-12-04
Valparaiso,Ball State,69,50,0,19,2013-12-04
IUPUI,Bradley,72,66,0,6,2013-12-04
New Hampshire,Central Connecticut,56,65,1,-9,2013-12-04
Davidson,Charlotte,87,78,0,9,2013-12-04
Western Carolina,Coastal Carolina,68,76,1,-8,2013-12-04
Army,Columbia,64,81,1,-17,2013-12-04
Delaware State,Dayton,46,56,1,-10,2013-12-04
Cleveland State,Drexel,82,85,1,-3,2013-12-04
UMBC,Duquesne,88,94,1,-6,2013-12-04
Furman,Fordham,48,79,1,-31,2013-12-04
Wofford,Gardner-Webb,65,62,0,3,2013-12-04
South Florida,George Mason,68,66,0,2,2013-12-04
Rutgers,George Washington,87,93,1,-6,2013-12-04
Brewton-Parker,Georgia Southern,66,75,1,-9,2013-12-04
Young Harris,Georgia State,54,71,1,-17,2013-12-04
Sacred Heart,Hofstra,73,59,0,14,2013-12-04
Albany (NY),Holy Cross,57,62,1,-5,2013-12-04
Rice,Houston Baptist,71,73,1,-2,2013-12-04
SMU,UIC,73,65,0,8,2013-12-04
Chicago State,Illinois State,56,75,1,-19,2013-12-04
St. Edward's,Incarnate Word,67,77,1,-10,2013-12-04
Marist,Iona,74,83,1,-9,2013-12-04
Bucknell,Kent State,66,59,0,7,2013-12-04
Hartford,La Salle,62,75,1,-13,2013-12-04
West Virginia Tech,Longwood,80,95,1,-15,2013-12-04
Louisiana,Louisiana Tech,89,80,0,9,2013-12-04
UMKC,Louisville,62,90,1,-28,2013-12-04
Catholic,Loyola (MD),75,87,1,-12,2013-12-04
UNC,Michigan State,79,65,0,14,2013-12-04
Cameron,Missouri State,57,81,1,-24,2013-12-04
Binghamton,Mount St. Mary's,74,70,0,4,2013-12-04
Evansville,Murray State,63,65,1,-2,2013-12-04
Citadel,Navy,74,79,1,-5,2013-12-04
Miami (FL),Nebraska,49,60,1,-11,2013-12-04
New Mexico,New Mexico State,79,70,0,9,2013-12-04
Maine,NJIT,72,81,1,-9,2013-12-04
Northwestern,NC State,48,69,1,-21,2013-12-04
Harvard,Northeastern,72,64,0,8,2013-12-04
Maryland,Ohio State,60,76,1,-16,2013-12-04
Cal State Fullerton,Pepperdine,78,64,0,14,2013-12-04
Boston College,Purdue,67,88,1,-21,2013-12-04
Central Pennsylvania College,Radford,72,111,1,-39,2013-12-04
Lehigh,Saint Francis (PA),57,50,0,7,2013-12-04
UT-Martin,Samford,89,73,0,16,2013-12-04
Dakota State,South Dakota State,62,88,1,-26,2013-12-04
Morehead State,Southern Miss,60,74,1,-14,2013-12-04
Fairleigh Dickinson,Stony Brook,62,77,1,-15,2013-12-04
St. Joseph's,Temple,69,77,1,-8,2013-12-04
Houston,Texas A&M,57,74,1,-17,2013-12-04
Huston-Tillotson,UTSA,62,90,1,-28,2013-12-04
Cedarville,Texas State,58,79,1,-21,2013-12-04
Detroit,Toledo,75,91,1,-16,2013-12-04
Texas Southern,Tulsa,71,98,1,-27,2013-12-04
Penn,Villanova,54,77,1,-23,2013-12-04
Wisconsin,Virginia,48,38,0,10,2013-12-04
Tulane,Wake Forest,57,72,1,-15,2013-12-04
Eastern Illinois,Western Illinois,32,60,1,-28,2013-12-04
Richmond,William & Mary,71,60,0,11,2013-12-04
Bryant,Yale,72,64,0,8,2013-12-04
Robert Morris,Youngstown State,76,84,1,-8,2013-12-04
South Dakota,Air Force,86,94,1,-8,2013-12-05
Oakwood,Alabama A&M,58,70,1,-12,2013-12-05
Carroll (MT),Boise State,52,80,1,-28,2013-12-05
Santa Clara,Cal State Bakersfield,60,42,0,18,2013-12-05
Seattle,Cal State Northridge,58,53,0,5,2013-12-05
La Verne,UC-Riverside,77,92,1,-15,2013-12-05
North Carolina Wesleyan,Coastal Carolina,54,89,1,-35,2013-12-05
High Point,Georgetown,45,80,1,-35,2013-12-05
Ole Miss,Kansas State,58,61,1,-3,2013-12-05
Tennessee Tech,Lipscomb,79,87,1,-8,2013-12-05
TCU,Mississippi State,71,61,0,10,2013-12-05
West Virginia,Missouri,71,80,1,-9,2013-12-05
Rider,Monmouth,89,83,0,6,2013-12-05
Florida A&M,Norfolk State,87,91,1,-4,2013-12-05
Wright State,North Carolina A&T,59,62,1,-3,2013-12-05
Dartmouth,Northern Illinois,57,64,1,-7,2013-12-05
Texas A&M-Corpus Christi,Oklahoma,56,78,1,-22,2013-12-05
Montreat,Presbyterian,58,91,1,-33,2013-12-05
Providence,Rhode Island,50,49,0,1,2013-12-05
San Diego State,San Diego,65,64,0,1,2013-12-05
LIU-Brooklyn,Seton Hall,81,92,1,-11,2013-12-05
Marshall,Vanderbilt,67,69,1,-2,2013-12-05
Eastern Kentucky,VCU,68,71,1,-3,2013-12-05
Kentucky,Baylor,62,67,1,-5,2013-12-06
California,UCSB,65,72,1,-7,2013-12-06
St. Peter's,Canisius,67,82,1,-15,2013-12-06
Maine,UConn,68,95,1,-27,2013-12-06
Arizona State,DePaul,78,56,0,22,2013-12-06
Carroll (MT),Idaho State,50,77,1,-27,2013-12-06
Sam Houston State,James Madison,77,76,0,1,2013-12-06
Manhattan,Marist,70,59,0,11,2013-12-06
Siena,Niagara,84,71,0,13,2013-12-06
South Carolina,Oklahoma State,52,79,1,-27,2013-12-06
Loyola Marymount,Pitt,68,85,1,-17,2013-12-06
Fairfield,Quinnipiac,79,83,1,-4,2013-12-06
Towson,Stephen F. Austin,69,79,1,-10,2013-12-06
Brown,American,72,67,0,5,2013-12-07
UNLV,Arizona,58,63,1,-5,2013-12-07
Clemson,Arkansas,68,74,1,-6,2013-12-07
St. Francis (NY),Army,54,67,1,-13,2013-12-07
Harvard,Boston University,79,68,0,11,2013-12-07
UMass,BYU,105,96,0,9,2013-12-07
North Dakota State,Bryant,66,62,0,4,2013-12-07
Columbia,Bucknell,52,57,1,-5,2013-12-07
St. Bonaventure,Buffalo,73,78,1,-5,2013-12-07
North Dakota,Butler,64,79,1,-15,2013-12-07
Santa Clara,Cal Poly,53,64,1,-11,2013-12-07
Seattle,Cal State Fullerton,74,65,0,9,2013-12-07
Nevada,UC-Davis,87,81,0,6,2013-12-07
Pepperdine,UC-Irvine,75,69,0,6,2013-12-07
Stetson,UCF,58,77,1,-19,2013-12-07
Wisconsin-Parkside,Chicago State,81,90,1,-9,2013-12-07
Gardner-Webb,Citadel,67,55,0,12,2013-12-07
Akron,Cleveland State,73,61,0,12,2013-12-07
Kansas,Colorado,72,75,1,-3,2013-12-07
Saint Francis (PA),Cornell,72,62,0,10,2013-12-07
Johnson & Wales (NC),Davidson,63,105,1,-42,2013-12-07
Coppin State,Delaware State,73,54,0,19,2013-12-07
Iowa,Drake,83,66,0,17,2013-12-07
Tennessee State,Drexel,61,75,1,-14,2013-12-07
Indiana State,Eastern Illinois,66,48,0,18,2013-12-07
Miami (OH),Evansville,65,78,1,-13,2013-12-07
Jacksonville,Florida Atlantic,63,83,1,-20,2013-12-07
Florida Gulf Coast,Florida International,61,72,1,-11,2013-12-07
Colgate,Georgetown,55,61,1,-6,2013-12-07
ETSU,Georgia Tech,57,87,1,-30,2013-12-07
New Mexico State,Gonzaga,68,80,1,-12,2013-12-07
Virginia,Green Bay,72,75,1,-3,2013-12-07
Florida A&M,Hampton,62,72,1,-10,2013-12-07
Holy Cross,Hartford,78,90,1,-12,2013-12-07
San Jose State,Houston,72,68,0,4,2013-12-07
Washington State,Idaho,67,66,0,1,2013-12-07
Dayton,Illinois State,75,81,1,-6,2013-12-07
North Florida,Indiana,68,89,1,-21,2013-12-07
Northern Iowa,Iowa State,82,91,1,-9,2013-12-07
Dartmouth,Purdue-Fort Wayne,64,80,1,-16,2013-12-07
North Carolina Central,IUPUI,65,71,1,-6,2013-12-07
Stony Brook,La Salle,57,65,1,-8,2013-12-07
UMBC,Lehigh,68,70,1,-2,2013-12-07
Greensboro,Liberty,47,84,1,-37,2013-12-07
Eastern Kentucky,Longwood,76,67,0,9,2013-12-07
Southern,Louisiana Tech,50,69,1,-19,2013-12-07
Louisiana,Louisville,74,113,1,-39,2013-12-07
UIC,Loyola (IL),70,73,1,-3,2013-12-07
Northwestern State,Memphis,76,96,1,-20,2013-12-07
Denver,Mercer,63,64,1,-1,2013-12-07
Houston Baptist,Michigan,53,107,1,-54,2013-12-07
Bradley,Milwaukee,67,73,1,-6,2013-12-07
New Orleans,Minnesota,65,80,1,-15,2013-12-07
Tougaloo,Mississippi Valley State,81,89,1,-8,2013-12-07
UCLA,Missouri,71,80,1,-9,2013-12-07
Youngstown State,UMKC,80,88,1,-8,2013-12-07
Walla Walla,Montana State,54,109,1,-55,2013-12-07
Howard,Morgan State,58,87,1,-29,2013-12-07
Loyola (MD),Mount St. Mary's,58,70,1,-12,2013-12-07
Lipscomb,Murray State,69,73,1,-4,2013-12-07
Cincinnati,New Mexico,54,63,1,-9,2013-12-07
Loyola (LA),Nicholls State,62,87,1,-25,2013-12-07
UMass-Lowell,NJIT,44,55,1,-11,2013-12-07
Bethune-Cookman,Norfolk State,45,59,1,-14,2013-12-07
UNC Greensboro,UNC,50,81,1,-31,2013-12-07
Long Beach State,NC State,66,76,1,-10,2013-12-07
Alabama-Birmingham,Northeastern,74,69,0,5,2013-12-07
Hawaii,Northern Arizona,76,66,0,10,2013-12-07
Western Michigan,Northwestern,35,51,1,-16,2013-12-07
Delaware,Notre Dame,75,80,1,-5,2013-12-07
Ohio,Oakland,56,73,1,-17,2013-12-07
Central Connecticut,Ohio State,56,74,1,-18,2013-12-07
Marshall,Penn State,77,90,1,-13,2013-12-07
Wagner,Penn,75,69,0,6,2013-12-07
Portland,Portland State,92,76,0,16,2013-12-07
Furman,Presbyterian,74,59,0,15,2013-12-07
Fairleigh Dickinson,Princeton,55,77,1,-22,2013-12-07
Eastern Michigan,Purdue,64,69,1,-5,2013-12-07
North Carolina A&T,Radford,52,72,1,-20,2013-12-07
South Alabama,Rice,93,96,1,-3,2013-12-07
Toledo,Robert Morris,80,77,0,3,2013-12-07
Lafayette,Sacred Heart,86,79,0,7,2013-12-07
Villanova,St. Joseph's,98,68,0,30,2013-12-07
Towson,Sam Houston State,55,67,1,-12,2013-12-07
Austin Peay,Samford,63,85,1,-22,2013-12-07
Georgia Southern,South Carolina State,79,61,0,18,2013-12-07
Wyoming,South Dakota,67,66,0,1,2013-12-07
Alabama,South Florida,64,66,1,-2,2013-12-07
Southeast Missouri State,Southeastern Louisiana,74,73,0,1,2013-12-07
Western Kentucky,Southern Illinois,69,60,0,9,2013-12-07
Central Michigan,SIU-Edwardsville,65,64,0,1,2013-12-07
Georgia State,Southern Miss,65,75,1,-10,2013-12-07
Fordham,St. John's (NY),58,104,1,-46,2013-12-07
James Madison,Stephen F. Austin,57,70,1,-13,2013-12-07
Binghamton,Syracuse,65,93,1,-28,2013-12-07
Texas,Temple,81,80,0,1,2013-12-07
Tennessee Tech,Tennessee,63,84,1,-21,2013-12-07
Northern Kentucky,UT-Martin,66,79,1,-13,2013-12-07
Sacramento State,UTEP,51,69,1,-18,2013-12-07
UTSA,Texas-Rio Grande Valley,72,65,0,7,2013-12-07
Alabama State,Troy,69,85,1,-16,2013-12-07
Jackson State,Tulane,65,70,1,-5,2013-12-07
Fresno State,Utah,77,90,1,-13,2013-12-07
Pacific,Utah State,78,68,0,10,2013-12-07
St. Katherine,Utah Valley,37,89,1,-52,2013-12-07
Saint Louis,Valparaiso,67,65,0,2,2013-12-07
Wright State,VMI,74,94,1,-20,2013-12-07
Richmond,Wake Forest,66,76,1,-10,2013-12-07
Grace Bible,Western Illinois,43,77,1,-34,2013-12-07
Oral Roberts,Wichita State,58,71,1,-13,2013-12-07
Marquette,Wisconsin,64,70,1,-6,2013-12-07
William & Mary,Wofford,63,60,0,3,2013-12-07
Bowling Green State,Xavier,73,85,1,-12,2013-12-07
New Hampshire,Yale,61,71,1,-10,2013-12-07
Charlotte,Appalachian State,77,59,0,18,2013-12-08
Illinois,Auburn,81,62,0,19,2013-12-08
Siena,Canisius,78,93,1,-15,2013-12-08
Southwestern Oklahoma State,Colorado State,55,109,1,-54,2013-12-08
Nebraska,Creighton,67,82,1,-15,2013-12-08
Rhode Island,Detroit,68,70,1,-2,2013-12-08
Mount Olive,East Carolina,75,77,1,-2,2013-12-08
Iona,Fairfield,83,72,0,11,2013-12-08
Jacksonville State,Florida State,53,77,1,-24,2013-12-08
Oklahoma,George Mason,81,66,0,15,2013-12-08
Maryland,George Washington,75,77,1,-2,2013-12-08
Monmouth,Manhattan,66,75,1,-9,2013-12-08
Virginia Tech,Miami (FL),61,60,0,1,2013-12-08
Oregon,Ole Miss,115,105,0,10,2013-12-08
St. Peter's,Niagara,56,61,1,-5,2013-12-08
Quinnipiac,Rider,78,90,1,-12,2013-12-08
Seton Hall,Rutgers,77,71,0,6,2013-12-08
Eastern Washington,Saint Mary's,65,93,1,-28,2013-12-08
Washington,San Diego State,63,70,1,-7,2013-12-08
Boston College,USC,62,78,1,-16,2013-12-08
Texas-Permian Basin,Texas A&M-Corpus Christi,82,77,0,5,2013-12-08
Old Dominion,VCU,48,69,1,-21,2013-12-08
Western State,Air Force,53,94,1,-41,2013-12-09
Manchester,Butler,41,100,1,-59,2013-12-09
UMass-Lowell,Columbia,39,78,1,-39,2013-12-09
Bethune-Cookman,Hampton,52,85,1,-33,2013-12-09
Alcorn State,Houston,58,89,1,-31,2013-12-09
Fairleigh Dickinson,Iowa,59,92,1,-33,2013-12-09
LIU-Brooklyn,Lehigh,69,76,1,-7,2013-12-09
Thomas University,Louisiana-Monroe,61,84,1,-23,2013-12-09
Fisk,Middle Tennessee,65,115,1,-50,2013-12-09
Bryant,Notre Dame,59,70,1,-11,2013-12-09
Virginia-Lynchburg,VMI,78,110,1,-32,2013-12-09
Purdue-Fort Wayne,Bradley,65,61,0,4,2013-12-10
Albany (NY),Brown,74,68,0,6,2013-12-10
Nevada,California,84,92,1,-8,2013-12-10
Chowan,Campbell,67,65,0,2,2013-12-10
Hartford,Central Connecticut,59,73,1,-14,2013-12-10
Hiwassee,Chattanooga,68,86,1,-18,2013-12-10
Fordham,Colgate,77,73,0,4,2013-12-10
Green Bay,Eastern Michigan,58,67,1,-9,2013-12-10
Kansas,Florida,61,67,1,-6,2013-12-10
Mars Hill,Furman,97,93,0,4,2013-12-10
Dartmouth,Illinois,65,72,1,-7,2013-12-10
Oakland,Indiana,54,81,1,-27,2013-12-10
Cincinnati Christian,IUPUI,72,94,1,-22,2013-12-10
South Dakota,Kansas State,62,64,1,-2,2013-12-10
Boise State,Kentucky,55,70,1,-15,2013-12-10
South Dakota State,Minnesota,59,75,1,-16,2013-12-10
Cal State Bakersfield,Omaha,88,93,1,-5,2013-12-10
Colorado College,Northern Colorado,57,96,1,-39,2013-12-10
Savannah State,Northern Iowa,50,55,1,-5,2013-12-10
Pacifica,San Diego,47,84,1,-37,2013-12-10
NJIT,Seton Hall,55,71,1,-16,2013-12-10
Monmouth,St. Francis (NY),73,58,0,15,2013-12-10
Central Pennsylvania College,Towson,72,102,1,-30,2013-12-10
Little Rock,Tulsa,64,78,1,-14,2013-12-10
Idaho State,Utah,66,74,1,-8,2013-12-10
Gonzaga,West Virginia,80,76,0,4,2013-12-10
Evansville,Xavier,60,63,1,-3,2013-12-10
New Mexico State,Arizona,48,74,1,-26,2013-12-11
North Dakota,Bowling Green State,69,79,1,-10,2013-12-11
Prairie View,BYU,52,100,1,-48,2013-12-11
Canisius,Buffalo,69,55,0,14,2013-12-11
Howard,UCF,64,79,1,-15,2013-12-11
Denver,Colorado State,80,70,0,10,2013-12-11
UMBC,Coppin State,71,91,1,-20,2013-12-11
Niagara,Davidson,83,72,0,11,2013-12-11
Penn State,Duquesne,68,59,0,9,2013-12-11
Boston University,George Washington,60,70,1,-10,2013-12-11
Alcorn State,Jacksonville State,52,63,1,-11,2013-12-11
Northwestern State,Louisiana Tech,71,93,1,-22,2013-12-11
Idaho,Montana,58,69,1,-11,2013-12-11
Claflin,UNC Greensboro,70,75,1,-5,2013-12-11
North Dakota State,Notre Dame,73,69,0,4,2013-12-11
Bryant,Ohio State,48,86,1,-38,2013-12-11
Princeton,Rutgers,78,73,0,5,2013-12-11
Weber State,Utah Valley,59,62,1,-3,2013-12-11
Milwaukee,Wisconsin,52,78,1,-26,2013-12-11
Savannah State,Arkansas,43,72,1,-29,2013-12-12
Maryland,Boston College,88,80,0,8,2013-12-12
Coker,College of Charleston,54,68,1,-14,2013-12-12
Florida Atlantic,DePaul,70,81,1,-11,2013-12-12
LIU-Brooklyn,NJIT,96,93,0,3,2013-12-12
Bluefield College (VA),UNC Asheville,56,92,1,-36,2013-12-12
Elon,Colorado,63,80,1,-17,2013-12-13
Iowa,Iowa State,82,85,1,-3,2013-12-13
Campbell,Loyola (IL),68,80,1,-12,2013-12-13
Army,Maine,90,80,0,10,2013-12-13
Little Rock,Memphis,59,73,1,-14,2013-12-13
Southeastern Louisiana,Mississippi State,62,68,1,-6,2013-12-13
Missouri State,Oral Roberts,70,67,0,3,2013-12-13
Arkansas-Pine Bluff,Oregon State,63,77,1,-14,2013-12-13
UC-Riverside,Air Force,52,62,1,-10,2013-12-14
Bethune-Cookman,Akron,56,84,1,-28,2013-12-14
Charleston Southern,Alabama,45,59,1,-14,2013-12-14
Colgate,Albany (NY),69,60,0,9,2013-12-14
Grambling,Arizona State,55,97,1,-42,2013-12-14
Liberty,Austin Peay,71,77,1,-6,2013-12-14
Saint Mary's,Boise State,82,74,0,8,2013-12-14
Navy,Bryant,80,90,1,-10,2013-12-14
Purdue,Butler,70,76,1,-6,2013-12-14
Cal St Dominguez Hills,Cal Poly,49,85,1,-36,2013-12-14
Fresno State,California,56,67,1,-11,2013-12-14
Hawaii,Chaminade,94,84,0,10,2013-12-14
Xavier,Cincinnati,64,47,0,17,2013-12-14
Furman,Clemson,35,71,1,-36,2013-12-14
Reinhardt,Coastal Carolina,82,118,1,-36,2013-12-14
Jacksonville State,Dartmouth,46,76,1,-30,2013-12-14
Central Michigan,Dayton,58,84,1,-26,2013-12-14
New Mexico State,Drake,81,69,0,12,2013-12-14
Robert Morris,Duquesne,67,63,0,4,2013-12-14
North Carolina A&T,East Carolina,71,84,1,-13,2013-12-14
Jackson State,Evansville,57,51,0,6,2013-12-14
Samford,Florida Gulf Coast,51,83,1,-32,2013-12-14
Howard,Fordham,60,79,1,-19,2013-12-14
Clearwater Christian,Gardner-Webb,54,106,1,-52,2013-12-14
Lipscomb,Georgia,75,84,1,-9,2013-12-14
Old Dominion,Georgia State,73,79,1,-6,2013-12-14
South Alabama,Gonzaga,59,68,1,-9,2013-12-14
James Madison,High Point,84,69,0,15,2013-12-14
Texas-Arlington,Houston Baptist,80,70,0,10,2013-12-14
Oregon,Illinois,71,64,0,7,2013-12-14
McMurry,Incarnate Word,56,83,1,-27,2013-12-14
Notre Dame,Indiana,79,72,0,7,2013-12-14
St. Bonaventure,Iona,102,89,0,13,2013-12-14
SIU-Edwardsville,Purdue-Fort Wayne,75,95,1,-20,2013-12-14
New Mexico,Kansas,63,80,1,-17,2013-12-14
Bluefield College (VA),Longwood,73,99,1,-26,2013-12-14
Houston,Louisiana,76,79,1,-3,2013-12-14
Louisiana-Monroe,LSU,54,61,1,-7,2013-12-14
Oklahoma State,Louisiana Tech,70,55,0,15,2013-12-14
Western Kentucky,Louisville,63,79,1,-16,2013-12-14
IUPUI,Marquette,50,86,1,-36,2013-12-14
West Virginia,Marshall,74,64,0,10,2013-12-14
Florida Atlantic,Maryland,62,66,1,-4,2013-12-14
Northern Illinois,UMass,54,80,1,-26,2013-12-14
Arizona,Michigan,72,70,0,2,2013-12-14
Oakland,Michigan State,63,67,1,-4,2013-12-14
Middle Tennessee,Ole Miss,63,72,1,-9,2013-12-14
Indiana State,UMKC,74,63,0,11,2013-12-14
Binghamton,Monmouth,46,74,1,-28,2013-12-14
Arkansas State,Nebraska,67,79,1,-12,2013-12-14
Omaha,Nevada,82,80,0,2,2013-12-14
Champion Baptist,New Orleans,38,101,1,-63,2013-12-14
Kentucky,UNC,77,82,1,-5,2013-12-14
Detroit,NC State,79,82,1,-3,2013-12-14
Grand Canyon,Northern Arizona,61,63,1,-2,2013-12-14
VCU,Northern Iowa,68,77,1,-9,2013-12-14
Louisiana College,Northwestern State,76,116,1,-40,2013-12-14
Alabama A&M,Ohio,47,72,1,-25,2013-12-14
North Dakota State,Ohio State,62,79,1,-17,2013-12-14
Tulsa,Oklahoma,91,101,1,-10,2013-12-14
Menlo,Pacific,73,84,1,-11,2013-12-14
Princeton,Penn State,81,79,0,2,2013-12-14
Youngstown State,Pitt,73,91,1,-18,2013-12-14
Idaho,Portland State,76,75,0,1,2013-12-14
Coppin State,Richmond,49,71,1,-22,2013-12-14
Wagner,Rider,58,79,1,-21,2013-12-14
UNC Greensboro,Rutgers,72,89,1,-17,2013-12-14
William Jessup,Sacramento State,54,85,1,-31,2013-12-14
Wofford,Saint Louis,52,66,1,-14,2013-12-14
Nicholls State,San Francisco,48,77,1,-29,2013-12-14
La Sierra,Santa Clara,61,97,1,-36,2013-12-14
St. Peter's,Seton Hall,83,80,0,3,2013-12-14
Green Bay,South Dakota,89,85,0,4,2013-12-14
Belmont,South Dakota State,72,85,1,-13,2013-12-14
UIC,Southeast Missouri State,75,69,0,6,2013-12-14
Dillard,Southern,64,107,1,-43,2013-12-14
St. Catharine,Southern Miss,60,96,1,-36,2013-12-14
UNLV,Southern Utah,73,51,0,22,2013-12-14
Canisius,St. Francis (NY),51,67,1,-16,2013-12-14
UC-Davis,Stanford,56,83,1,-27,2013-12-14
Texas State,Texas,53,85,1,-32,2013-12-14
McNeese State,Texas A&M,60,73,1,-13,2013-12-14
Sam Houston State,Toledo,61,77,1,-16,2013-12-14
Prairie View,UCLA,71,95,1,-24,2013-12-14
BYU,Utah,64,81,1,-17,2013-12-14
Utah Valley,Utah State,60,71,1,-11,2013-12-14
Loyola Marymount,Valparaiso,73,80,1,-7,2013-12-14
Idaho State,Washington,66,85,1,-19,2013-12-14
Tennessee,Wichita State,61,70,1,-9,2013-12-14
Eastern Kentucky,Wisconsin,61,86,1,-25,2013-12-14
Georgia Southern,Alabama-Birmingham,62,84,1,-22,2013-12-15
Philadelphia,Boston College,50,67,1,-17,2013-12-15
Norfolk State,Boston University,86,82,0,4,2013-12-15
Texas Southern,Cal State Fullerton,80,87,1,-7,2013-12-15
Marist,College of Charleston,69,62,0,7,2013-12-15
Drexel,Davidson,72,58,0,14,2013-12-15
Howard,Delaware State,64,62,0,2,2013-12-15
Wyoming,Denver,61,64,1,-3,2013-12-15
Chicago State,DePaul,70,77,1,-7,2013-12-15
UC-Irvine,Eastern Washington,70,61,0,9,2013-12-15
Northeastern,Fairfield,60,64,1,-4,2013-12-15
Central Connecticut,Hofstra,67,72,1,-5,2013-12-15
Troy,Kansas State,43,72,1,-29,2013-12-15
Tennessee Tech,Lamar,79,74,0,5,2013-12-15
Wright State,Miami (OH),56,59,1,-3,2013-12-15
Western Michigan,Missouri,60,66,1,-6,2013-12-15
Saint Martin's,Montana,57,73,1,-16,2013-12-15
Bowling Green State,Morehead State,67,61,0,6,2013-12-15
Stony Brook,New Hampshire,67,48,0,19,2013-12-15
Manhattan,UNC Wilmington,77,72,0,5,2013-12-15
Presentation,North Dakota,32,78,1,-46,2013-12-15
Stephen F. Austin,North Texas,87,53,0,34,2013-12-15
Chattanooga,Northern Kentucky,71,87,1,-16,2013-12-15
Maryland-Eastern Shore,Oregon State,66,98,1,-32,2013-12-15
Montana State,Portland,72,69,0,3,2013-12-15
Hartford,Sacred Heart,84,72,0,12,2013-12-15
UCSB,San Diego,72,61,0,11,2013-12-15
Pacific Lutheran,Seattle,38,66,1,-28,2013-12-15
UNC Asheville,USC Upstate,73,63,0,10,2013-12-15
Cal State Bakersfield,USC,59,63,1,-4,2013-12-15
Syracuse,St. John's (NY),68,63,0,5,2013-12-15
Fisk,Tennessee State,85,108,1,-23,2013-12-15
Texas-Rio Grande Valley,TCU,48,57,1,-9,2013-12-15
Central Arkansas,Texas Tech,57,79,1,-22,2013-12-15
Quinnipiac,Vermont,80,67,0,13,2013-12-15
La Salle,Villanova,52,73,1,-21,2013-12-15
Pepperdine,Washington State,61,78,1,-17,2013-12-15
Appalachian State,Winthrop,72,80,1,-8,2013-12-15
Oral Roberts,Akron,64,74,1,-10,2013-12-16
Western Illinois,Alabama State,52,59,1,-7,2013-12-16
SIU-Edwardsville,Chicago State,64,81,1,-17,2013-12-16
Western Carolina,Cleveland State,55,66,1,-11,2013-12-16
Gardner-Webb,Duke,66,85,1,-19,2013-12-16
Tusculum,ETSU,87,108,1,-21,2013-12-16
Kennesaw State,Georgia Tech,57,74,1,-17,2013-12-16
Central Baptist,Grambling,75,83,1,-8,2013-12-16
Canisius,Holy Cross,83,73,0,10,2013-12-16
Open Bible College,Incarnate Word,60,96,1,-36,2013-12-16
Alcorn State,Mercer,44,70,1,-26,2013-12-16
Delaware,North Dakota State,66,85,1,-19,2013-12-16
UC-Riverside,Northern Colorado,60,63,1,-3,2013-12-16
Mississippi Valley State,Northwestern,64,86,1,-22,2013-12-16
Illinois State,Oakland,75,90,1,-15,2013-12-16
UT-Martin,Presbyterian,73,70,0,3,2013-12-16
Radford,Santa Clara,62,75,1,-13,2013-12-16
New Orleans,UTEP,71,69,0,2,2013-12-16
Bacone,Abilene Christian,63,90,1,-27,2013-12-17
Wichita State,Alabama,72,67,0,5,2013-12-17
Toledo,Arkansas State,78,65,0,13,2013-12-17
Jacksonville,UCF,64,104,1,-40,2013-12-17
Pitt,Cincinnati,43,44,1,-1,2013-12-17
Arkansas-Pine Bluff,Creighton,51,88,1,-37,2013-12-17
Belmont,Denver,62,90,1,-28,2013-12-17
Memphis,Florida,75,77,1,-2,2013-12-17
Charlotte,Florida State,62,106,1,-44,2013-12-17
Elon,Georgetown,76,85,1,-9,2013-12-17
Tennessee Tech,Green Bay,49,76,1,-27,2013-12-17
Purdue Calumet,UIC,61,88,1,-27,2013-12-17
Open Bible College,Incarnate Word,53,98,1,-45,2013-12-17
Central Michigan,Jacksonville State,73,82,1,-9,2013-12-17
Immaculata,Lafayette,54,79,1,-25,2013-12-17
Howard,Liberty,59,77,1,-18,2013-12-17
Virginia Intermont,Longwood,61,80,1,-19,2013-12-17
Centenary (LA),Louisiana,69,103,1,-34,2013-12-17
McNeese State,Louisiana Tech,50,64,1,-14,2013-12-17
Missouri State,Louisville,60,90,1,-30,2013-12-17
Cal Poly,Loyola Marymount,59,79,1,-20,2013-12-17
Ball State,Marquette,53,91,1,-38,2013-12-17
Alice Lloyd,Marshall,57,121,1,-64,2013-12-17
North Florida,Michigan State,48,78,1,-30,2013-12-17
Tennessee Temple,Middle Tennessee,52,102,1,-50,2013-12-17
Florida A&M,Mississippi State,65,78,1,-13,2013-12-17
Southern Illinois,Murray State,65,73,1,-8,2013-12-17
New Mexico State,New Mexico,67,61,0,6,2013-12-17
Central Arkansas,North Texas,55,64,1,-9,2013-12-17
Texas-Arlington,Oklahoma,89,91,1,-2,2013-12-17
Delaware State,Oklahoma State,43,75,1,-32,2013-12-17
UC-Irvine,Oregon,63,91,1,-28,2013-12-17
Yale,Providence,74,76,1,-2,2013-12-17
Maryland-Eastern Shore,Purdue,50,79,1,-29,2013-12-17
Duquesne,Saint Francis (PA),78,71,0,7,2013-12-17
Dillard,South Alabama,73,82,1,-9,2013-12-17
Manhattan,South Carolina,86,68,0,18,2013-12-17
Coastal Carolina,South Carolina State,78,83,1,-5,2013-12-17
Florida Gulf Coast,South Florida,66,68,1,-2,2013-12-17
Florida Atlantic,Stetson,62,64,1,-2,2013-12-17
Washington,Tulane,73,62,0,11,2013-12-17
Austin Peay,Vanderbilt,56,58,1,-2,2013-12-17
Wofford,VCU,57,72,1,-15,2013-12-17
St. Bonaventure,Wake Forest,62,77,1,-15,2013-12-17
St. Katherine,Weber State,36,107,1,-71,2013-12-17
Bethune-Cookman,Youngstown State,59,71,1,-12,2013-12-17
Open Bible College,Abilene Christian,43,87,1,-44,2013-12-18
Detroit,Akron,60,79,1,-19,2013-12-18
Chattanooga,Alabama-Birmingham,52,67,1,-15,2013-12-18
Northwestern State,Baylor,84,91,1,-7,2013-12-18
Brevard,Citadel,68,79,1,-11,2013-12-18
Notre Dame (OH),Cleveland State,72,97,1,-25,2013-12-18
Stanford,UConn,53,51,0,2,2013-12-18
Houston Baptist,DePaul,58,78,1,-20,2013-12-18
Western Michigan,Drake,68,71,1,-3,2013-12-18
North Carolina A&T,Eastern Kentucky,73,84,1,-11,2013-12-18
Kennesaw State,Georgia Southern,55,73,1,-18,2013-12-18
Nicholls State,IUPUI,62,56,0,6,2013-12-18
Lamar,LIU-Brooklyn,79,82,1,-3,2013-12-18
Northern Illinois,Loyola (IL),55,49,0,6,2013-12-18
Vermont,UMass-Lowell,62,48,0,14,2013-12-18
Louisiana-Monroe,Ole Miss,62,75,1,-13,2013-12-18
Miami (OH),UMKC,55,69,1,-14,2013-12-18
High Point,Morgan State,74,85,1,-11,2013-12-18
Radford,UNLV,62,81,1,-19,2013-12-18
Dartmouth,New Hampshire,62,48,0,14,2013-12-18
Texas,UNC,86,83,0,3,2013-12-18
Winthrop,North Carolina Central,66,72,1,-6,2013-12-18
James Madison,UNC Greensboro,65,78,1,-13,2013-12-18
Hampton,Northern Kentucky,67,69,1,-2,2013-12-18
UMass,Ohio,83,71,0,12,2013-12-18
Delaware,Ohio State,64,76,1,-12,2013-12-18
College of Charleston,Old Dominion,51,44,0,7,2013-12-18
Towson,Oregon State,67,76,1,-9,2013-12-18
Appalachian State,Presbyterian,69,74,1,-5,2013-12-18
Campbell,Robert Morris,61,72,1,-11,2013-12-18
Drexel,St. Joseph's,55,75,1,-20,2013-12-18
Indiana State,Saint Louis,66,83,1,-17,2013-12-18
Southern Utah,San Diego State,39,76,1,-37,2013-12-18
Washington State,San Francisco State,80,50,0,30,2013-12-18
UC-Davis,San Jose State,85,89,1,-4,2013-12-18
Sacred Heart,Santa Clara,61,70,1,-9,2013-12-18
Wayne State (NE),South Dakota State,56,75,1,-19,2013-12-18
Texas-Rio Grande Valley,SMU,56,82,1,-26,2013-12-18
San Francisco,St. John's (NY),57,81,1,-24,2013-12-18
Texas Southern,Temple,90,89,0,1,2013-12-18
NC State,Tennessee,65,58,0,7,2013-12-18
Cal State Bakersfield,UTSA,90,64,0,26,2013-12-18
LSU,Texas Tech,71,69,0,2,2013-12-18
Grand Canyon,Tulsa,65,66,1,-1,2013-12-18
Charleston Southern,Western Carolina,84,92,1,-8,2013-12-18
Southern Miss,Western Kentucky,65,68,1,-3,2013-12-18
Southern,Arizona,43,69,1,-26,2013-12-19
UT-Martin,Arkansas,56,102,1,-46,2013-12-19
Clemson,Auburn,64,66,1,-2,2013-12-19
Lipscomb,Austin Peay,88,83,0,5,2013-12-19
Troy,UCSB,54,57,1,-3,2013-12-19
Iona,Dayton,84,96,1,-12,2013-12-19
UCLA,Duke,63,80,1,-17,2013-12-19
VMI,East Carolina,94,103,1,-9,2013-12-19
Central Pennsylvania College,Elon,78,126,1,-48,2013-12-19
Gardner-Webb,Georgia,49,58,1,-9,2013-12-19
Tennessee State,Illinois State,58,64,1,-6,2013-12-19
Louisiana,Jackson State,70,73,1,-3,2013-12-19
Wagner,La Salle,54,80,1,-26,2013-12-19
USC,Long Beach State,71,72,1,-1,2013-12-19
Stony Brook,Loyola (MD),76,69,0,7,2013-12-19
Florida Gulf Coast,Mississippi State,53,66,1,-13,2013-12-19
Southwestern Christian,Montana State,79,109,1,-30,2013-12-19
South Dakota,Morehead State,83,120,1,-37,2013-12-19
Seattle,Norfolk State,70,67,0,3,2013-12-19
Northwood (TX),Rice,56,69,1,-13,2013-12-19
American,Saint Mary's,44,59,1,-15,2013-12-19
Miami (FL),Savannah State,68,51,0,17,2013-12-19
USC Upstate,South Carolina,74,68,0,6,2013-12-19
Florida A&M,South Florida,70,73,1,-3,2013-12-19
Lafayette,St. Francis (NY),62,65,1,-3,2013-12-19
Hillsdale Baptist/Randall (Ok.),Tennessee Tech,56,112,1,-56,2013-12-19
Grambling,TCU,75,98,1,-23,2013-12-19
Northwestern State,UTEP,74,84,1,-10,2013-12-19
Texas State,Utah,50,69,1,-19,2013-12-19
Western Illinois,Utah State,52,68,1,-16,2013-12-19
Eastern Illinois,Wright State,43,70,1,-27,2013-12-19
Yale,Albany (NY),62,70,1,-8,2013-12-20
Jacksonville State,Little Rock,70,75,1,-5,2013-12-20
Portland,Bradley,74,53,0,21,2013-12-20
UIC,UC-Riverside,56,57,1,-1,2013-12-20
Southern Miss,Coppin State,88,74,0,14,2013-12-20
Liberty,Furman,83,86,1,-3,2013-12-20
Georgia Southern,Georgia State,61,73,1,-12,2013-12-20
Idaho State,Idaho,65,69,1,-4,2013-12-20
Nicholls State,Indiana,66,79,1,-13,2013-12-20
Samford,Jacksonville,75,58,0,17,2013-12-20
Bucknell,Marist,51,69,1,-18,2013-12-20
Omaha,Minnesota,79,92,1,-13,2013-12-20
Montana Western,Montana,74,91,1,-17,2013-12-20
Sacred Heart,UNLV,50,82,1,-32,2013-12-20
Virginia Intermont,UNC Asheville,58,83,1,-25,2013-12-20
Princeton,Pacific,83,58,0,25,2013-12-20
High Point,Syracuse,54,75,1,-21,2013-12-20
Cal State Northridge,Texas A&M-Corpus Christi,67,66,0,1,2013-12-20
Western Illinois,Troy,61,58,0,3,2013-12-20
UCSB,Utah State,71,77,1,-6,2013-12-20
Haskell Indian Nations Institute,Utah Valley,64,103,1,-39,2013-12-20
Goucher,William & Mary,60,94,1,-34,2013-12-20
SMU,Wyoming,62,54,0,8,2013-12-20
Xavier,Alabama,77,74,0,3,2013-12-21
Milligan,Appalachian State,68,100,1,-32,2013-12-21
Texas Tech,Arizona State,62,76,1,-14,2013-12-21
South Alabama,Arkansas,60,72,1,-12,2013-12-21
Southern Miss,Little Rock,74,60,0,14,2013-12-21
Pacific,Bradley,71,55,0,16,2013-12-21
Delaware,Bryant,108,107,0,1,2013-12-21
Manhattan,Buffalo,84,81,0,3,2013-12-21
Sacramento State,Cal State Fullerton,51,59,1,-8,2013-12-21
Air Force,UC-Davis,74,80,1,-6,2013-12-21
Western Illinois,UCSB,55,61,1,-6,2013-12-21
Johnson & Wales (NC),Campbell,64,95,1,-31,2013-12-21
Lamar,Canisius,74,87,1,-13,2013-12-21
Charleston Southern,Central Arkansas,97,90,0,7,2013-12-21
Coastal Carolina,Central Connecticut,65,62,0,3,2013-12-21
Rio Grande,UCF,58,86,1,-28,2013-12-21
USC Upstate,Charlotte,76,81,1,-5,2013-12-21
Middle Tennessee,Cincinnati,48,69,1,-21,2013-12-21
Kent State,College of Charleston,58,54,0,4,2013-12-21
Oklahoma State,Colorado,78,73,0,5,2013-12-21
Fairleigh Dickinson,Columbia,59,82,1,-23,2013-12-21
Jacksonville State,Coppin State,72,61,0,11,2013-12-21
Longwood,Dartmouth,64,84,1,-20,2013-12-21
UC-Irvine,Denver,63,50,0,13,2013-12-21
Austin Peay,ETSU,79,84,1,-5,2013-12-21
Butler,Evansville,68,59,0,9,2013-12-21
Fresno State,Florida,49,66,1,-17,2013-12-21
Louisville,Florida International,85,56,0,29,2013-12-21
UMass,Florida State,55,60,1,-5,2013-12-21
Hiwassee,Gardner-Webb,54,90,1,-36,2013-12-21
UMBC,George Washington,61,74,1,-13,2013-12-21
Western Carolina,Georgia,63,65,1,-2,2013-12-21
Kansas State,Gonzaga,72,62,0,10,2013-12-21
Lyon,Grambling,55,54,0,1,2013-12-21
Fairfield,Green Bay,58,74,1,-16,2013-12-21
James Madison,Hampton,55,49,0,6,2013-12-21
Vermont,Harvard,68,74,1,-6,2013-12-21
Rice,Houston,52,54,1,-2,2013-12-21
Missouri,Illinois,64,65,1,-1,2013-12-21
IUPUI,Indiana State,61,81,1,-20,2013-12-21
Eastern Illinois,Purdue-Fort Wayne,65,86,1,-21,2013-12-21
Georgetown,Kansas,64,86,1,-22,2013-12-21
Belmont,Kentucky,80,93,1,-13,2013-12-21
Quinnipiac,Lehigh,58,69,1,-11,2013-12-21
Montana State-Billings,Long Beach State,75,82,1,-7,2013-12-21
Temple,LIU-Brooklyn,101,65,0,36,2013-12-21
Alabama-Birmingham,LSU,63,86,1,-23,2013-12-21
La Sierra,Loyola Marymount,83,100,1,-17,2013-12-21
St. Joseph's,Loyola (MD),88,77,0,11,2013-12-21
New Mexico,Marquette,75,68,0,7,2013-12-21
Arkansas State,Marshall,83,82,0,1,2013-12-21
Boston University,Maryland,83,77,0,6,2013-12-21
Wilmington (DE),Maryland-Eastern Shore,65,62,0,3,2013-12-21
Duquesne,UMass-Lowell,95,77,0,18,2013-12-21
Southeast Missouri State,Memphis,65,77,1,-12,2013-12-21
Stanford,Michigan,65,68,1,-3,2013-12-21
Northeastern,Milwaukee,62,59,0,3,2013-12-21
Alabama A&M,Missouri State,47,68,1,-21,2013-12-21
Fordham,Monmouth,78,87,1,-9,2013-12-21
Citadel,Nebraska,62,77,1,-15,2013-12-21
Northern New Mexico,New Mexico State,47,97,1,-50,2013-12-21
St. Bonaventure,Niagara,74,72,0,2,2013-12-21
Holy Cross,NJIT,74,55,0,19,2013-12-21
Davidson,UNC,85,97,1,-12,2013-12-21
East Carolina,NC State,79,90,1,-11,2013-12-21
Old Dominion,UNC Wilmington,69,57,0,12,2013-12-21
South Dakota State,North Dakota,77,70,0,7,2013-12-21
Towson,North Dakota State,82,90,1,-8,2013-12-21
Bethune-Cookman,North Florida,64,68,1,-4,2013-12-21
Wayland Baptist,North Texas,77,81,1,-4,2013-12-21
Navy,Northern Kentucky,65,72,1,-7,2013-12-21
Ohio State,Notre Dame,64,61,0,3,2013-12-21
Eastern Michigan,Oakland,81,79,0,2,2013-12-21
Texas A&M,Oklahoma,52,64,1,-12,2013-12-21
Dallas Baptist,Oral Roberts,55,69,1,-14,2013-12-21
BYU,Oregon,96,100,1,-4,2013-12-21
Houston Baptist,Pepperdine,64,76,1,-12,2013-12-21
Cal Poly,Pitt,56,73,1,-17,2013-12-21
Princeton,Portland,79,93,1,-14,2013-12-21
Maine,Providence,70,94,1,-24,2013-12-21
North Carolina A&T,Saint Louis,57,79,1,-22,2013-12-21
Southern Utah,San Diego,52,67,1,-15,2013-12-21
McNeese State,San Diego State,36,65,1,-29,2013-12-21
Westminster (UT),San Jose State,66,73,1,-7,2013-12-21
Valparaiso,Southeastern,89,46,0,43,2013-12-21
Ball State,Southern Illinois,58,66,1,-8,2013-12-21
Youngstown State,St. John's (NY),87,96,1,-9,2013-12-21
Elmhurst,Stephen F. Austin,49,83,1,-34,2013-12-21
Southeastern Louisiana,UT-Martin,80,76,0,4,2013-12-21
Miami (OH),Tennessee State,79,64,0,15,2013-12-21
Michigan State,Texas,92,78,0,14,2013-12-21
Cal State Bakersfield,Texas-Arlington,75,79,1,-4,2013-12-21
Tulsa,TCU,58,70,1,-12,2013-12-21
Texas-Tyler,Texas State,54,73,1,-19,2013-12-21
Cleveland State,Toledo,67,71,1,-4,2013-12-21
Alabama State,Tulane,66,84,1,-18,2013-12-21
Troy,Utah State,50,71,1,-21,2013-12-21
Georgia Tech,Vanderbilt,63,76,1,-13,2013-12-21
Rider,Villanova,67,88,1,-21,2013-12-21
Northern Iowa,Virginia,43,57,1,-14,2013-12-21
Virginia Tech,VCU,52,82,1,-30,2013-12-21
UNC Greensboro,Wake Forest,51,59,1,-8,2013-12-21
UTEP,Washington State,64,51,0,13,2013-12-21
Murray State,Western Kentucky,64,71,1,-7,2013-12-21
Prairie View,Western Michigan,53,92,1,-39,2013-12-21
Wofford,Winthrop,62,56,0,6,2013-12-21
UMKC,Wright State,49,61,1,-12,2013-12-21
Oregon State,Akron,71,83,1,-12,2013-12-22
Milwaukee,Alabama State,67,54,0,13,2013-12-22
Boston College,Auburn,67,77,1,-10,2013-12-22
Southern,Baylor,56,81,1,-25,2013-12-22
Detroit,Bowling Green State,62,64,1,-2,2013-12-22
Idaho,Cal State Northridge,69,79,1,-10,2013-12-22
Northern Illinois,UC-Riverside,71,64,0,7,2013-12-22
Valparaiso,UCF,62,90,1,-28,2013-12-22
Ursinus,Colgate,51,79,1,-28,2013-12-22
California,Creighton,54,68,1,-14,2013-12-22
USC,Dayton,79,76,0,3,2013-12-22
Saint Francis (PA),Drexel,49,59,1,-10,2013-12-22
Elon,Florida Atlantic,67,62,0,5,2013-12-22
Florida A&M,Florida Gulf Coast,68,77,1,-9,2013-12-22
Iowa State,George Mason,79,67,0,12,2013-12-22
St. Peter's,Hartford,56,66,1,-10,2013-12-22
Boise State,Hawaii,62,61,0,1,2013-12-22
DePaul,Illinois State,64,69,1,-5,2013-12-22
Kennesaw State,Indiana,66,90,1,-24,2013-12-22
Arkansas-Pine Bluff,Iowa,61,86,1,-25,2013-12-22
Louisiana Tech,Louisiana-Monroe,83,61,0,22,2013-12-22
Penn,Marist,62,76,1,-14,2013-12-22
La Salle,Miami (FL),58,71,1,-13,2013-12-22
Mercer,Ole Miss,79,76,0,3,2013-12-22
South Florida,Mississippi State,66,71,1,-5,2013-12-22
Seattle,Omaha,69,76,1,-7,2013-12-22
Iona,Nevada,72,80,1,-8,2013-12-22
Santa Clara,UNLV,71,92,1,-21,2013-12-22
Brown,Northwestern,52,58,1,-6,2013-12-22
Robert Morris,Oakland,94,100,1,-6,2013-12-22
Mount St. Mary's,Penn State,82,92,1,-10,2013-12-22
Sacred Heart,Radford,78,94,1,-16,2013-12-22
New Hampshire,Rhode Island,45,62,1,-17,2013-12-22
Ohio,Richmond,70,69,0,1,2013-12-22
Army,Rutgers,72,75,1,-3,2013-12-22
South Carolina,Saint Mary's,78,71,0,7,2013-12-22
American,San Francisco,69,77,1,-8,2013-12-22
Eastern Washington,Seton Hall,70,92,1,-22,2013-12-22
Cornell,Stony Brook,54,76,1,-22,2013-12-22
Georgia State,UTSA,99,68,0,31,2013-12-22
Northeastern,Tulane,62,65,1,-3,2013-12-22
Weber State,UCLA,60,83,1,-23,2013-12-22
UConn,Washington,82,70,0,12,2013-12-22
Purdue,West Virginia,73,70,0,3,2013-12-22
North Carolina Central,Wichita State,66,77,1,-11,2013-12-22
Northern Colorado,Wyoming,59,72,1,-13,2013-12-22
Iowa State,Akron,83,60,0,23,2013-12-23
Northern Arizona,Arizona,44,77,1,-33,2013-12-23
South Carolina,Boise State,54,80,1,-26,2013-12-23
Binghamton,Buffalo,57,87,1,-30,2013-12-23
Chicago State,Cincinnati,62,102,1,-40,2013-12-23
Laroche,Cleveland State,42,89,1,-47,2013-12-23
UIC,Colorado State,61,74,1,-13,2013-12-23
Indiana Tech,Detroit,50,93,1,-43,2013-12-23
Albany (NY),Drake,63,71,1,-8,2013-12-23
Sacred Heart,Florida A&M,70,75,1,-5,2013-12-23
Radford,Florida Gulf Coast,64,63,0,1,2013-12-23
Loyola (IL),Fordham,69,83,1,-14,2013-12-23
Oregon State,George Mason,58,54,0,4,2013-12-23
Saint Mary's,Hawaii,74,76,1,-2,2013-12-23
South Carolina State,Jacksonville,47,61,1,-14,2013-12-23
UNLV,Mississippi State,82,66,0,16,2013-12-23
Grand Canyon,New Mexico,68,80,1,-12,2013-12-23
Evergreen State,Portland State,65,98,1,-33,2013-12-23
South Florida,Santa Clara,65,66,1,-1,2013-12-23
Hofstra,Siena,59,67,1,-8,2013-12-23
IUPUI,Southeast Missouri State,79,83,1,-4,2013-12-23
SIU-Edwardsville,Southern Illinois,57,74,1,-17,2013-12-23
NJIT,St. Francis (NY),65,77,1,-12,2013-12-23
Morehead State,Tennessee,67,82,1,-15,2013-12-23
Montana State,UTEP,55,70,1,-15,2013-12-23
North Dakota State,Utah Valley,74,70,0,4,2013-12-23
Norfolk State,Virginia,56,66,1,-10,2013-12-23
South Carolina,Akron,69,59,0,10,2013-12-25
Iowa State,Boise State,70,66,0,4,2013-12-25
Saint Mary's,George Mason,63,65,1,-2,2013-12-25
Oregon State,Hawaii,73,79,1,-6,2013-12-25
Morgan State,Cal State Northridge,80,86,1,-6,2013-12-27
St. Andrews,Mercer,56,98,1,-42,2013-12-27
Northern Kentucky,UNC,60,75,1,-15,2013-12-27
DePaul,Northwestern,57,56,0,1,2013-12-27
Defiance,Oakland,66,87,1,-21,2013-12-27
Louisiana-Monroe,Ohio State,31,71,1,-40,2013-12-27
St. Katherine,San Diego State,35,118,1,-83,2013-12-27
Lafayette,Seton Hall,58,90,1,-32,2013-12-27
Mississippi Valley State,Washington,80,95,1,-15,2013-12-27
Auburn Montgomery,Alabama State,51,78,1,-27,2013-12-28
Denver,Alcorn State,67,49,0,18,2013-12-28
UC-Irvine,Arizona State,61,74,1,-13,2013-12-28
High Point,Arkansas,48,89,1,-41,2013-12-28
Bryant,Binghamton,62,67,1,-5,2013-12-28
VCU,Boston College,69,50,0,19,2013-12-28
South Florida,Bradley,61,57,0,4,2013-12-28
Fairfield,Bucknell,73,64,0,9,2013-12-28
NJIT,Butler,48,66,1,-18,2013-12-28
Furman,California,60,90,1,-30,2013-12-28
Omaha,Central Arkansas,104,88,0,16,2013-12-28
St. Andrews,Charleston Southern,40,122,1,-82,2013-12-28
Nebraska,Cincinnati,59,74,1,-15,2013-12-28
Georgia,Colorado,70,84,1,-14,2013-12-28
Lamar,Colorado State,71,86,1,-15,2013-12-28
St. John's (NY),Columbia,65,59,0,6,2013-12-28
Eastern Washington,UConn,65,82,1,-17,2013-12-28
Eastern Michigan,Duke,59,82,1,-23,2013-12-28
Tennessee State,Eastern Illinois,69,70,1,-1,2013-12-28
Grambling,Evansville,61,96,1,-35,2013-12-28
Harvard,Fordham,94,86,0,8,2013-12-28
UC-Merced,Fresno State,43,104,1,-61,2013-12-28
Florida International,Georgetown,57,92,1,-35,2013-12-28
Santa Clara,Gonzaga,60,74,1,-14,2013-12-28
St. Francis (IL),Green Bay,41,91,1,-50,2013-12-28
George Washington,Hofstra,69,58,0,11,2013-12-28
Montana,Idaho,72,71,0,1,2013-12-28
Cal State Bakersfield,Idaho State,61,57,0,4,2013-12-28
UIC,Illinois,60,74,1,-14,2013-12-28
Belmont,Indiana State,73,85,1,-12,2013-12-28
Tulane,Kansas State,41,72,1,-31,2013-12-28
Cleveland State,Kent State,78,70,0,8,2013-12-28
Louisville,Kentucky,66,73,1,-7,2013-12-28
Southeastern,Liberty,53,92,1,-39,2013-12-28
McNeese State,LSU,52,79,1,-27,2013-12-28
BYU,Loyola Marymount,76,87,1,-11,2013-12-28
Samford,Marquette,48,71,1,-23,2013-12-28
Providence,UMass,67,69,1,-2,2013-12-28
Jackson State,Memphis,61,75,1,-14,2013-12-28
Holy Cross,Michigan,66,88,1,-22,2013-12-28
New Orleans,Michigan State,48,101,1,-53,2013-12-28
Texas A&M-Corpus Christi,Minnesota,44,65,1,-21,2013-12-28
South Dakota State,UMKC,65,60,0,5,2013-12-28
Long Beach State,Nevada,80,77,0,3,2013-12-28
Cal State Fullerton,UNLV,64,83,1,-19,2013-12-28
South Alabama,New Mexico State,64,82,1,-18,2013-12-28
UNC Wilmington,UNC Asheville,61,75,1,-14,2013-12-28
Georgia Southern,North Carolina A&T,66,63,0,3,2013-12-28
Missouri,NC State,68,64,0,4,2013-12-28
Iona,Northern Iowa,78,90,1,-12,2013-12-28
San Diego,Pepperdine,64,75,1,-11,2013-12-28
San Francisco,Portland,87,81,0,6,2013-12-28
Southern Miss,Rhode Island,77,64,0,13,2013-12-28
Old Dominion,Richmond,58,67,1,-9,2013-12-28
Cornell,St. Peter's,59,67,1,-8,2013-12-28
LIU-Brooklyn,Sam Houston State,78,82,1,-4,2013-12-28
Pacifica,San Jose State,59,87,1,-28,2013-12-28
Akron,South Carolina,45,78,1,-33,2013-12-28
Villanova,Syracuse,62,78,1,-16,2013-12-28
Western Illinois,UTEP,64,67,1,-3,2013-12-28
Coppin State,Toledo,66,85,1,-19,2013-12-28
Belhaven (MS),Troy,62,74,1,-12,2013-12-28
Alabama,UCLA,67,75,1,-8,2013-12-28
St. Katherine,Utah,51,124,1,-73,2013-12-28
San Diego Christian,Utah State,53,84,1,-31,2013-12-28
Tennessee Tech,Utah Valley,66,75,1,-9,2013-12-28
UNC Greensboro,Virginia Tech,55,52,0,3,2013-12-28
Mississippi Valley State,Washington State,48,85,1,-37,2013-12-28
Northern New Mexico,Weber State,49,75,1,-26,2013-12-28
Brescia,Western Kentucky,65,103,1,-38,2013-12-28
Prairie View,Wisconsin,43,80,1,-37,2013-12-28
Wake Forest,Xavier,53,68,1,-15,2013-12-28
Alabama A&M,Alabama-Birmingham,57,69,1,-12,2013-12-29
Western Illinois,Alcorn State,64,62,0,2,2013-12-29
Albertus Magnus,Central Connecticut,82,85,1,-3,2013-12-29
Georgia Tech,Charlotte,58,55,0,3,2013-12-29
Grand Canyon,Chattanooga,64,69,1,-5,2013-12-29
College of Charleston,Citadel,72,48,0,24,2013-12-29
Chicago State,Creighton,58,90,1,-32,2013-12-29
Murray State,Dayton,51,72,1,-21,2013-12-29
Buffalo,Drexel,55,52,0,3,2013-12-29
Georgia State,East Carolina,89,82,0,7,2013-12-29
Valparaiso,ETSU,62,73,1,-11,2013-12-29
Savannah State,Florida,34,76,1,-42,2013-12-29
Winthrop,Hampton,95,101,1,-6,2013-12-29
Eastern Kentucky,Purdue-Fort Wayne,90,68,0,22,2013-12-29
Drake,IUPUI,75,52,0,23,2013-12-29
Middle Tennessee,Maine,85,89,1,-4,2013-12-29
Tulsa,Maryland,74,85,1,-11,2013-12-29
American,Maryland-Eastern Shore,71,58,0,13,2013-12-29
Southern Illinois,Miami (OH),65,67,1,-2,2013-12-29
Southeast Missouri State,Missouri State,78,81,1,-3,2013-12-29
Brown,Niagara,65,68,1,-3,2013-12-29
North Dakota,Northern Colorado,66,84,1,-18,2013-12-29
Canisius,Notre Dame,81,87,1,-6,2013-12-29
Morgan State,Oregon,76,97,1,-21,2013-12-29
Quinnipiac,Oregon State,68,76,1,-8,2013-12-29
Penn,Rider,88,89,1,-1,2013-12-29
UC-Riverside,Sacramento State,67,69,1,-2,2013-12-29
Boston University,St. Joseph's,67,73,1,-6,2013-12-29
Howard,USC,60,82,1,-22,2013-12-29
Robert Morris (IL),SIU-Edwardsville,78,102,1,-24,2013-12-29
Cal Poly,Stanford,62,79,1,-17,2013-12-29
Texas Southern,TCU,64,77,1,-13,2013-12-29
Denver,UTEP,54,60,1,-6,2013-12-29
Duquesne,Texas-Rio Grande Valley,88,69,0,19,2013-12-29
Hartford,Washington,67,73,1,-6,2013-12-29
William & Mary,West Virginia,45,82,1,-37,2013-12-29
Davidson,Wichita State,70,81,1,-11,2013-12-29
Bowling Green State,Wright State,43,46,1,-3,2013-12-29
South Dakota,Youngstown State,59,85,1,-26,2013-12-29
Open Bible College,Abilene Christian,49,99,1,-50,2013-12-30
Thomas University,Alabama State,68,93,1,-25,2013-12-30
Bluefield College (VA),Appalachian State,70,97,1,-27,2013-12-30
Grambling,Little Rock,68,88,1,-20,2013-12-30
Southern Arkansas,Arkansas State,66,91,1,-25,2013-12-30
Coast Guard,Army,48,68,1,-20,2013-12-30
Arkansas-Pine Bluff,Auburn,59,91,1,-32,2013-12-30
Dalton State,Austin Peay,57,93,1,-36,2013-12-30
Oral Roberts,Baylor,55,81,1,-26,2013-12-30
Lehigh,Bryant,68,70,1,-2,2013-12-30
Furman,UC-Davis,75,65,0,10,2013-12-30
Georgia Southern,Campbell,63,69,1,-6,2013-12-30
Ecclesia,Central Arkansas,77,121,1,-44,2013-12-30
Maine,Chattanooga,80,86,1,-6,2013-12-30
VMI,Clemson,50,80,1,-30,2013-12-30
South Carolina State,Coastal Carolina,68,58,0,10,2013-12-30
Columbia,Colgate,76,70,0,6,2013-12-30
St. Francis (NY),Delaware State,60,57,0,3,2013-12-30
Bethune-Cookman,Detroit,53,73,1,-20,2013-12-30
Northern Kentucky,Florida Gulf Coast,56,60,1,-4,2013-12-30
Charleston Southern,Florida State,59,67,1,-8,2013-12-30
San Francisco,Gonzaga,41,69,1,-28,2013-12-30
Middle Tennessee,Grand Canyon,79,56,0,23,2013-12-30
Norfolk State,Hawaii,66,77,1,-11,2013-12-30
NJIT,Hofstra,64,75,1,-11,2013-12-30
Huston-Tillotson,Incarnate Word,73,102,1,-29,2013-12-30
Mercer,Jacksonville,86,49,0,37,2013-12-30
UT-Martin,Jacksonville State,65,70,1,-5,2013-12-30
Ball State,James Madison,68,73,1,-5,2013-12-30
Toledo,Kansas,83,93,1,-10,2013-12-30
Central Methodist,Louisiana,58,90,1,-32,2013-12-30
San Diego,Loyola Marymount,62,65,1,-3,2013-12-30
Navy,UMBC,48,63,1,-15,2013-12-30
Loyola (MD),Miami (FL),48,71,1,-23,2013-12-30
Wagner,Monmouth,59,52,0,7,2013-12-30
Asbury,Morehead State,68,102,1,-34,2013-12-30
NC State,UNC Greensboro,68,64,0,4,2013-12-30
Kennesaw State,North Florida,60,85,1,-25,2013-12-30
Longwood,Ohio,43,78,1,-35,2013-12-30
Louisiana Tech,Oklahoma,102,98,0,4,2013-12-30
Robert Morris,Oklahoma State,66,92,1,-26,2013-12-30
Saint Mary's,Pacific,88,80,0,8,2013-12-30
BYU,Pepperdine,74,80,1,-6,2013-12-30
Santa Clara,Portland,76,68,0,8,2013-12-30
Houghton,Radford,51,80,1,-29,2013-12-30
Presbyterian,Samford,59,71,1,-12,2013-12-30
UCSB,Seattle,86,70,0,16,2013-12-30
Fordham,Siena,69,79,1,-10,2013-12-30
Marshall,South Carolina,65,92,1,-27,2013-12-30
Spring Hill,Southeastern Louisiana,65,75,1,-10,2013-12-30
Champion Baptist,Southern,12,116,1,-104,2013-12-30
Delaware,St. Bonaventure,73,80,1,-7,2013-12-30
Cal State Northridge,Stephen F. Austin,67,74,1,-7,2013-12-30
Lipscomb,Stetson,63,65,1,-2,2013-12-30
Virginia,Tennessee,52,87,1,-35,2013-12-30
Rice,Texas,44,66,1,-22,2013-12-30
LIU-Brooklyn,Texas State,73,64,0,9,2013-12-30
Mount St. Mary's,Texas Tech,69,100,1,-31,2013-12-30
New Hampshire,Towson,64,72,1,-8,2013-12-30
Saint Louis,Vanderbilt,57,49,0,8,2013-12-30
Lyndon State,Vermont,48,88,1,-40,2013-12-30
Milligan,Western Carolina,72,106,1,-34,2013-12-30
Ole Miss,Western Kentucky,79,74,0,5,2013-12-30
High Point,Wofford,53,81,1,-28,2013-12-30
Coppin State,Akron,66,77,1,-11,2013-12-31
Villanova,Butler,76,73,0,3,2013-12-31
Louisville,UCF,90,65,0,25,2013-12-31
Marquette,Creighton,49,67,1,-18,2013-12-31
Lesley,Dartmouth,47,85,1,-38,2013-12-31
Saint Francis (PA),Denver,61,83,1,-22,2013-12-31
Elon,Duke,48,86,1,-38,2013-12-31
DePaul,Georgetown,54,61,1,-7,2013-12-31
UConn,Houston,71,75,1,-4,2013-12-31
Indiana,Illinois,80,83,1,-3,2013-12-31
Nebraska,Iowa,57,67,1,-10,2013-12-31
Northern Illinois,Iowa State,63,99,1,-36,2013-12-31
George Washington,Kansas State,55,72,1,-17,2013-12-31
North Carolina Central,Maryland,56,70,1,-14,2013-12-31
Selma University,Mississippi Valley State,87,99,1,-12,2013-12-31
UNC Wilmington,UNC,51,84,1,-33,2013-12-31
Montreat,UNC Asheville,41,80,1,-39,2013-12-31
Richmond,Northeastern,70,66,0,4,2013-12-31
Michigan State,Penn State,79,63,0,16,2013-12-31
Albany (NY),Pitt,46,58,1,-12,2013-12-31
Kent State,Princeton,68,73,1,-5,2013-12-31
Seton Hall,Providence,81,80,0,1,2013-12-31
Ohio State,Purdue,78,69,0,9,2013-12-31
Binghamton,St. Joseph's,44,71,1,-27,2013-12-31
North Greenville,USC Upstate,61,94,1,-33,2013-12-31
Memphis,South Florida,88,73,0,15,2013-12-31
Eastern Michigan,Syracuse,48,70,1,-22,2013-12-31
North Texas,Texas A&M,61,41,0,20,2013-12-31
Cameron,UTSA,56,64,1,-8,2013-12-31
Maryland-Eastern Shore,Virginia Tech,66,82,1,-16,2013-12-31
St. John's (NY),Xavier,60,70,1,-10,2013-12-31
Utah State,Air Force,72,73,1,-1,2014-01-01
SMU,Cincinnati,57,65,1,-8,2014-01-01
San Diego State,Colorado State,71,61,0,10,2014-01-01
College of Charleston,Davidson,76,64,0,12,2014-01-01
Winthrop,Dayton,47,81,1,-34,2014-01-01
Liberty,Delaware,64,77,1,-13,2014-01-01
Evansville,Drake,66,94,1,-28,2014-01-01
Warner Southern,Florida Atlantic,47,81,1,-34,2014-01-01
Lipscomb,Florida Gulf Coast,62,75,1,-13,2014-01-01
UNLV,Fresno State,75,62,0,13,2014-01-01
Boston College,Harvard,58,73,1,-15,2014-01-01
Loyola (IL),Indiana State,58,70,1,-12,2014-01-01
Kennesaw State,Jacksonville,66,86,1,-20,2014-01-01
Mercer,North Florida,83,89,1,-6,2014-01-01
Bradley,Northern Iowa,46,80,1,-34,2014-01-01
Temple,Rutgers,66,71,1,-5,2014-01-01
Nevada,San Jose State,62,50,0,12,2014-01-01
Northern Kentucky,Stetson,67,65,0,2,2014-01-01
Old Dominion,William & Mary,68,74,1,-6,2014-01-01
Western State,Wyoming,52,69,1,-17,2014-01-01
Marshall,Akron,58,59,1,-1,2014-01-02
Washington State,Arizona,25,60,1,-35,2014-01-02
Washington,Arizona State,76,65,0,11,2014-01-02
UT-Martin,Austin Peay,68,81,1,-13,2014-01-02
Jacksonville State,Belmont,67,78,1,-11,2014-01-02
Holy Cross,Boston University,60,70,1,-10,2014-01-02
Purdue-Fort Wayne,Bowling Green State,65,60,0,5,2014-01-02
Rhode Island,Brown,75,66,0,9,2014-01-02
American,Bucknell,67,57,0,10,2014-01-02
Simpson (CA),UC-Davis,69,93,1,-24,2014-01-02
Morgan State,UC-Irvine,63,75,1,-12,2014-01-02
Waldorf,UC-Riverside,43,85,1,-42,2014-01-02
East Carolina,Campbell,79,71,0,8,2014-01-02
Texas A&M-Corpus Christi,Central Arkansas,81,66,0,15,2014-01-02
Lehigh,Colgate,88,81,0,7,2014-01-02
Oregon State,Colorado,58,64,1,-6,2014-01-02
Gardner-Webb,Delaware State,65,66,1,-1,2014-01-02
Appalachian State,Duquesne,55,79,1,-24,2014-01-02
Eastern Kentucky,Eastern Illinois,100,81,0,19,2014-01-02
Florida International,Florida A&M,88,93,1,-5,2014-01-02
Penn,George Mason,77,80,1,-3,2014-01-02
Troy,Georgia State,72,81,1,-9,2014-01-02
Saint Mary's,Gonzaga,51,73,1,-22,2014-01-02
Texas-Rio Grande Valley,Grand Canyon,85,91,1,-6,2014-01-02
Cleveland State,Green Bay,55,66,1,-11,2014-01-02
UMKC,Idaho,80,74,0,6,2014-01-02
Portland State,Idaho State,76,87,1,-11,2014-01-02
Judson,IUPUI,50,112,1,-62,2014-01-02
Army,Lafayette,85,66,0,19,2014-01-02
Navy,Loyola (MD),57,63,1,-6,2014-01-02
Fairfield,Marist,56,75,1,-19,2014-01-02
Southeastern Louisiana,McNeese State,60,69,1,-9,2014-01-02
Youngstown State,Milwaukee,76,82,1,-6,2014-01-02
Michigan,Minnesota,63,60,0,3,2014-01-02
Maryland-Eastern Shore,Mississippi State,63,77,1,-14,2014-01-02
Illinois State,Missouri State,70,78,1,-8,2014-01-02
Siena,Monmouth,59,63,1,-4,2014-01-02
Northern Arizona,Montana,73,65,0,8,2014-01-02
Sacramento State,Montana State,55,70,1,-15,2014-01-02
Southeast Missouri State,Murray State,75,82,1,-7,2014-01-02
New Orleans,Nicholls State,83,88,1,-5,2014-01-02
Southern Utah,North Dakota,61,65,1,-4,2014-01-02
Wisconsin,Northwestern,76,49,0,27,2014-01-02
Sam Houston State,Northwestern State,107,104,0,3,2014-01-02
Houston Baptist,Oral Roberts,55,88,1,-33,2014-01-02
Pacific,Portland,64,72,1,-8,2014-01-02
Citadel,Radford,59,76,1,-17,2014-01-02
Niagara,Rider,83,85,1,-2,2014-01-02
Manhattan,St. Peter's,74,62,0,12,2014-01-02
Wofford,Samford,71,61,0,10,2014-01-02
Loyola Marymount,San Francisco,61,75,1,-14,2014-01-02
Pepperdine,Santa Clara,70,61,0,9,2014-01-02
Western Kentucky,South Alabama,58,56,0,2,2014-01-02
Cal State Northridge,South Dakota,75,76,1,-1,2014-01-02
Wichita State,Southern Illinois,82,67,0,15,2014-01-02
Morehead State,SIU-Edwardsville,70,63,0,7,2014-01-02
California,Stanford,69,62,0,7,2014-01-02
Lamar,Stephen F. Austin,65,85,1,-20,2014-01-02
Tennessee Tech,Tennessee State,57,53,0,4,2014-01-02
Arkansas State,Texas-Arlington,82,66,0,16,2014-01-02
Little Rock,Texas State,63,59,0,4,2014-01-02
Hofstra,Tulane,58,61,1,-3,2014-01-02
Oregon,Utah,70,68,0,2,2014-01-02
UIC,Valparaiso,72,87,1,-15,2014-01-02
Eastern Washington,Weber State,67,74,1,-7,2014-01-02
UNC Greensboro,Western Carolina,51,72,1,-21,2014-01-02
Siena Heights,Western Michigan,47,83,1,-36,2014-01-02
Oakland,Wright State,64,76,1,-12,2014-01-02
Oakland City,Ball State,58,94,1,-36,2014-01-03
Savannah State,Baylor,50,80,1,-30,2014-01-03
Marygrove,Central Michigan,44,127,1,-83,2014-01-03
Central Connecticut,Coastal Carolina,67,86,1,-19,2014-01-03
Georgia,George Washington,55,73,1,-18,2014-01-03
Omaha,Hawaii,73,77,1,-4,2014-01-03
Lees-McRae,High Point,78,85,1,-7,2014-01-03
Mount St. Mary's,Norfolk State,104,84,0,20,2014-01-03
Bethune-Cookman,Northern Illinois,51,65,1,-14,2014-01-03
South Carolina State,South Carolina,75,82,1,-7,2014-01-03
Drexel,Southern Miss,49,66,1,-17,2014-01-03
Stony Brook,VCU,63,81,1,-18,2014-01-03
Robert Morris,Alabama,56,64,1,-8,2014-01-04
Newberry,Alabama-Birmingham,75,96,1,-21,2014-01-04
Hartford,Albany (NY),56,81,1,-25,2014-01-04
Washington,Arizona,62,71,1,-9,2014-01-04
UTSA,Arkansas,71,104,1,-33,2014-01-04
Florida A&M,Auburn,50,81,1,-31,2014-01-04
Southeast Missouri State,Austin Peay,74,80,1,-6,2014-01-04
Tennessee Tech,Belmont,62,64,1,-2,2014-01-04
Fresno State,Boise State,79,86,1,-7,2014-01-04
Clemson,Boston College,62,60,0,2,2014-01-04
Drake,Bradley,57,68,1,-11,2014-01-04
San Diego,BYU,53,87,1,-34,2014-01-04
Utah Valley,Cal State Bakersfield,82,74,0,8,2014-01-04
San Diego Christian,UC-Irvine,56,91,1,-35,2014-01-04
Master's,UCSB,52,81,1,-29,2014-01-04
Delaware State,Campbell,70,60,0,10,2014-01-04
Houston Baptist,Central Arkansas,69,86,1,-17,2014-01-04
Temple,UCF,76,78,1,-2,2014-01-04
North Carolina A&T,Charlotte,72,88,1,-16,2014-01-04
Howard,College of Charleston,50,60,1,-10,2014-01-04
St. Francis (NY),Columbia,61,81,1,-20,2014-01-04
Towson,Coppin State,81,79,0,2,2014-01-04
Vermont,Dartmouth,62,53,0,9,2014-01-04
Cal Poly,Delaware,72,82,1,-10,2014-01-04
Wright State,Detroit,53,58,1,-5,2014-01-04
Morehead State,Eastern Illinois,85,77,0,8,2014-01-04
Rochester (MI),Eastern Michigan,54,92,1,-38,2014-01-04
Indiana State,Evansville,81,62,0,19,2014-01-04
Richmond,Florida,58,67,1,-9,2014-01-04
Virginia,Florida State,62,50,0,12,2014-01-04
Chattanooga,Furman,72,63,0,9,2014-01-04
St. John's (NY),Georgetown,60,77,1,-17,2014-01-04
Samford,Georgia Southern,78,80,1,-2,2014-01-04
Pacific,Gonzaga,64,86,1,-22,2014-01-04
Alabama State,Grambling,68,51,0,17,2014-01-04
New Mexico State,Grand Canyon,84,62,0,22,2014-01-04
Youngstown State,Green Bay,69,85,1,-16,2014-01-04
Radford,Hampton,60,87,1,-27,2014-01-04
Chicago State,Idaho,57,55,0,2,2014-01-04
Eastern Washington,Idaho State,72,83,1,-11,2014-01-04
Penn State,Illinois,55,75,1,-20,2014-01-04
Our Lady of the Lake,Incarnate Word,85,100,1,-15,2014-01-04
Michigan State,Indiana,73,56,0,17,2014-01-04
Niagara,Iona,92,118,1,-26,2014-01-04
Kalamazoo,Purdue-Fort Wayne,74,110,1,-36,2014-01-04
Alabama A&M,Jackson State,68,61,0,7,2014-01-04
Oklahoma State,Kansas State,71,74,1,-3,2014-01-04
ETSU,Kennesaw State,71,55,0,16,2014-01-04
Princeton,Liberty,80,74,0,6,2014-01-04
North Florida,Lipscomb,78,73,0,5,2014-01-04
Louisiana,Louisiana-Monroe,98,103,1,-5,2014-01-04
Rhode Island,LSU,74,70,0,4,2014-01-04
Longwood,Louisiana Tech,52,126,1,-74,2014-01-04
Fairfield,Manhattan,57,83,1,-26,2014-01-04
DePaul,Marquette,56,66,1,-10,2014-01-04
Georgia Tech,Maryland,61,77,1,-16,2014-01-04
Miami (OH),UMass,65,73,1,-8,2014-01-04
New Orleans,McNeese State,69,82,1,-13,2014-01-04
Cincinnati,Memphis,69,53,0,16,2014-01-04
USC Upstate,Mercer,60,62,1,-2,2014-01-04
Cleveland State,Milwaukee,77,49,0,28,2014-01-04
Dayton,Ole Miss,83,80,0,3,2014-01-04
Arkansas-Pine Bluff,Mississippi Valley State,78,73,0,5,2014-01-04
Long Beach State,Missouri,59,69,1,-10,2014-01-04
Quinnipiac,Monmouth,94,77,0,17,2014-01-04
Sacramento State,Montana,70,82,1,-12,2014-01-04
Northern Arizona,Montana State,66,68,1,-2,2014-01-04
Wyoming,Nevada,58,61,1,-3,2014-01-04
Air Force,UNLV,75,68,0,7,2014-01-04
Sacred Heart,New Hampshire,66,53,0,13,2014-01-04
Colorado State,New Mexico,73,80,1,-7,2014-01-04
Southeastern Louisiana,Nicholls State,61,64,1,-3,2014-01-04
Ohio,UNC Asheville,79,70,0,9,2014-01-04
Pitt,NC State,74,62,0,12,2014-01-04
James Madison,UNC Wilmington,60,55,0,5,2014-01-04
Mayville State,North Dakota State,45,96,1,-51,2014-01-04
UC-Riverside,North Texas,72,76,1,-4,2014-01-04
Southern Utah,Northern Colorado,55,91,1,-36,2014-01-04
Jacksonville,Northern Kentucky,66,73,1,-7,2014-01-04
Lamar,Northwestern State,85,99,1,-14,2014-01-04
Duke,Notre Dame,77,79,1,-2,2014-01-04
Valparaiso,Oakland,70,75,1,-5,2014-01-04
Nebraska,Ohio State,53,84,1,-31,2014-01-04
George Mason,Old Dominion,66,71,1,-5,2014-01-04
Texas A&M-Corpus Christi,Oral Roberts,71,64,0,7,2014-01-04
La Salle,Penn,76,57,0,19,2014-01-04
Saint Mary's,Portland,72,63,0,9,2014-01-04
Southern,Prairie View,60,57,0,3,2014-01-04
Harvard,Rice,69,54,0,15,2014-01-04
Louisville,Rutgers,83,76,0,7,2014-01-04
NJIT,Saint Francis (PA),64,56,0,8,2014-01-04
Denver,St. Joseph's,52,53,1,-1,2014-01-04
Yale,Saint Louis,55,75,1,-20,2014-01-04
Canisius,St. Peter's,67,63,0,4,2014-01-04
Pepperdine,San Francisco,66,76,1,-10,2014-01-04
Loyola Marymount,Santa Clara,81,86,1,-5,2014-01-04
UMKC,Seattle,95,84,0,11,2014-01-04
Creighton,Seton Hall,79,66,0,13,2014-01-04
Rider,Siena,47,62,1,-15,2014-01-04
Georgia State,South Alabama,73,63,0,10,2014-01-04
Iowa Wesleyan,South Dakota,52,86,1,-34,2014-01-04
Houston,South Florida,67,58,0,9,2014-01-04
Eastern Kentucky,SIU-Edwardsville,79,85,1,-6,2014-01-04
UConn,SMU,65,74,1,-9,2014-01-04
Cornell,St. Bonaventure,57,81,1,-24,2014-01-04
Sam Houston State,Stephen F. Austin,56,73,1,-17,2014-01-04
Miami (FL),Syracuse,44,49,1,-5,2014-01-04
Tusculum,Tennessee,51,98,1,-47,2014-01-04
Jacksonville State,Tennessee State,65,70,1,-5,2014-01-04
Oklahoma,Texas,88,85,0,3,2014-01-04
Texas-Rio Grande Valley,Texas A&M,46,63,1,-17,2014-01-04
Little Rock,Texas-Arlington,72,70,0,2,2014-01-04
West Virginia,TCU,74,69,0,5,2014-01-04
Alcorn State,Texas Southern,66,83,1,-17,2014-01-04
Arkansas State,Texas State,74,69,0,5,2014-01-04
Iowa State,Texas Tech,73,62,0,11,2014-01-04
Western Kentucky,Troy,60,51,0,9,2014-01-04
Cal State Fullerton,Tulsa,57,73,1,-16,2014-01-04
Oregon State,Utah,69,80,1,-11,2014-01-04
San Jose State,Utah State,67,86,1,-19,2014-01-04
Northeastern,Vanderbilt,49,79,1,-30,2014-01-04
Washington College,VMI,54,128,1,-74,2014-01-04
Portland State,Weber State,62,79,1,-17,2014-01-04
Elon,Western Carolina,62,74,1,-12,2014-01-04
William & Mary,Western Illinois,78,67,0,11,2014-01-04
Davidson,Wofford,78,63,0,15,2014-01-04
Butler,Xavier,68,79,1,-11,2014-01-04
Washington State,Arizona State,47,66,1,-19,2014-01-05
Loyola (MD),Army,82,91,1,-9,2014-01-05
Colgate,Bucknell,57,68,1,-11,2014-01-05
Oregon,Colorado,91,100,1,-9,2014-01-05
Hofstra,Fairleigh Dickinson,67,86,1,-19,2014-01-05
American,Holy Cross,69,54,0,15,2014-01-05
Southern Illinois,Illinois State,48,66,1,-18,2014-01-05
San Diego State,Kansas,61,57,0,4,2014-01-05
Boston University,Lehigh,67,66,0,1,2014-01-05
Missouri State,Loyola (IL),57,89,1,-32,2014-01-05
Binghamton,Maine,66,82,1,-16,2014-01-05
Presbyterian,Marshall,49,77,1,-28,2014-01-05
UMBC,UMass-Lowell,54,59,1,-5,2014-01-05
Northwestern,Michigan,51,74,1,-23,2014-01-05
Purdue,Minnesota,79,82,1,-3,2014-01-05
UT-Martin,Murray State,77,91,1,-14,2014-01-05
Lafayette,Navy,71,79,1,-8,2014-01-05
Florida Gulf Coast,Stetson,68,55,0,13,2014-01-05
USC,UCLA,73,107,1,-34,2014-01-05
Providence,Villanova,61,91,1,-30,2014-01-05
UNC,Wake Forest,67,73,1,-6,2014-01-05
Northern Iowa,Wichita State,53,67,1,-14,2014-01-05
Iowa,Wisconsin,71,75,1,-4,2014-01-05
Columbia International,Charleston Southern,45,105,1,-60,2014-01-06
Chattanooga,Citadel,82,78,0,4,2014-01-06
Appalachian State,Elon,66,75,1,-9,2014-01-06
Alabama A&M,Grambling,70,58,0,12,2014-01-06
Alabama State,Jackson State,68,70,1,-2,2014-01-06
USC Upstate,Kennesaw State,58,68,1,-10,2014-01-06
Jacksonville,Lipscomb,88,85,0,3,2014-01-06
Canisius,Marist,62,65,1,-3,2014-01-06
ETSU,Mercer,63,73,1,-10,2014-01-06
Furman,UNC Greensboro,82,90,1,-8,2014-01-06
North Florida,Northern Kentucky,64,70,1,-6,2014-01-06
Maryland,Pitt,59,79,1,-20,2014-01-06
Alcorn State,Prairie View,67,70,1,-3,2014-01-06
Iona,Quinnipiac,74,86,1,-12,2014-01-06
William Jessup,Saint Mary's,46,84,1,-38,2014-01-06
Maryland-Eastern Shore,Savannah State,42,66,1,-24,2014-01-06
Southern,Texas Southern,79,71,0,8,2014-01-06
West Virginia,Texas Tech,89,86,0,3,2014-01-06
Vanderbilt,Alabama,63,68,1,-5,2014-01-07
Navy,Boston University,32,55,1,-23,2014-01-07
New Hampshire,Brown,68,72,1,-4,2014-01-07
Green Bay,Chicago State,98,62,0,36,2014-01-07
James Madison,College of Charleston,61,75,1,-14,2014-01-07
Hartford,Dartmouth,68,56,0,12,2014-01-07
Creighton,DePaul,81,62,0,19,2014-01-07
Georgia Tech,Duke,57,79,1,-22,2014-01-07
Cincinnati,Houston,61,60,0,1,2014-01-07
Youngstown State,UIC,75,62,0,13,2014-01-07
Baylor,Iowa State,72,87,1,-15,2014-01-07
Tennessee,LSU,68,50,0,18,2014-01-07
Ohio State,Michigan State,68,72,1,-4,2014-01-07
Hampton,North Carolina Central,61,74,1,-13,2014-01-07
NC State,Notre Dame,77,70,0,7,2014-01-07
Saint Louis,Rhode Island,59,58,0,1,2014-01-07
Middle Tennessee,Tennessee State,74,66,0,8,2014-01-07
Kansas State,TCU,65,47,0,18,2014-01-07
Syracuse,Virginia Tech,72,52,0,20,2014-01-07
UMBC,Albany (NY),72,73,1,-1,2014-01-08
Loyola (MD),American,51,65,1,-14,2014-01-08
Akron,Ball State,72,68,0,4,2014-01-08
Eastern Michigan,Bowling Green State,56,51,0,5,2014-01-08
Missouri State,Bradley,68,65,0,3,2014-01-08
Northern Illinois,Buffalo,46,67,1,-21,2014-01-08
High Point,Campbell,71,74,1,-3,2014-01-08
Miami (OH),Central Michigan,77,70,0,7,2014-01-08
Coastal Carolina,Charleston Southern,58,70,1,-12,2014-01-08
Detroit,Cleveland State,63,73,1,-10,2014-01-08
Stony Brook,Columbia,63,68,1,-5,2014-01-08
Harvard,UConn,56,61,1,-5,2014-01-08
Hofstra,Delaware,79,86,1,-7,2014-01-08
Indiana State,Drake,77,73,0,4,2014-01-08
Fordham,Duquesne,81,87,1,-6,2014-01-08
Murray State,Eastern Kentucky,77,64,0,13,2014-01-08
Northern Iowa,Evansville,80,53,0,27,2014-01-08
St. Peter's,Fairfield,56,55,0,1,2014-01-08
South Carolina,Florida,58,74,1,-16,2014-01-08
Air Force,Fresno State,65,71,1,-6,2014-01-08
UNC Asheville,Gardner-Webb,81,77,0,4,2014-01-08
Colgate,Holy Cross,64,73,1,-9,2014-01-08
Ohio,Kent State,59,53,0,6,2014-01-08
Mississippi State,Kentucky,63,85,1,-22,2014-01-08
Bucknell,Lafayette,96,86,0,10,2014-01-08
Army,Lehigh,79,76,0,3,2014-01-08
Southern Illinois,Loyola (IL),71,67,0,4,2014-01-08
St. Joseph's,UMass,62,66,1,-4,2014-01-08
Georgia,Missouri,70,64,0,6,2014-01-08
Nevada,UNLV,74,71,0,3,2014-01-08
Miami (FL),UNC,63,57,0,6,2014-01-08
UNC Wilmington,Northeastern,68,79,1,-11,2014-01-08
Milwaukee,Oakland,84,75,0,9,2014-01-08
Kansas,Oklahoma,90,83,0,7,2014-01-08
Texas,Oklahoma State,74,87,1,-13,2014-01-08
Minnesota,Penn State,68,65,0,3,2014-01-08
Winthrop,Presbyterian,71,67,0,4,2014-01-08
Georgetown,Providence,52,70,1,-18,2014-01-08
Liberty,Radford,63,72,1,-9,2014-01-08
Boise State,San Diego State,66,69,1,-3,2014-01-08
Colorado State,San Jose State,66,64,0,2,2014-01-08
Villanova,Seton Hall,83,67,0,16,2014-01-08
Maryland-Eastern Shore,South Carolina State,71,78,1,-7,2014-01-08
Richmond,St. Bonaventure,70,84,1,-14,2014-01-08
Arkansas,Texas A&M,53,69,1,-16,2014-01-08
Wake Forest,Virginia,51,74,1,-23,2014-01-08
Longwood,VMI,72,95,1,-23,2014-01-08
Utah,Washington,57,59,1,-2,2014-01-08
Colorado,Washington State,71,70,0,1,2014-01-08
Toledo,Western Michigan,76,87,1,-11,2014-01-08
Illinois State,Wichita State,47,66,1,-19,2014-01-08
Drexel,William & Mary,73,85,1,-12,2014-01-08
Illinois,Wisconsin,70,95,1,-25,2014-01-08
New Mexico,Wyoming,72,69,0,3,2014-01-08
Vermont,Yale,67,59,0,8,2014-01-08
UNC Greensboro,Appalachian State,66,60,0,6,2014-01-09
South Alabama,Little Rock,60,65,1,-5,2014-01-09
Troy,Arkansas State,98,84,0,14,2014-01-09
New Hampshire,Binghamton,38,67,1,-29,2014-01-09
Pepperdine,BYU,72,84,1,-12,2014-01-09
Saint Francis (PA),Bryant,67,77,1,-10,2014-01-09
DePaul,Butler,99,94,0,5,2014-01-09
Hawaii,Cal Poly,65,77,1,-12,2014-01-09
Grand Canyon,Cal State Bakersfield,66,63,0,3,2014-01-09
UC-Riverside,Cal State Fullerton,73,78,1,-5,2014-01-09
UC-Davis,Cal State Northridge,77,89,1,-12,2014-01-09
Wagner,Central Connecticut,88,59,0,29,2014-01-09
Samford,Chattanooga,81,90,1,-9,2014-01-09
Florida State,Clemson,56,41,0,15,2014-01-09
Lipscomb,ETSU,82,80,0,2,2014-01-09
Montana,Eastern Washington,62,69,1,-7,2014-01-09
Mount St. Mary's,Fairleigh Dickinson,79,85,1,-6,2014-01-09
Davidson,Furman,73,56,0,17,2014-01-09
Maine,Hartford,65,80,1,-15,2014-01-09
Stephen F. Austin,Houston Baptist,77,50,0,27,2014-01-09
Northwestern,Iowa,67,93,1,-26,2014-01-09
North Dakota State,Purdue-Fort Wayne,71,82,1,-11,2014-01-09
South Dakota State,IUPUI,86,70,0,16,2014-01-09
Stetson,Jacksonville,75,88,1,-13,2014-01-09
SIU-Edwardsville,Jacksonville State,52,61,1,-9,2014-01-09
George Washington,La Salle,72,76,1,-4,2014-01-09
Nicholls State,Lamar,64,60,0,4,2014-01-09
UC-Irvine,Long Beach State,46,44,0,2,2014-01-09
Florida Atlantic,Louisiana Tech,64,84,1,-20,2014-01-09
Memphis,Louisville,73,67,0,6,2014-01-09
Auburn,Ole Miss,62,65,1,-3,2014-01-09
Michigan,Nebraska,71,70,0,1,2014-01-09
Seattle,New Mexico State,87,96,1,-9,2014-01-09
Abilene Christian,New Orleans,81,87,1,-6,2014-01-09
Idaho State,North Dakota,62,66,1,-4,2014-01-09
Florida Gulf Coast,North Florida,79,75,0,4,2014-01-09
Southern Miss,North Texas,74,64,0,10,2014-01-09
Sacramento State,Northern Arizona,65,75,1,-10,2014-01-09
Weber State,Northern Colorado,51,70,1,-19,2014-01-09
California,Oregon,96,83,0,13,2014-01-09
Stanford,Oregon State,72,81,1,-9,2014-01-09
San Francisco,Pacific,81,72,0,9,2014-01-09
Gonzaga,Portland,73,82,1,-9,2014-01-09
Montana State,Portland State,79,76,0,3,2014-01-09
Manhattan,Quinnipiac,76,81,1,-5,2014-01-09
Florida International,Rice,71,60,0,11,2014-01-09
Robert Morris,Sacred Heart,79,70,0,9,2014-01-09
Santa Clara,Saint Mary's,57,55,0,2,2014-01-09
McNeese State,Sam Houston State,81,86,1,-5,2014-01-09
Loyola Marymount,San Diego,67,74,1,-7,2014-01-09
Northern Kentucky,USC Upstate,64,73,1,-9,2014-01-09
Belmont,Southeast Missouri State,107,94,0,13,2014-01-09
Incarnate Word,Southeastern Louisiana,72,76,1,-4,2014-01-09
Arizona State,USC,79,60,0,19,2014-01-09
LIU-Brooklyn,St. Francis (NY),64,78,1,-14,2014-01-09
South Florida,Temple,82,75,0,7,2014-01-09
Eastern Illinois,Tennessee Tech,69,81,1,-12,2014-01-09
Northwestern State,Texas A&M-Corpus Christi,87,101,1,-14,2014-01-09
Louisiana-Monroe,Texas-Arlington,79,83,1,-4,2014-01-09
Charlotte,UTEP,73,68,0,5,2014-01-09
Idaho,Texas-Rio Grande Valley,86,85,0,1,2014-01-09
Marshall,UTSA,81,90,1,-9,2014-01-09
Tulane,Tulsa,71,97,1,-26,2014-01-09
Arizona,UCLA,79,75,0,4,2014-01-09
George Mason,VCU,57,71,1,-14,2014-01-09
Georgia State,Western Kentucky,77,54,0,23,2014-01-09
Citadel,Wofford,75,79,1,-4,2014-01-09
Marquette,Xavier,79,86,1,-7,2014-01-09
Rider,Canisius,91,94,1,-3,2014-01-10
Radford,High Point,81,72,0,9,2014-01-10
Fairfield,Iona,75,84,1,-9,2014-01-10
Kennesaw State,Mercer,46,83,1,-37,2014-01-10
Monmouth,Niagara,85,74,0,11,2014-01-10
Marist,Siena,58,67,1,-9,2014-01-10
Wright State,Valparaiso,62,45,0,17,2014-01-10
Arkansas-Pine Bluff,Alabama A&M,72,64,0,8,2014-01-11
Mississippi Valley State,Alabama State,62,93,1,-31,2014-01-11
Jackson State,Alcorn State,51,64,1,-13,2014-01-11
Florida,Arkansas,84,82,0,2,2014-01-11
Troy,Little Rock,75,62,0,13,2014-01-11
South Alabama,Arkansas State,60,72,1,-12,2014-01-11
Missouri,Auburn,70,68,0,2,2014-01-11
TCU,Baylor,62,88,1,-26,2014-01-11
North Carolina A&T,Bethune-Cookman,70,67,0,3,2014-01-11
UMass-Lowell,Binghamton,71,59,0,12,2014-01-11
Wyoming,Boise State,52,50,0,2,2014-01-11
Loyola Marymount,BYU,68,91,1,-23,2014-01-11
Daniel Webster,Brown,50,91,1,-41,2014-01-11
Robert Morris,Bryant,71,67,0,4,2014-01-11
Holy Cross,Bucknell,57,61,1,-4,2014-01-11
Eastern Michigan,Buffalo,66,76,1,-10,2014-01-11
Georgetown,Butler,70,67,0,3,2014-01-11
Hawaii,Cal State Northridge,78,79,1,-1,2014-01-11
UC-Irvine,UC-Riverside,72,52,0,20,2014-01-11
Cal Poly,UCSB,72,64,0,8,2014-01-11
Saint Francis (PA),Central Connecticut,75,67,0,8,2014-01-11
Wofford,Chattanooga,69,70,1,-1,2014-01-11
Rutgers,Cincinnati,51,71,1,-20,2014-01-11
Duke,Clemson,59,72,1,-13,2014-01-11
American,Colgate,69,62,0,7,2014-01-11
Fresno State,Colorado State,57,76,1,-19,2014-01-11
Central Pennsylvania College,Columbia,78,104,1,-26,2014-01-11
UCF,UConn,61,84,1,-23,2014-01-11
Savannah State,Coppin State,75,53,0,22,2014-01-11
Oberlin,Cornell,55,77,1,-22,2014-01-11
Appalachian State,Davidson,66,78,1,-12,2014-01-11
Saint Louis,Dayton,67,59,0,8,2014-01-11
Hampton,Delaware State,73,60,0,13,2014-01-11
Oakland,Detroit,77,69,0,8,2014-01-11
Northeastern,Drexel,88,93,1,-5,2014-01-11
Old Dominion,East Carolina,81,70,0,11,2014-01-11
Northern Kentucky,ETSU,65,74,1,-9,2014-01-11
Montana State,Eastern Washington,72,77,1,-5,2014-01-11
Citadel,Elon,65,74,1,-9,2014-01-11
North Carolina Central,Florida A&M,60,63,1,-3,2014-01-11
Richmond,Fordham,77,74,0,3,2014-01-11
Coastal Carolina,Gardner-Webb,81,69,0,12,2014-01-11
St. Joseph's,George Mason,84,80,0,4,2014-01-11
Rhode Island,George Washington,56,69,1,-13,2014-01-11
Alabama,Georgia,58,66,1,-8,2014-01-11
Western Carolina,Georgia Southern,68,67,0,1,2014-01-11
Notre Dame,Georgia Tech,69,74,1,-5,2014-01-11
Dartmouth,Harvard,45,61,1,-16,2014-01-11
College of Charleston,Hofstra,71,75,1,-4,2014-01-11
Northwestern State,Houston Baptist,97,98,1,-1,2014-01-11
Loyola (IL),Illinois State,50,59,1,-9,2014-01-11
Bradley,Indiana State,59,62,1,-3,2014-01-11
South Dakota State,Purdue-Fort Wayne,75,82,1,-7,2014-01-11
North Dakota State,IUPUI,87,64,0,23,2014-01-11
Florida Gulf Coast,Jacksonville,69,76,1,-7,2014-01-11
Eastern Illinois,Jacksonville State,56,48,0,8,2014-01-11
Delaware,James Madison,78,74,0,4,2014-01-11
Kansas State,Kansas,60,86,1,-26,2014-01-11
Ball State,Kent State,74,86,1,-12,2014-01-11
Boston University,Lafayette,89,78,0,11,2014-01-11
McNeese State,Lamar,74,59,0,15,2014-01-11
UC-Davis,Long Beach State,74,99,1,-25,2014-01-11
Campbell,Longwood,75,67,0,8,2014-01-11
Texas-Arlington,Louisiana,70,90,1,-20,2014-01-11
Texas State,Louisiana-Monroe,61,36,0,25,2014-01-11
Florida International,Louisiana Tech,51,85,1,-34,2014-01-11
Lehigh,Loyola (MD),68,72,1,-4,2014-01-11
Seton Hall,Marquette,66,67,1,-1,2014-01-11
Maine,UMBC,76,79,1,-3,2014-01-11
Norfolk State,Maryland-Eastern Shore,66,62,0,4,2014-01-11
St. Bonaventure,UMass,68,73,1,-5,2014-01-11
Western Michigan,Miami (OH),78,77,0,1,2014-01-11
Minnesota,Michigan State,75,87,1,-12,2014-01-11
Alabama-Birmingham,Middle Tennessee,84,89,1,-5,2014-01-11
Ole Miss,Mississippi State,72,76,1,-4,2014-01-11
Chicago State,UMKC,68,66,0,2,2014-01-11
Wichita State,Missouri State,72,69,0,3,2014-01-11
Eastern Kentucky,Morehead State,76,65,0,11,2014-01-11
South Carolina State,Morgan State,56,73,1,-17,2014-01-11
St. Francis (NY),Mount St. Mary's,82,88,1,-6,2014-01-11
Austin Peay,Murray State,67,89,1,-22,2014-01-11
Army,Navy,60,55,0,5,2014-01-11
Utah State,Nevada,54,62,1,-8,2014-01-11
Idaho,New Mexico State,54,78,1,-24,2014-01-11
Incarnate Word,New Orleans,78,55,0,23,2014-01-11
Presbyterian,UNC Asheville,70,84,1,-14,2014-01-11
Virginia,NC State,76,45,0,31,2014-01-11
Weber State,North Dakota,72,60,0,12,2014-01-11
Stetson,North Florida,60,74,1,-14,2014-01-11
Tulane,North Texas,73,62,0,11,2014-01-11
Idaho State,Northern Colorado,75,82,1,-7,2014-01-11
Drake,Northern Iowa,66,76,1,-10,2014-01-11
Iowa State,Oklahoma,82,87,1,-5,2014-01-11
Central Arkansas,Oral Roberts,80,93,1,-13,2014-01-11
California,Oregon State,88,83,0,5,2014-01-11
Santa Clara,Pacific,68,80,1,-12,2014-01-11
Indiana,Penn State,79,76,0,3,2014-01-11
Princeton,Penn,74,77,1,-3,2014-01-11
Wake Forest,Pitt,65,80,1,-15,2014-01-11
Montana,Portland State,78,81,1,-3,2014-01-11
Florida Atlantic,Rice,73,68,0,5,2014-01-11
Fairleigh Dickinson,Sacred Heart,67,71,1,-4,2014-01-11
San Francisco,Saint Mary's,73,88,1,-15,2014-01-11
Nicholls State,Sam Houston State,61,88,1,-27,2014-01-11
Furman,Samford,55,57,1,-2,2014-01-11
Pepperdine,San Diego,69,65,0,4,2014-01-11
New Mexico,San Jose State,69,65,0,4,2014-01-11
LSU,South Carolina,71,68,0,3,2014-01-11
Lipscomb,USC Upstate,70,84,1,-14,2014-01-11
Denver,South Dakota,54,59,1,-5,2014-01-11
Tennessee State,Southeast Missouri State,94,102,1,-8,2014-01-11
Abilene Christian,Southeastern Louisiana,77,85,1,-8,2014-01-11
Grambling,Southern,49,73,1,-24,2014-01-11
Evansville,Southern Illinois,75,69,0,6,2014-01-11
Sacramento State,Southern Utah,77,49,0,28,2014-01-11
Villanova,St. John's (NY),74,67,0,7,2014-01-11
UNC,Syracuse,45,57,1,-12,2014-01-11
Memphis,Temple,79,69,0,10,2014-01-11
Texas A&M,Tennessee,57,56,0,1,2014-01-11
Belmont,UT-Martin,87,72,0,15,2014-01-11
SIU-Edwardsville,Tennessee Tech,63,64,1,-1,2014-01-11
Texas Tech,Texas,64,67,1,-3,2014-01-11
Stephen F. Austin,Texas A&M-Corpus Christi,80,70,0,10,2014-01-11
Marshall,UTEP,56,66,1,-10,2014-01-11
Seattle,Texas-Rio Grande Valley,64,46,0,18,2014-01-11
Charlotte,UTSA,77,85,1,-8,2014-01-11
Prairie View,Texas Southern,83,87,1,-4,2014-01-11
Central Michigan,Toledo,71,86,1,-15,2014-01-11
UNC Wilmington,Towson,53,60,1,-7,2014-01-11
Grand Canyon,Utah Valley,58,65,1,-7,2014-01-11
Kentucky,Vanderbilt,71,62,0,9,2014-01-11
Albany (NY),Vermont,38,68,1,-30,2014-01-11
Liberty,VMI,85,80,0,5,2014-01-11
Boston College,Virginia Tech,62,59,0,3,2014-01-11
LIU-Brooklyn,Wagner,70,84,1,-14,2014-01-11
Oklahoma State,West Virginia,73,72,0,1,2014-01-11
Omaha,Western Illinois,72,79,1,-7,2014-01-11
Charleston Southern,Winthrop,68,85,1,-17,2014-01-11
Baruch College,Yale,49,88,1,-39,2014-01-11
San Diego State,Air Force,79,72,0,7,2014-01-12
Northern Illinois,Bowling Green State,45,36,0,9,2014-01-12
Monmouth,Canisius,67,87,1,-20,2014-01-12
Xavier,Creighton,89,95,1,-6,2014-01-12
La Salle,Duquesne,75,56,0,19,2014-01-12
Maryland,Florida State,61,85,1,-24,2014-01-12
Stony Brook,Hartford,73,50,0,23,2014-01-12
SMU,Louisville,63,71,1,-8,2014-01-12
Marist,Manhattan,79,86,1,-7,2014-01-12
Green Bay,Milwaukee,93,86,0,7,2014-01-12
Rider,Niagara,90,78,0,12,2014-01-12
Illinois,Northwestern,43,49,1,-6,2014-01-12
Akron,Ohio,83,80,0,3,2014-01-12
Iowa,Ohio State,84,74,0,10,2014-01-12
Stanford,Oregon,82,80,0,2,2014-01-12
Nebraska,Purdue,64,70,1,-6,2014-01-12
Quinnipiac,St. Peter's,67,74,1,-7,2014-01-12
Iona,Siena,87,78,0,9,2014-01-12
Arizona,USC,73,53,0,20,2014-01-12
Southern Miss,Tulsa,71,75,1,-4,2014-01-12
Arizona State,UCLA,72,87,1,-15,2014-01-12
Colorado,Washington,54,71,1,-17,2014-01-12
Utah,Washington State,46,49,1,-3,2014-01-12
UIC,Wright State,53,58,1,-5,2014-01-12
Mississippi Valley State,Alabama A&M,59,68,1,-9,2014-01-13
Arkansas-Pine Bluff,Alabama State,64,77,1,-13,2014-01-13
Grambling,Alcorn State,56,64,1,-8,2014-01-13
North Carolina Central,Bethune-Cookman,64,49,0,15,2014-01-13
Syracuse,Boston College,69,59,0,10,2014-01-13
South Carolina State,Coppin State,69,75,1,-6,2014-01-13
Norfolk State,Delaware State,58,56,0,2,2014-01-13
Virginia,Duke,65,69,1,-4,2014-01-13
North Carolina A&T,Florida A&M,66,76,1,-10,2014-01-13
Savannah State,Howard,56,54,0,2,2014-01-13
Kansas,Iowa State,77,70,0,7,2014-01-13
Texas State,Louisiana,58,81,1,-23,2014-01-13
Lafayette,Loyola (MD),63,77,1,-14,2014-01-13
CCNY,NJIT,60,99,1,-39,2014-01-13
College of Charleston,Northeastern,58,49,0,9,2014-01-13
Jackson State,Southern,36,60,1,-24,2014-01-13
Northern Arizona,Southern Utah,70,36,0,34,2014-01-13
Tennessee State,UT-Martin,81,100,1,-19,2014-01-13
Texas,West Virginia,80,69,0,11,2014-01-13
Cleveland State,Youngstown State,66,67,1,-1,2014-01-13
Kentucky,Arkansas,85,87,1,-2,2014-01-14
Temple,Cincinnati,58,69,1,-11,2014-01-14
Butler,Creighton,60,88,1,-28,2014-01-14
St. John's (NY),DePaul,75,77,1,-2,2014-01-14
Towson,Drexel,80,68,0,12,2014-01-14
Western Michigan,Eastern Michigan,37,56,1,-19,2014-01-14
Georgia,Florida,50,72,1,-22,2014-01-14
VCU,George Washington,66,76,1,-10,2014-01-14
Pitt,Georgia Tech,81,74,0,7,2014-01-14
Wisconsin,Indiana,72,75,1,-3,2014-01-14
Oklahoma,Kansas State,66,72,1,-6,2014-01-14
Campbell,Liberty,68,71,1,-3,2014-01-14
Penn State,Michigan,67,80,1,-13,2014-01-14
Boise State,Nevada,74,65,0,9,2014-01-14
Northern Iowa,Southern Illinois,66,68,1,-2,2014-01-14
Bradley,Wichita State,50,72,1,-22,2014-01-14
San Jose State,Air Force,62,77,1,-15,2014-01-15
Miami (OH),Akron,52,59,1,-7,2014-01-15
Mississippi State,Alabama,61,80,1,-19,2014-01-15
Holy Cross,Army,78,75,0,3,2014-01-15
Colgate,Boston University,58,66,1,-8,2014-01-15
Central Michigan,Bowling Green State,57,67,1,-10,2014-01-15
Washington,California,56,82,1,-26,2014-01-15
Presbyterian,Charleston Southern,58,95,1,-37,2014-01-15
UNC Asheville,Coastal Carolina,78,81,1,-3,2014-01-15
William & Mary,Delaware,71,76,1,-5,2014-01-15
Valparaiso,Detroit,78,70,0,8,2014-01-15
Dayton,Fordham,80,68,0,12,2014-01-15
UMass,George Mason,88,87,0,1,2014-01-15
Longwood,High Point,75,83,1,-8,2014-01-15
Purdue,Illinois,66,58,0,8,2014-01-15
Evansville,Illinois State,78,79,1,-1,2014-01-15
Missouri State,Indiana State,55,70,1,-15,2014-01-15
Northeastern,James Madison,56,52,0,4,2014-01-15
Rhode Island,La Salle,62,72,1,-10,2014-01-15
American,Lehigh,65,63,0,2,2014-01-15
Drake,Loyola (IL),60,70,1,-10,2014-01-15
Notre Dame,Maryland,66,74,1,-8,2014-01-15
Albany (NY),UMass-Lowell,66,70,1,-4,2014-01-15
Florida State,Miami (FL),63,53,0,10,2014-01-15
LSU,Ole Miss,74,88,1,-14,2014-01-15
Bucknell,Navy,61,62,1,-1,2014-01-15
UMBC,New Hampshire,42,56,1,-14,2014-01-15
UNLV,New Mexico,76,73,0,3,2014-01-15
Hofstra,UNC Wilmington,69,64,0,5,2014-01-15
Kent State,Northern Illinois,73,64,0,9,2014-01-15
Michigan State,Northwestern,54,40,0,14,2014-01-15
Ball State,Ohio,51,71,1,-20,2014-01-15
TCU,Oklahoma State,50,82,1,-32,2014-01-15
VMI,Radford,101,88,0,13,2014-01-15
UCF,Rutgers,75,85,1,-10,2014-01-15
Duquesne,St. Joseph's,75,84,1,-9,2014-01-15
St. Bonaventure,Saint Louis,60,66,1,-6,2014-01-15
Fresno State,San Diego State,60,68,1,-8,2014-01-15
South Florida,SMU,54,71,1,-17,2014-01-15
Washington State,Stanford,48,80,1,-32,2014-01-15
Binghamton,Stony Brook,47,67,1,-20,2014-01-15
Auburn,Tennessee,67,78,1,-11,2014-01-15
South Carolina,Texas A&M,67,75,1,-8,2014-01-15
Baylor,Texas Tech,72,82,1,-10,2014-01-15
Buffalo,Toledo,65,67,1,-2,2014-01-15
Colorado State,Utah State,50,57,1,-7,2014-01-15
Clemson,Virginia Tech,56,49,0,7,2014-01-15
NC State,Wake Forest,69,70,1,-1,2014-01-15
Gardner-Webb,Winthrop,56,51,0,5,2014-01-15
Georgetown,Xavier,67,80,1,-13,2014-01-15
Oral Roberts,Abilene Christian,82,59,0,23,2014-01-16
UTSA,Alabama-Birmingham,65,78,1,-13,2014-01-16
Chattanooga,Appalachian State,80,70,0,10,2014-01-16
Arizona State,Arizona,68,91,1,-23,2014-01-16
Sacred Heart,Bryant,70,85,1,-15,2014-01-16
Cal State Northridge,Cal Poly,52,62,1,-10,2014-01-16
UC-Riverside,UC-Davis,81,69,0,12,2014-01-16
Cal State Fullerton,UC-Irvine,54,72,1,-18,2014-01-16
Long Beach State,UCSB,51,64,1,-13,2014-01-16
St. Francis (NY),Central Connecticut,76,66,0,10,2014-01-16
Tulsa,Charlotte,86,90,1,-4,2014-01-16
New Mexico State,Chicago State,81,86,1,-5,2014-01-16
Oakland,Cleveland State,76,86,1,-10,2014-01-16
UCLA,Colorado,69,56,0,13,2014-01-16
Elon,Davidson,87,85,0,2,2014-01-16
Purdue-Fort Wayne,Denver,67,64,0,3,2014-01-16
Murray State,Eastern Illinois,70,66,0,4,2014-01-16
Belmont,Eastern Kentucky,63,74,1,-11,2014-01-16
Niagara,Fairfield,67,63,0,4,2014-01-16
East Carolina,Florida Atlantic,67,78,1,-11,2014-01-16
USC Upstate,Florida Gulf Coast,60,63,1,-3,2014-01-16
Old Dominion,Florida International,52,36,0,16,2014-01-16
Furman,Georgia Southern,81,88,1,-7,2014-01-16
Arkansas State,Georgia State,72,73,1,-1,2014-01-16
Utah Valley,Idaho,71,66,0,5,2014-01-16
Southern Utah,Idaho State,45,60,1,-15,2014-01-16
Milwaukee,UIC,67,63,0,4,2014-01-16
Central Arkansas,Incarnate Word,72,87,1,-15,2014-01-16
Tennessee State,Jacksonville State,64,70,1,-6,2014-01-16
Kennesaw State,Lipscomb,83,88,1,-5,2014-01-16
Fairleigh Dickinson,LIU-Brooklyn,89,67,0,22,2014-01-16
Houston,Louisville,52,91,1,-39,2014-01-16
Portland,Loyola Marymount,71,57,0,14,2014-01-16
Vermont,Maine,83,46,0,37,2014-01-16
Siena,Manhattan,68,90,1,-22,2014-01-16
North Texas,Marshall,80,65,0,15,2014-01-16
Texas A&M-Corpus Christi,McNeese State,77,61,0,16,2014-01-16
UConn,Memphis,83,73,0,10,2014-01-16
UTEP,Middle Tennessee,63,54,0,9,2014-01-16
Ohio State,Minnesota,53,63,1,-10,2014-01-16
Texas-Rio Grande Valley,UMKC,78,66,0,12,2014-01-16
North Dakota,Montana,71,84,1,-13,2014-01-16
Northern Colorado,Montana State,55,70,1,-15,2014-01-16
Southeast Missouri State,Morehead State,67,80,1,-13,2014-01-16
Wagner,Mount St. Mary's,80,89,1,-9,2014-01-16
Lamar,New Orleans,55,77,1,-22,2014-01-16
Houston Baptist,Nicholls State,64,66,1,-2,2014-01-16
NJIT,North Carolina Central,55,71,1,-16,2014-01-16
Citadel,UNC Greensboro,65,69,1,-4,2014-01-16
Omaha,North Dakota State,69,91,1,-22,2014-01-16
Eastern Washington,Northern Arizona,65,84,1,-19,2014-01-16
Mercer,Northern Kentucky,74,58,0,16,2014-01-16
Stephen F. Austin,Northwestern State,74,58,0,16,2014-01-16
Gonzaga,Pepperdine,70,53,0,17,2014-01-16
Monmouth,Quinnipiac,61,70,1,-9,2014-01-16
St. Peter's,Rider,77,69,0,8,2014-01-16
Saint Francis (PA),Robert Morris,68,73,1,-5,2014-01-16
Portland State,Sacramento State,68,64,0,4,2014-01-16
BYU,San Francisco,83,76,0,7,2014-01-16
San Diego,Santa Clara,69,66,0,3,2014-01-16
Cal State Bakersfield,Seattle,61,57,0,4,2014-01-16
Louisiana,South Alabama,73,81,1,-8,2014-01-16
IUPUI,South Dakota,57,69,1,-12,2014-01-16
Western Illinois,South Dakota State,55,64,1,-9,2014-01-16
Sam Houston State,Southeastern Louisiana,85,78,0,7,2014-01-16
Austin Peay,SIU-Edwardsville,67,71,1,-4,2014-01-16
Rice,Southern Miss,62,84,1,-22,2014-01-16
Providence,St. John's (NY),84,83,0,1,2014-01-16
ETSU,Stetson,58,64,1,-6,2014-01-16
Louisiana-Monroe,Troy,75,64,0,11,2014-01-16
Louisiana Tech,Tulane,73,45,0,28,2014-01-16
USC,Utah,66,84,1,-18,2014-01-16
Missouri,Vanderbilt,75,78,1,-3,2014-01-16
Little Rock,Western Kentucky,87,83,0,4,2014-01-16
Southern Illinois,Bradley,60,66,1,-6,2014-01-17
Canisius,Iona,85,83,0,2,2014-01-17
Jacksonville,North Florida,82,86,1,-4,2014-01-17
Green Bay,Wright State,79,69,0,10,2014-01-17
Central Arkansas,Abilene Christian,72,73,1,-1,2014-01-18
Toledo,Akron,75,61,0,14,2014-01-18
UTEP,Alabama-Birmingham,63,61,0,2,2014-01-18
Alabama A&M,Alabama State,58,67,1,-9,2014-01-18
Mississippi Valley State,Alcorn State,53,65,1,-12,2014-01-18
Lafayette,American,61,66,1,-5,2014-01-18
Georgia Southern,Appalachian State,68,81,1,-13,2014-01-18
Southern,Arkansas-Pine Bluff,60,56,0,4,2014-01-18
Florida,Auburn,68,61,0,7,2014-01-18
Miami (OH),Ball State,64,52,0,12,2014-01-18
Oklahoma,Baylor,66,64,0,2,2014-01-18
Utah State,Boise State,74,78,1,-4,2014-01-18
Kent State,Buffalo,60,71,1,-11,2014-01-18
Marquette,Butler,57,69,1,-12,2014-01-18
Long Beach State,Cal Poly,63,62,0,1,2014-01-18
UCSB,Cal State Northridge,79,69,0,10,2014-01-18
Washington State,California,55,76,1,-21,2014-01-18
Cal State Fullerton,UC-Davis,61,69,1,-8,2014-01-18
VMI,Campbell,93,97,1,-4,2014-01-18
LIU-Brooklyn,Central Connecticut,62,61,0,1,2014-01-18
SMU,UCF,58,46,0,12,2014-01-18
Eastern Michigan,Central Michigan,72,59,0,13,2014-01-18
UNC Asheville,Charleston Southern,80,76,0,4,2014-01-18
North Texas,Charlotte,74,76,1,-2,2014-01-18
Texas-Rio Grande Valley,Chicago State,84,61,0,23,2014-01-18
Furman,Citadel,76,71,0,5,2014-01-18
Wake Forest,Clemson,53,61,1,-8,2014-01-18
Winthrop,Coastal Carolina,73,72,0,1,2014-01-18
Navy,Colgate,41,63,1,-22,2014-01-18
USC,Colorado,62,83,1,-21,2014-01-18
Air Force,Colorado State,68,74,1,-6,2014-01-18
Cornell,Columbia,61,71,1,-10,2014-01-18
Louisville,UConn,76,64,0,12,2014-01-18
IUPUI,Denver,45,66,1,-21,2014-01-18
Illinois State,Drake,77,63,0,14,2014-01-18
NC State,Duke,60,95,1,-35,2014-01-18
Austin Peay,Eastern Illinois,64,67,1,-3,2014-01-18
Jacksonville State,Eastern Kentucky,56,60,1,-4,2014-01-18
UMass,Elon,84,74,0,10,2014-01-18
Loyola (IL),Evansville,48,53,1,-5,2014-01-18
Manhattan,Fairfield,67,71,1,-4,2014-01-18
Bryant,Fairleigh Dickinson,95,68,0,27,2014-01-18
Old Dominion,Florida Atlantic,65,60,0,5,2014-01-18
ETSU,Florida Gulf Coast,62,90,1,-28,2014-01-18
East Carolina,Florida International,64,68,1,-4,2014-01-18
New Mexico,Fresno State,89,78,0,11,2014-01-18
Seton Hall,Georgetown,67,57,0,10,2014-01-18
Arkansas,Georgia,61,66,1,-5,2014-01-18
Little Rock,Georgia State,73,99,1,-26,2014-01-18
Miami (FL),Georgia Tech,56,42,0,14,2014-01-18
Texas Southern,Grambling,74,72,0,2,2014-01-18
Coppin State,Hampton,71,68,0,3,2014-01-18
UC-Riverside,Hawaii,69,100,1,-31,2014-01-18
Lehigh,Holy Cross,42,61,1,-19,2014-01-18
Maryland-Eastern Shore,Howard,55,88,1,-33,2014-01-18
Cal State Bakersfield,Idaho,61,64,1,-3,2014-01-18
Michigan State,Illinois,78,62,0,16,2014-01-18
Oral Roberts,Incarnate Word,79,77,0,2,2014-01-18
Northwestern,Indiana,54,47,0,7,2014-01-18
Prairie View,Jackson State,85,80,0,5,2014-01-18
Oklahoma State,Kansas,78,80,1,-2,2014-01-18
West Virginia,Kansas State,56,78,1,-22,2014-01-18
Tennessee,Kentucky,66,74,1,-8,2014-01-18
Temple,La Salle,68,74,1,-6,2014-01-18
High Point,Liberty,76,70,0,6,2014-01-18
Mercer,Lipscomb,87,66,0,21,2014-01-18
Vanderbilt,LSU,58,81,1,-23,2014-01-18
Gonzaga,Loyola Marymount,82,72,0,10,2014-01-18
Albany (NY),Maine,85,78,0,7,2014-01-18
Rider,Marist,66,56,0,10,2014-01-18
Tulsa,Marshall,69,52,0,17,2014-01-18
Vermont,UMBC,73,47,0,26,2014-01-18
Houston Baptist,McNeese State,68,70,1,-2,2014-01-18
LeMoyne-Owen,Memphis,78,101,1,-23,2014-01-18
UTSA,Middle Tennessee,58,80,1,-22,2014-01-18
Texas A&M,Mississippi State,72,81,1,-9,2014-01-18
Alabama,Missouri,47,68,1,-21,2014-01-18
New Mexico State,UMKC,66,68,1,-2,2014-01-18
Northern Colorado,Montana,84,73,0,11,2014-01-18
North Dakota,Montana State,72,69,0,3,2014-01-18
UT-Martin,Morehead State,75,82,1,-7,2014-01-18
Robert Morris,Mount St. Mary's,77,69,0,8,2014-01-18
Hartford,New Hampshire,60,43,0,17,2014-01-18
Sam Houston State,New Orleans,77,70,0,7,2014-01-18
Texas A&M-Corpus Christi,Nicholls State,70,67,0,3,2014-01-18
Morgan State,Norfolk State,87,70,0,17,2014-01-18
Boston College,UNC,71,82,1,-11,2014-01-18
NJIT,North Carolina A&T,82,88,1,-6,2014-01-18
Delaware State,North Carolina Central,52,62,1,-10,2014-01-18
Davidson,UNC Greensboro,93,82,0,11,2014-01-18
Drexel,UNC Wilmington,79,63,0,16,2014-01-18
Western Illinois,North Dakota State,52,65,1,-13,2014-01-18
Delaware,Northeastern,74,70,0,4,2014-01-18
Portland State,Northern Arizona,56,77,1,-21,2014-01-18
Ohio,Northern Illinois,65,46,0,19,2014-01-18
Missouri State,Northern Iowa,89,94,1,-5,2014-01-18
Kennesaw State,Northern Kentucky,69,82,1,-13,2014-01-18
St. Joseph's,Penn,85,68,0,17,2014-01-18
Portland,Pepperdine,65,76,1,-11,2014-01-18
Gardner-Webb,Presbyterian,67,58,0,9,2014-01-18
Creighton,Providence,68,81,1,-13,2014-01-18
Penn State,Purdue,64,65,1,-1,2014-01-18
Niagara,Quinnipiac,71,85,1,-14,2014-01-18
Longwood,Radford,76,93,1,-17,2014-01-18
George Mason,Rhode Island,69,71,1,-2,2014-01-18
Dayton,Richmond,64,73,1,-9,2014-01-18
Eastern Washington,Sacramento State,64,75,1,-11,2014-01-18
Wagner,Saint Francis (PA),56,50,0,6,2014-01-18
Fordham,Saint Louis,48,70,1,-22,2014-01-18
Pacific,Saint Mary's,73,79,1,-6,2014-01-18
UNLV,San Diego State,52,63,1,-11,2014-01-18
San Diego,San Francisco,62,64,1,-2,2014-01-18
BYU,Santa Clara,91,81,0,10,2014-01-18
Bethune-Cookman,Savannah State,60,70,1,-10,2014-01-18
Louisiana-Monroe,South Alabama,64,58,0,6,2014-01-18
Ole Miss,South Carolina,75,74,0,1,2014-01-18
Florida A&M,South Carolina State,78,72,0,6,2014-01-18
Purdue-Fort Wayne,South Dakota,61,75,1,-14,2014-01-18
Omaha,South Dakota State,80,71,0,9,2014-01-18
Cincinnati,South Florida,61,54,0,7,2014-01-18
Lamar,Southeastern Louisiana,65,91,1,-26,2014-01-18
Murray State,SIU-Edwardsville,60,67,1,-7,2014-01-18
George Washington,St. Bonaventure,79,71,0,8,2014-01-18
Sacred Heart,St. Francis (NY),71,74,1,-3,2014-01-18
Dartmouth,St. John's (NY),55,69,1,-14,2014-01-18
Washington,Stanford,67,79,1,-12,2014-01-18
USC Upstate,Stetson,73,77,1,-4,2014-01-18
UMass-Lowell,Stony Brook,65,70,1,-5,2014-01-18
Pitt,Syracuse,54,59,1,-5,2014-01-18
Belmont,Tennessee State,79,65,0,14,2014-01-18
Southeast Missouri State,Tennessee Tech,83,74,0,9,2014-01-18
Iowa State,Texas,76,86,1,-10,2014-01-18
Texas Tech,TCU,60,49,0,11,2014-01-18
Texas-Arlington,Texas State,56,48,0,8,2014-01-18
Louisiana,Troy,72,59,0,13,2014-01-18
Rice,Tulane,41,58,1,-17,2014-01-18
UCLA,Utah,69,74,1,-5,2014-01-18
Milwaukee,Valparaiso,62,75,1,-13,2014-01-18
DePaul,Villanova,62,88,1,-26,2014-01-18
Florida State,Virginia,66,78,1,-12,2014-01-18
Duquesne,VCU,65,80,1,-15,2014-01-18
Southern Utah,Weber State,59,65,1,-6,2014-01-18
Samford,Western Carolina,64,67,1,-3,2014-01-18
Arkansas State,Western Kentucky,77,82,1,-5,2014-01-18
Indiana State,Wichita State,48,68,1,-20,2014-01-18
James Madison,William & Mary,56,78,1,-22,2014-01-18
Michigan,Wisconsin,77,70,0,7,2014-01-18
Chattanooga,Wofford,71,57,0,14,2014-01-18
San Jose State,Wyoming,56,67,1,-11,2014-01-18
Brown,Yale,67,74,1,-7,2014-01-18
Detroit,Youngstown State,63,77,1,-14,2014-01-18
Bucknell,Army,67,74,1,-7,2014-01-19
Wright State,Cleveland State,49,46,0,3,2014-01-19
Towson,College of Charleston,72,57,0,15,2014-01-19
Rutgers,Houston,55,77,1,-22,2014-01-19
Green Bay,UIC,69,64,0,5,2014-01-19
Siena,Iona,74,88,1,-14,2014-01-19
Minnesota,Iowa,73,94,1,-21,2014-01-19
Canisius,Monmouth,82,83,1,-1,2014-01-19
Virginia Tech,Notre Dame,63,70,1,-7,2014-01-19
Oregon,Oregon State,72,80,1,-8,2014-01-19
Utah Valley,Seattle,52,51,0,1,2014-01-19
Hofstra,SMU,49,73,1,-24,2014-01-19
Louisiana Tech,Southern Miss,71,80,1,-9,2014-01-19
Bowling Green State,Western Michigan,69,64,0,5,2014-01-19
Binghamton,Albany (NY),60,66,1,-6,2014-01-20
Alcorn State,Arkansas-Pine Bluff,71,45,0,26,2014-01-20
Fairfield,Belmont,53,62,1,-9,2014-01-20
Loyola (MD),Boston University,58,72,1,-14,2014-01-20
Xavier,DePaul,84,74,0,10,2014-01-20
Delaware,Drexel,90,77,0,13,2014-01-20
Marquette,Georgetown,80,72,0,8,2014-01-20
Prairie View,Grambling,83,82,0,1,2014-01-20
Morgan State,Hampton,80,71,0,9,2014-01-20
UMass-Lowell,Hartford,51,69,1,-18,2014-01-20
Texas Southern,Jackson State,80,84,1,-4,2014-01-20
Baylor,Kansas,68,78,1,-10,2014-01-20
St. Peter's,Marist,63,70,1,-7,2014-01-20
Stony Brook,UMBC,81,62,0,19,2014-01-20
Ohio State,Nebraska,62,68,1,-6,2014-01-20
Coppin State,Norfolk State,71,83,1,-12,2014-01-20
Delaware State,North Carolina A&T,55,66,1,-11,2014-01-20
Maryland,NC State,56,65,1,-9,2014-01-20
Florida A&M,Savannah State,68,79,1,-11,2014-01-20
Bethune-Cookman,South Carolina State,67,69,1,-2,2014-01-20
New Hampshire,Vermont,40,57,1,-17,2014-01-20
Creighton,Villanova,96,68,0,28,2014-01-20
UNC,Virginia,61,76,1,-15,2014-01-20
Idaho State,Weber State,59,65,1,-6,2014-01-20
Western Carolina,Wofford,60,71,1,-11,2014-01-20
Georgia Tech,Boston College,68,60,0,8,2014-01-21
Temple,UConn,66,90,1,-24,2014-01-21
Harvard,Florida Atlantic,53,68,1,-15,2014-01-21
Notre Dame,Florida State,74,76,1,-2,2014-01-21
Texas A&M,Kentucky,51,68,1,-17,2014-01-21
Missouri,LSU,71,77,1,-6,2014-01-21
Nicholls State,McNeese State,87,79,0,8,2014-01-21
Indiana,Michigan State,66,71,1,-5,2014-01-21
Evansville,Missouri State,61,64,1,-3,2014-01-21
Boise State,New Mexico,75,84,1,-9,2014-01-21
Purdue,Northwestern,60,63,1,-3,2014-01-21
Clemson,Pitt,43,76,1,-33,2014-01-21
Butler,Providence,56,65,1,-9,2014-01-21
Rutgers,SMU,56,70,1,-14,2014-01-21
Kansas State,Texas,64,67,1,-3,2014-01-21
Milwaukee,Wright State,57,73,1,-16,2014-01-21
Wyoming,Air Force,66,59,0,7,2014-01-22
Boston University,American,56,86,1,-30,2014-01-22
Northern Iowa,Bradley,65,69,1,-4,2014-01-22
Loyola (MD),Bucknell,60,70,1,-10,2014-01-22
Radford,Campbell,63,65,1,-2,2014-01-22
Niagara,Canisius,74,87,1,-13,2014-01-22
Army,Colgate,66,63,0,3,2014-01-22
UNC Wilmington,College of Charleston,70,75,1,-5,2014-01-22
VCU,Dayton,80,66,0,14,2014-01-22
Saint Louis,Duquesne,76,72,0,4,2014-01-22
Akron,Eastern Michigan,78,68,0,10,2014-01-22
George Mason,Fordham,70,76,1,-6,2014-01-22
Nevada,Fresno State,96,86,0,10,2014-01-22
Charleston Southern,Gardner-Webb,78,76,0,2,2014-01-22
South Carolina,Georgia,76,97,1,-21,2014-01-22
Oakland,Green Bay,69,83,1,-14,2014-01-22
William & Mary,Hofstra,60,77,1,-17,2014-01-22
Cleveland State,UIC,74,64,0,10,2014-01-22
Wichita State,Illinois State,70,55,0,15,2014-01-22
Holy Cross,Lafayette,59,58,0,1,2014-01-22
Liberty,Longwood,66,69,1,-3,2014-01-22
Indiana State,Loyola (IL),65,61,0,4,2014-01-22
Duke,Miami (FL),67,46,0,21,2014-01-22
Central Michigan,Miami (OH),80,86,1,-6,2014-01-22
Iowa,Michigan,67,75,1,-8,2014-01-22
Wisconsin,Minnesota,68,81,1,-13,2014-01-22
Auburn,Mississippi State,74,82,1,-8,2014-01-22
Southern,Mississippi Valley State,64,72,1,-8,2014-01-22
Lehigh,Navy,68,66,0,2,2014-01-22
Utah State,UNLV,42,62,1,-20,2014-01-22
Winthrop,UNC Asheville,66,81,1,-15,2014-01-22
North Carolina A&T,North Carolina Central,44,84,1,-40,2014-01-22
Bowling Green State,Ohio,58,56,0,2,2014-01-22
TCU,Oklahoma,69,77,1,-8,2014-01-22
Coastal Carolina,Presbyterian,84,72,0,12,2014-01-22
UMass,Richmond,55,58,1,-3,2014-01-22
Rhode Island,St. Joseph's,57,61,1,-4,2014-01-22
San Diego State,San Jose State,75,50,0,25,2014-01-22
Louisville,South Florida,86,47,0,39,2014-01-22
California,USC,69,77,1,-8,2014-01-22
Drake,Southern Illinois,57,54,0,3,2014-01-22
La Salle,St. Bonaventure,51,66,1,-15,2014-01-22
Arkansas,Tennessee,74,81,1,-7,2014-01-22
Northern Illinois,Toledo,68,77,1,-9,2014-01-22
Northeastern,Towson,57,54,0,3,2014-01-22
Ole Miss,Vanderbilt,63,52,0,11,2014-01-22
High Point,VMI,80,82,1,-2,2014-01-22
Wake Forest,Virginia Tech,83,77,0,6,2014-01-22
Oregon State,Washington State,66,55,0,11,2014-01-22
Texas Tech,West Virginia,81,87,1,-6,2014-01-22
Lamar,Abilene Christian,65,57,0,8,2014-01-23
Florida,Alabama,68,62,0,6,2014-01-23
Colorado,Arizona,57,69,1,-12,2014-01-23
Utah,Arizona State,75,79,1,-4,2014-01-23
Texas State,Little Rock,64,69,1,-5,2014-01-23
Jacksonville State,Austin Peay,71,59,0,12,2014-01-23
Buffalo,Ball State,68,71,1,-3,2014-01-23
Morehead State,Belmont,66,80,1,-14,2014-01-23
Hartford,Binghamton,56,54,0,2,2014-01-23
LIU-Brooklyn,Bryant,79,87,1,-8,2014-01-23
Chicago State,Cal State Bakersfield,71,63,0,8,2014-01-23
Cal Poly,Cal State Fullerton,58,56,0,2,2014-01-23
Hawaii,UC-Davis,90,73,0,17,2014-01-23
Cal State Northridge,UC-Irvine,66,72,1,-6,2014-01-23
UCSB,UC-Riverside,68,65,0,3,2014-01-23
Northwestern State,Central Arkansas,76,68,0,8,2014-01-23
Elon,Chattanooga,63,84,1,-21,2014-01-23
UCF,Cincinnati,51,69,1,-18,2014-01-23
Appalachian State,Citadel,80,67,0,13,2014-01-23
Tulane,East Carolina,59,54,0,5,2014-01-23
North Florida,ETSU,93,99,1,-6,2014-01-23
Southern Utah,Eastern Washington,83,90,1,-7,2014-01-23
St. Francis (NY),Fairleigh Dickinson,85,86,1,-1,2014-01-23
Wofford,Georgia Southern,74,64,0,10,2014-01-23
San Diego,Gonzaga,56,59,1,-3,2014-01-23
Idaho,Grand Canyon,73,86,1,-13,2014-01-23
New Orleans,Houston Baptist,79,66,0,13,2014-01-23
Montana,Idaho State,59,54,0,5,2014-01-23
Sam Houston State,Incarnate Word,74,85,1,-11,2014-01-23
Stetson,Kennesaw State,68,65,0,3,2014-01-23
Western Michigan,Kent State,75,59,0,16,2014-01-23
Georgia State,Louisiana,77,70,0,7,2014-01-23
Western Kentucky,Louisiana-Monroe,69,51,0,18,2014-01-23
Charlotte,Louisiana Tech,60,80,1,-20,2014-01-23
UMass-Lowell,Maine,74,62,0,12,2014-01-23
Houston,Memphis,59,82,1,-23,2014-01-23
Florida Gulf Coast,Mercer,55,68,1,-13,2014-01-23
Fairfield,Monmouth,60,63,1,-3,2014-01-23
Tennessee Tech,Murray State,53,92,1,-39,2014-01-23
Denver,Omaha,74,60,0,14,2014-01-23
Albany (NY),New Hampshire,56,60,1,-4,2014-01-23
Sacramento State,North Dakota,71,82,1,-11,2014-01-23
Alabama-Birmingham,North Texas,65,76,1,-11,2014-01-23
Northern Arizona,Northern Colorado,72,87,1,-15,2014-01-23
Illinois,Ohio State,55,62,1,-7,2014-01-23
Southern Miss,Old Dominion,75,60,0,15,2014-01-23
Stephen F. Austin,Oral Roberts,72,69,0,3,2014-01-23
Loyola Marymount,Pacific,92,81,0,11,2014-01-23
Nebraska,Penn State,54,58,1,-4,2014-01-23
BYU,Portland,110,114,1,-4,2014-01-23
Marshall,Rice,73,63,0,10,2014-01-23
Sacred Heart,Robert Morris,65,91,1,-26,2014-01-23
Mount St. Mary's,Saint Francis (PA),83,77,0,6,2014-01-23
Pepperdine,Saint Mary's,74,80,1,-6,2014-01-23
UNC Greensboro,Samford,78,88,1,-10,2014-01-23
St. Peter's,Siena,47,64,1,-17,2014-01-23
Jacksonville,USC Upstate,69,79,1,-10,2014-01-23
SIU-Edwardsville,Southeast Missouri State,78,82,1,-4,2014-01-23
Seton Hall,St. John's (NY),76,77,1,-1,2014-01-23
Eastern Illinois,UT-Martin,77,84,1,-7,2014-01-23
Eastern Kentucky,Tennessee State,94,78,0,16,2014-01-23
Southeastern Louisiana,Texas A&M-Corpus Christi,71,74,1,-3,2014-01-23
Troy,Texas-Arlington,56,59,1,-3,2014-01-23
Middle Tennessee,Tulsa,53,58,1,-5,2014-01-23
Stanford,UCLA,74,91,1,-17,2014-01-23
UMKC,Utah Valley,48,66,1,-18,2014-01-23
Central Connecticut,Wagner,87,83,0,4,2014-01-23
Oregon,Washington,76,80,1,-4,2014-01-23
Montana State,Weber State,57,86,1,-29,2014-01-23
Davidson,Western Carolina,82,77,0,5,2014-01-23
South Dakota,Western Illinois,61,79,1,-18,2014-01-23
Valparaiso,Youngstown State,74,71,0,3,2014-01-23
Quinnipiac,Iona,73,95,1,-22,2014-01-24
Rider,Manhattan,51,67,1,-16,2014-01-24
Detroit,Milwaukee,73,54,0,19,2014-01-24
Marist,Niagara,74,80,1,-6,2014-01-24
Lipscomb,Northern Kentucky,75,74,0,1,2014-01-24
Vermont,Stony Brook,64,67,1,-3,2014-01-24
Sam Houston State,Abilene Christian,70,51,0,19,2014-01-25
LSU,Alabama,80,82,1,-2,2014-01-25
Alabama State,Alcorn State,58,54,0,4,2014-01-25
Colorado,Arizona State,51,72,1,-21,2014-01-25
Auburn,Arkansas,67,86,1,-19,2014-01-25
Little Rock,Arkansas State,49,77,1,-28,2014-01-25
American,Army,84,74,0,10,2014-01-25
Tennessee Tech,Austin Peay,69,83,1,-14,2014-01-25
Texas,Baylor,74,60,0,14,2014-01-25
Eastern Kentucky,Belmont,81,84,1,-3,2014-01-25
Maryland-Eastern Shore,Bethune-Cookman,63,69,1,-6,2014-01-25
San Jose State,Boise State,55,76,1,-21,2014-01-25
Miami (OH),Bowling Green State,70,65,0,5,2014-01-25
Yale,Brown,56,73,1,-17,2014-01-25
St. Francis (NY),Bryant,79,83,1,-4,2014-01-25
Boston University,Bucknell,64,61,0,3,2014-01-25
St. John's (NY),Butler,69,52,0,17,2014-01-25
UMKC,Cal State Bakersfield,70,69,0,1,2014-01-25
UCSB,Cal State Fullerton,72,74,1,-2,2014-01-25
Hawaii,UC-Irvine,90,86,0,4,2014-01-25
Cal Poly,UC-Riverside,58,61,1,-3,2014-01-25
Stephen F. Austin,Central Arkansas,66,49,0,17,2014-01-25
Akron,Central Michigan,82,74,0,8,2014-01-25
Longwood,Charleston Southern,88,85,0,3,2014-01-25
UNC Greensboro,Chattanooga,67,77,1,-10,2014-01-25
Western Carolina,Citadel,78,60,0,18,2014-01-25
Valparaiso,Cleveland State,50,69,1,-19,2014-01-25
New Mexico,Colorado State,68,66,0,2,2014-01-25
Columbia,Cornell,74,58,0,16,2014-01-25
Georgetown,Creighton,63,76,1,-13,2014-01-25
Georgia Southern,Davidson,52,82,1,-30,2014-01-25
Towson,Delaware,76,83,1,-7,2014-01-25
Wichita State,Drake,78,61,0,17,2014-01-25
William & Mary,Drexel,68,66,0,2,2014-01-25
Florida State,Duke,56,78,1,-22,2014-01-25
St. Bonaventure,Duquesne,81,83,1,-2,2014-01-25
Southern Miss,East Carolina,60,46,0,14,2014-01-25
Jacksonville,ETSU,75,76,1,-1,2014-01-25
Ohio,Eastern Michigan,58,56,0,2,2014-01-25
Central Connecticut,Fairleigh Dickinson,73,86,1,-13,2014-01-25
Tennessee,Florida,41,67,1,-26,2014-01-25
Howard,Florida A&M,69,62,0,7,2014-01-25
Florida Atlantic,Florida International,57,66,1,-9,2014-01-25
Wofford,Furman,76,52,0,24,2014-01-25
Campbell,Gardner-Webb,48,66,1,-18,2014-01-25
George Washington,George Mason,75,69,0,6,2014-01-25
BYU,Gonzaga,69,84,1,-15,2014-01-25
Seattle,Grand Canyon,63,71,1,-8,2014-01-25
UNC Asheville,High Point,67,78,1,-11,2014-01-25
Northeastern,Hofstra,70,57,0,13,2014-01-25
Southeastern Louisiana,Houston Baptist,60,52,0,8,2014-01-25
Montana State,Idaho State,64,69,1,-5,2014-01-25
Lamar,Incarnate Word,64,75,1,-11,2014-01-25
Illinois State,Indiana State,62,76,1,-14,2014-01-25
Kansas State,Iowa State,75,81,1,-6,2014-01-25
IUPUI,Purdue-Fort Wayne,75,90,1,-15,2014-01-25
Grambling,Jackson State,59,76,1,-17,2014-01-25
College of Charleston,James Madison,56,58,1,-2,2014-01-25
Florida Gulf Coast,Kennesaw State,83,62,0,21,2014-01-25
Georgia,Kentucky,54,79,1,-25,2014-01-25
VCU,La Salle,97,89,0,8,2014-01-25
Lafayette,Lehigh,68,71,1,-3,2014-01-25
Presbyterian,Liberty,53,65,1,-12,2014-01-25
Cal State Northridge,Long Beach State,62,76,1,-14,2014-01-25
Mount St. Mary's,LIU-Brooklyn,71,75,1,-4,2014-01-25
Western Kentucky,Louisiana,79,70,0,9,2014-01-25
Georgia State,Louisiana-Monroe,66,58,0,8,2014-01-25
Marshall,Louisiana Tech,77,98,1,-21,2014-01-25
Northern Iowa,Loyola (IL),87,93,1,-6,2014-01-25
Colgate,Loyola (MD),60,67,1,-7,2014-01-25
Villanova,Marquette,94,85,0,9,2014-01-25
Pitt,Maryland,83,79,0,4,2014-01-25
Hartford,UMBC,58,60,1,-2,2014-01-25
Stetson,Mercer,49,87,1,-38,2014-01-25
Syracuse,Miami (FL),64,52,0,12,2014-01-25
Michigan,Michigan State,80,75,0,5,2014-01-25
Mississippi State,Ole Miss,63,82,1,-19,2014-01-25
South Carolina,Missouri,74,82,1,-8,2014-01-25
Southern Illinois,Missouri State,63,69,1,-6,2014-01-25
Jacksonville State,Murray State,65,73,1,-8,2014-01-25
Holy Cross,Navy,67,52,0,15,2014-01-25
South Dakota,Omaha,73,77,1,-4,2014-01-25
Fresno State,UNLV,73,75,1,-2,2014-01-25
Texas-Rio Grande Valley,New Mexico State,78,90,1,-12,2014-01-25
Morgan State,North Carolina A&T,67,68,1,-1,2014-01-25
Coppin State,North Carolina Central,63,87,1,-24,2014-01-25
Northern Arizona,North Dakota,68,84,1,-16,2014-01-25
Middle Tennessee,North Texas,70,63,0,7,2014-01-25
Sacramento State,Northern Colorado,62,72,1,-10,2014-01-25
Buffalo,Northern Illinois,75,67,0,8,2014-01-25
Iowa,Northwestern,76,50,0,26,2014-01-25
UIC,Oakland,75,76,1,-1,2014-01-25
West Virginia,Oklahoma State,75,81,1,-6,2014-01-25
Tulane,Old Dominion,64,70,1,-6,2014-01-25
Northwestern State,Oral Roberts,87,83,0,4,2014-01-25
Pepperdine,Pacific,66,76,1,-10,2014-01-25
NJIT,Penn,74,89,1,-15,2014-01-25
San Diego,Portland,65,63,0,2,2014-01-25
Southern Utah,Portland State,64,67,1,-3,2014-01-25
Arkansas-Pine Bluff,Prairie View,62,71,1,-9,2014-01-25
Xavier,Providence,72,81,1,-9,2014-01-25
Wisconsin,Purdue,72,58,0,14,2014-01-25
Coastal Carolina,Radford,69,61,0,8,2014-01-25
Dayton,Rhode Island,76,88,1,-12,2014-01-25
Charlotte,Rice,69,71,1,-2,2014-01-25
St. Joseph's,Richmond,62,77,1,-15,2014-01-25
Wagner,Robert Morris,70,74,1,-4,2014-01-25
UConn,Rutgers,82,71,0,11,2014-01-25
Sacred Heart,Saint Francis (PA),66,68,1,-2,2014-01-25
Loyola Marymount,Saint Mary's,61,89,1,-28,2014-01-25
Elon,Samford,59,62,1,-3,2014-01-25
Santa Clara,San Francisco,66,75,1,-9,2014-01-25
Hampton,Savannah State,80,71,0,9,2014-01-25
DePaul,Seton Hall,69,86,1,-17,2014-01-25
Norfolk State,South Carolina State,61,73,1,-12,2014-01-25
North Florida,USC Upstate,60,71,1,-11,2014-01-25
North Dakota State,South Dakota State,85,77,0,8,2014-01-25
Eastern Illinois,Southeast Missouri State,77,74,0,3,2014-01-25
Alabama A&M,Southern,52,66,1,-14,2014-01-25
SIU-Edwardsville,UT-Martin,87,82,0,5,2014-01-25
Morehead State,Tennessee State,80,74,0,6,2014-01-25
Vanderbilt,Texas A&M,66,55,0,11,2014-01-25
New Orleans,Texas A&M-Corpus Christi,70,62,0,8,2014-01-25
South Alabama,Texas-Arlington,65,73,1,-8,2014-01-25
Kansas,TCU,91,69,0,22,2014-01-25
UTSA,UTEP,62,81,1,-19,2014-01-25
Mississippi Valley State,Texas Southern,56,94,1,-38,2014-01-25
Troy,Texas State,65,73,1,-8,2014-01-25
Oklahoma,Texas Tech,74,65,0,9,2014-01-25
Alabama-Birmingham,Tulsa,70,63,0,7,2014-01-25
San Diego State,Utah State,74,69,0,5,2014-01-25
Chicago State,Utah Valley,55,62,1,-7,2014-01-25
Virginia Tech,Virginia,45,65,1,-20,2014-01-25
Notre Dame,Wake Forest,58,65,1,-7,2014-01-25
Oregon State,Washington,81,87,1,-6,2014-01-25
Montana,Weber State,63,68,1,-5,2014-01-25
Denver,Western Illinois,67,55,0,12,2014-01-25
VMI,Winthrop,57,58,1,-1,2014-01-25
Nevada,Wyoming,62,64,1,-2,2014-01-25
Wright State,Youngstown State,67,68,1,-1,2014-01-25
Utah,Arizona,56,65,1,-9,2014-01-26
Marist,Canisius,65,78,1,-13,2014-01-26
Harvard,Dartmouth,80,50,0,30,2014-01-26
Bradley,Evansville,60,66,1,-6,2014-01-26
Siena,Fairfield,64,56,0,8,2014-01-26
Detroit,Green Bay,52,62,1,-10,2014-01-26
SMU,Houston,75,68,0,7,2014-01-26
Illinois,Indiana,46,56,1,-10,2014-01-26
Quinnipiac,Manhattan,90,86,0,4,2014-01-26
Fordham,UMass,52,90,1,-38,2014-01-26
New Hampshire,UMass-Lowell,61,32,0,29,2014-01-26
South Florida,Memphis,58,80,1,-22,2014-01-26
Minnesota,Nebraska,78,82,1,-4,2014-01-26
Clemson,UNC,61,80,1,-19,2014-01-26
Georgia Tech,NC State,78,80,1,-2,2014-01-26
Kean,Princeton,54,84,1,-30,2014-01-26
Monmouth,Rider,71,77,1,-6,2014-01-26
Iona,St. Peter's,71,63,0,8,2014-01-26
Stanford,USC,79,71,0,8,2014-01-26
Maine,Stony Brook,61,79,1,-18,2014-01-26
Cincinnati,Temple,80,76,0,4,2014-01-26
Kent State,Toledo,78,81,1,-3,2014-01-26
California,UCLA,64,76,1,-12,2014-01-26
Binghamton,Vermont,39,72,1,-33,2014-01-26
Oregon,Washington State,71,44,0,27,2014-01-26
Ball State,Western Michigan,53,62,1,-9,2014-01-26
Alabama A&M,Alcorn State,64,70,1,-6,2014-01-27
Howard,Bethune-Cookman,47,58,1,-11,2014-01-27
NJIT,Delaware State,65,59,0,6,2014-01-27
Villanova,Georgetown,65,60,0,5,2014-01-27
Colgate,Lafayette,75,68,0,7,2014-01-27
Coppin State,North Carolina A&T,70,54,0,16,2014-01-27
Morgan State,North Carolina Central,52,53,1,-1,2014-01-27
Oklahoma State,Oklahoma,76,88,1,-12,2014-01-27
Duke,Pitt,80,65,0,15,2014-01-27
Eastern Washington,Portland State,83,92,1,-9,2014-01-27
Mississippi Valley State,Prairie View,81,72,0,9,2014-01-27
Norfolk State,Savannah State,56,49,0,7,2014-01-27
Hampton,South Carolina State,67,56,0,11,2014-01-27
Alabama State,Southern,55,68,1,-13,2014-01-27
Arkansas-Pine Bluff,Texas Southern,71,72,1,-1,2014-01-27
Hofstra,Towson,58,76,1,-18,2014-01-27
College of Charleston,William & Mary,63,74,1,-11,2014-01-27
Missouri,Arkansas,75,71,0,4,2014-01-28
West Virginia,Baylor,66,64,0,2,2014-01-28
St. John's (NY),Creighton,60,63,1,-3,2014-01-28
Cleveland State,Eastern Illinois,82,68,0,14,2014-01-28
Michigan State,Iowa,71,69,0,2,2014-01-28
Texas Tech,Kansas State,58,66,1,-8,2014-01-28
Kentucky,LSU,82,87,1,-5,2014-01-28
VMI,UNC Asheville,109,105,0,4,2014-01-28
Virginia,Notre Dame,68,53,0,15,2014-01-28
High Point,Presbyterian,81,74,0,7,2014-01-28
SMU,South Florida,71,78,1,-7,2014-01-28
New Mexico,Utah State,78,65,0,13,2014-01-28
Loyola (IL),Wichita State,45,57,1,-12,2014-01-28
Ball State,Akron,46,73,1,-27,2014-01-29
Stony Brook,Albany (NY),67,77,1,-10,2014-01-29
Navy,American,52,74,1,-22,2014-01-29
UMBC,Binghamton,73,61,0,12,2014-01-29
Air Force,Boise State,58,69,1,-11,2014-01-29
Virginia Tech,Boston College,52,76,1,-24,2014-01-29
Army,Boston University,81,86,1,-5,2014-01-29
Illinois State,Bradley,45,64,1,-19,2014-01-29
Western Michigan,Buffalo,63,84,1,-21,2014-01-29
Arizona State,California,89,78,0,11,2014-01-29
Charleston Southern,Campbell,57,65,1,-8,2014-01-29
Memphis,UCF,69,59,0,10,2014-01-29
Liberty,Coastal Carolina,64,66,1,-2,2014-01-29
St. Joseph's,Dayton,60,57,0,3,2014-01-29
UIC,Detroit,68,74,1,-6,2014-01-29
Missouri State,Drake,74,84,1,-10,2014-01-29
Bowling Green State,Eastern Michigan,57,69,1,-12,2014-01-29
Wyoming,Fresno State,62,67,1,-5,2014-01-29
La Salle,George Washington,47,69,1,-22,2014-01-29
Vanderbilt,Georgia,59,54,0,5,2014-01-29
UNC,Georgia Tech,78,65,0,13,2014-01-29
Vermont,Hartford,67,60,0,7,2014-01-29
Drexel,Hofstra,77,74,0,3,2014-01-29
Loyola (MD),Holy Cross,51,60,1,-9,2014-01-29
Iowa State,Kansas,81,92,1,-11,2014-01-29
Northern Illinois,Kent State,50,49,0,1,2014-01-29
Bucknell,Lehigh,63,66,1,-3,2014-01-29
Gardner-Webb,Longwood,82,62,0,20,2014-01-29
Miami (FL),Maryland,71,74,1,-3,2014-01-29
Toledo,Miami (OH),83,70,0,13,2014-01-29
Belmont,Morehead State,76,73,0,3,2014-01-29
Colorado State,Nevada,67,76,1,-9,2014-01-29
Maine,New Hampshire,68,60,0,8,2014-01-29
Duquesne,NJIT,71,64,0,7,2014-01-29
Florida State,NC State,70,74,1,-4,2014-01-29
James Madison,Northeastern,49,46,0,3,2014-01-29
Evansville,Northern Iowa,81,95,1,-14,2014-01-29
Central Michigan,Ohio,67,71,1,-4,2014-01-29
Penn State,Ohio State,71,70,0,1,2014-01-29
St. Francis (NY),Sacred Heart,83,78,0,5,2014-01-29
Richmond,Saint Louis,57,77,1,-20,2014-01-29
Portland,San Francisco,71,84,1,-13,2014-01-29
UNLV,San Jose State,70,46,0,24,2014-01-29
Gonzaga,Santa Clara,54,52,0,2,2014-01-29
Butler,Seton Hall,64,57,0,7,2014-01-29
Texas A&M,South Carolina,52,80,1,-28,2014-01-29
UMKC,Southeast Missouri State,81,91,1,-10,2014-01-29
Indiana State,Southern Illinois,60,79,1,-19,2014-01-29
Crowley's Ridge,SIU-Edwardsville,48,77,1,-29,2014-01-29
UMass,St. Bonaventure,65,78,1,-13,2014-01-29
Arizona,Stanford,60,57,0,3,2014-01-29
Rutgers,Temple,82,88,1,-6,2014-01-29
Ole Miss,Tennessee,70,86,1,-16,2014-01-29
Green Bay,Valparaiso,60,75,1,-15,2014-01-29
Fordham,VCU,60,76,1,-16,2014-01-29
Syracuse,Wake Forest,67,57,0,10,2014-01-29
Delaware,William & Mary,89,72,0,17,2014-01-29
Radford,Winthrop,76,64,0,12,2014-01-29
Northwestern,Wisconsin,65,56,0,9,2014-01-29
Old Dominion,Alabama-Birmingham,66,75,1,-9,2014-01-30
Louisiana,Little Rock,69,80,1,-11,2014-01-30
Alabama,Auburn,55,74,1,-19,2014-01-30
Pacific,BYU,78,88,1,-10,2014-01-30
UC-Davis,Cal Poly,62,58,0,4,2014-01-30
UC-Riverside,Cal State Northridge,89,93,1,-4,2014-01-30
UC-Irvine,UCSB,60,80,1,-20,2014-01-30
Florida Atlantic,Charlotte,53,62,1,-9,2014-01-30
Grand Canyon,Chicago State,76,75,0,1,2014-01-30
Houston,UConn,43,80,1,-37,2014-01-30
Chattanooga,Davidson,51,94,1,-43,2014-01-30
South Dakota State,Denver,74,73,0,1,2014-01-30
UT-Martin,Eastern Kentucky,66,89,1,-23,2014-01-30
North Dakota,Eastern Washington,73,61,0,12,2014-01-30
Western Carolina,Elon,60,74,1,-14,2014-01-30
Citadel,Georgia Southern,52,83,1,-31,2014-01-30
Long Beach State,Hawaii,92,83,0,9,2014-01-30
Omaha,Purdue-Fort Wayne,82,86,1,-4,2014-01-30
Western Illinois,IUPUI,69,54,0,15,2014-01-30
Lipscomb,Jacksonville,88,76,0,12,2014-01-30
Houston Baptist,Lamar,57,59,1,-2,2014-01-30
Wagner,LIU-Brooklyn,75,68,0,7,2014-01-30
Arkansas State,Louisiana-Monroe,65,72,1,-7,2014-01-30
Cincinnati,Louisville,69,66,0,3,2014-01-30
Monmouth,Marist,73,75,1,-2,2014-01-30
Providence,Marquette,50,61,1,-11,2014-01-30
Florida International,Marshall,68,80,1,-12,2014-01-30
Central Arkansas,McNeese State,76,75,0,1,2014-01-30
Purdue,Michigan,66,75,1,-9,2014-01-30
East Carolina,Middle Tennessee,67,84,1,-17,2014-01-30
Wright State,Milwaukee,64,68,1,-4,2014-01-30
Florida,Mississippi State,62,51,0,11,2014-01-30
Fairleigh Dickinson,Mount St. Mary's,82,87,1,-5,2014-01-30
Indiana,Nebraska,55,60,1,-5,2014-01-30
Cal State Bakersfield,New Mexico State,86,88,1,-2,2014-01-30
Oral Roberts,Nicholls State,72,73,1,-1,2014-01-30
Appalachian State,UNC Greensboro,61,66,1,-5,2014-01-30
Northern Kentucky,North Florida,66,67,1,-1,2014-01-30
Weber State,Northern Arizona,76,67,0,9,2014-01-30
Incarnate Word,Northwestern State,86,100,1,-14,2014-01-30
UCLA,Oregon,70,68,0,2,2014-01-30
USC,Oregon State,75,76,1,-1,2014-01-30
Northern Colorado,Portland State,57,80,1,-23,2014-01-30
Canisius,Quinnipiac,86,74,0,12,2014-01-30
Bryant,Robert Morris,76,79,1,-3,2014-01-30
Idaho State,Sacramento State,78,84,1,-6,2014-01-30
Central Connecticut,Saint Francis (PA),63,69,1,-6,2014-01-30
Texas A&M-Corpus Christi,Sam Houston State,74,78,1,-4,2014-01-30
Saint Mary's,San Diego,43,61,1,-18,2014-01-30
Niagara,Siena,62,66,1,-4,2014-01-30
North Dakota State,South Dakota,66,63,0,3,2014-01-30
New Orleans,Southeastern Louisiana,90,85,0,5,2014-01-30
Montana,Southern Utah,69,61,0,8,2014-01-30
Abilene Christian,Stephen F. Austin,48,64,1,-16,2014-01-30
Tennessee State,Tennessee Tech,81,68,0,13,2014-01-30
Louisiana Tech,UTEP,79,89,1,-10,2014-01-30
Utah Valley,Texas-Rio Grande Valley,67,53,0,14,2014-01-30
Rice,UTSA,76,89,1,-13,2014-01-30
Texas-Arlington,Western Kentucky,72,77,1,-5,2014-01-30
Murray State,Austin Peay,96,88,0,8,2014-01-31
Cornell,Brown,66,78,1,-12,2014-01-31
Penn,Dartmouth,58,67,1,-9,2014-01-31
Cleveland State,Detroit,86,78,0,8,2014-01-31
Mercer,ETSU,90,77,0,13,2014-01-31
Stetson,Florida Gulf Coast,68,71,1,-3,2014-01-31
Princeton,Harvard,76,82,1,-6,2014-01-31
Manhattan,Iona,73,85,1,-12,2014-01-31
Youngstown State,Oakland,85,86,1,-1,2014-01-31
Rider,St. Peter's,71,53,0,18,2014-01-31
Kennesaw State,USC Upstate,48,65,1,-17,2014-01-31
Presbyterian,VMI,93,107,1,-14,2014-01-31
Columbia,Yale,59,69,1,-10,2014-01-31
Tennessee,Alabama,76,59,0,17,2014-02-01
Texas Southern,Alabama A&M,62,63,1,-1,2014-02-01
East Carolina,Alabama-Birmingham,74,67,0,7,2014-02-01
Prairie View,Alabama State,63,76,1,-13,2014-02-01
Vermont,Albany (NY),55,45,0,10,2014-02-01
Holy Cross,American,57,63,1,-6,2014-02-01
Elon,Appalachian State,83,76,0,7,2014-02-01
Grambling,Arkansas-Pine Bluff,64,66,1,-2,2014-02-01
Georgia,Auburn,67,74,1,-7,2014-02-01
Northern Illinois,Ball State,67,65,0,2,2014-02-01
Savannah State,Bethune-Cookman,50,40,0,10,2014-02-01
Lehigh,Boston University,82,80,0,2,2014-02-01
Saint Mary's,BYU,71,84,1,-13,2014-02-01
Columbia,Brown,56,64,1,-8,2014-02-01
UC-Irvine,Cal Poly,64,50,0,14,2014-02-01
Arizona,California,58,60,1,-2,2014-02-01
UC-Davis,UCSB,67,82,1,-15,2014-02-01
Coastal Carolina,Campbell,61,58,0,3,2014-02-01
Liberty,Charleston Southern,66,80,1,-14,2014-02-01
Florida International,Charlotte,61,73,1,-12,2014-02-01
Furman,Chattanooga,52,67,1,-15,2014-02-01
Bucknell,Colgate,79,68,0,11,2014-02-01
Hofstra,College of Charleston,49,67,1,-18,2014-02-01
Utah,Colorado,75,79,1,-4,2014-02-01
Hampton,Coppin State,79,76,0,3,2014-02-01
Princeton,Dartmouth,69,78,1,-9,2014-02-01
Citadel,Davidson,43,62,1,-19,2014-02-01
George Washington,Dayton,65,75,1,-10,2014-02-01
UNC Wilmington,Delaware,65,66,1,-1,2014-02-01
North Dakota State,Denver,63,67,1,-4,2014-02-01
Providence,DePaul,77,72,0,5,2014-02-01
SIU-Edwardsville,Eastern Illinois,70,76,1,-6,2014-02-01
Southeast Missouri State,Eastern Kentucky,78,79,1,-1,2014-02-01
Northern Colorado,Eastern Washington,90,94,1,-4,2014-02-01
Canisius,Fairfield,84,58,0,26,2014-02-01
Texas A&M,Florida,36,69,1,-33,2014-02-01
South Carolina State,Florida A&M,63,59,0,4,2014-02-01
Clemson,Florida State,53,49,0,4,2014-02-01
Rhode Island,Fordham,79,85,1,-6,2014-02-01
Michigan State,Georgetown,60,64,1,-4,2014-02-01
Texas-Arlington,Georgia State,91,101,1,-10,2014-02-01
Wright State,Green Bay,55,62,1,-7,2014-02-01
Penn,Harvard,50,80,1,-30,2014-02-01
Cal State Northridge,Hawaii,63,77,1,-14,2014-02-01
Winthrop,High Point,64,65,1,-1,2014-02-01
North Carolina Central,Howard,79,65,0,14,2014-02-01
Seattle,Idaho,68,67,0,1,2014-02-01
Iowa,Illinois,81,74,0,7,2014-02-01
Valparaiso,UIC,70,46,0,24,2014-02-01
Drake,Illinois State,57,75,1,-18,2014-02-01
Oklahoma,Iowa State,75,81,1,-6,2014-02-01
Western Illinois,Purdue-Fort Wayne,64,77,1,-13,2014-02-01
Omaha,IUPUI,99,71,0,28,2014-02-01
Northern Kentucky,Jacksonville,77,95,1,-18,2014-02-01
Akron,Kent State,57,60,1,-3,2014-02-01
Duquesne,La Salle,63,71,1,-8,2014-02-01
Navy,Lafayette,54,72,1,-18,2014-02-01
Texas A&M-Corpus Christi,Lamar,58,35,0,23,2014-02-01
Cal State Fullerton,Long Beach State,56,75,1,-19,2014-02-01
UNC Asheville,Longwood,67,66,0,1,2014-02-01
Louisiana-Monroe,Louisiana,50,66,1,-16,2014-02-01
Arkansas,LSU,74,88,1,-14,2014-02-01
UCF,Louisville,70,87,1,-17,2014-02-01
Army,Loyola (MD),77,71,0,6,2014-02-01
UMBC,Maine,80,83,1,-3,2014-02-01
Niagara,Marist,64,78,1,-14,2014-02-01
Florida Atlantic,Marshall,65,57,0,8,2014-02-01
North Carolina A&T,Maryland-Eastern Shore,60,67,1,-7,2014-02-01
Binghamton,UMass-Lowell,55,62,1,-7,2014-02-01
Oral Roberts,McNeese State,68,79,1,-11,2014-02-01
Norfolk State,Miami (FL),49,64,1,-15,2014-02-01
Eastern Michigan,Miami (OH),61,65,1,-4,2014-02-01
Old Dominion,Middle Tennessee,48,64,1,-16,2014-02-01
Northwestern,Minnesota,55,54,0,1,2014-02-01
South Carolina,Ole Miss,71,75,1,-4,2014-02-01
Jackson State,Mississippi Valley State,66,69,1,-3,2014-02-01
Kentucky,Missouri,84,79,0,5,2014-02-01
Grand Canyon,UMKC,72,53,0,19,2014-02-01
Bradley,Missouri State,61,74,1,-13,2014-02-01
Jacksonville State,Morehead State,54,65,1,-11,2014-02-01
Delaware State,Morgan State,64,77,1,-13,2014-02-01
LIU-Brooklyn,Mount St. Mary's,92,95,1,-3,2014-02-01
Air Force,Nevada,56,69,1,-13,2014-02-01
Boise State,UNLV,69,73,1,-4,2014-02-01
San Jose State,New Mexico,47,72,1,-25,2014-02-01
Utah Valley,New Mexico State,49,72,1,-23,2014-02-01
Central Arkansas,Nicholls State,67,78,1,-11,2014-02-01
NC State,UNC,70,84,1,-14,2014-02-01
Georgia Southern,UNC Greensboro,64,62,0,2,2014-02-01
Lipscomb,North Florida,60,58,0,2,2014-02-01
Idaho State,Northern Arizona,65,67,1,-2,2014-02-01
Indiana State,Northern Iowa,87,81,0,6,2014-02-01
Abilene Christian,Northwestern State,66,84,1,-18,2014-02-01
Boston College,Notre Dame,73,76,1,-3,2014-02-01
Toledo,Ohio,90,95,1,-5,2014-02-01
Baylor,Oklahoma State,76,70,0,6,2014-02-01
USC,Oregon,66,78,1,-12,2014-02-01
Loyola Marymount,Pepperdine,69,80,1,-11,2014-02-01
North Dakota,Portland State,68,70,1,-2,2014-02-01
Gardner-Webb,Radford,73,72,0,1,2014-02-01
Central Connecticut,Robert Morris,74,73,0,1,2014-02-01
Houston,Rutgers,70,93,1,-23,2014-02-01
Weber State,Sacramento State,75,78,1,-3,2014-02-01
Fairleigh Dickinson,Saint Francis (PA),75,83,1,-8,2014-02-01
UMass,St. Joseph's,68,73,1,-5,2014-02-01
George Mason,Saint Louis,81,87,1,-6,2014-02-01
Houston Baptist,Sam Houston State,63,81,1,-18,2014-02-01
Pacific,San Diego,84,67,0,17,2014-02-01
Colorado State,San Diego State,56,65,1,-9,2014-02-01
Gonzaga,San Francisco,75,65,0,10,2014-02-01
Portland,Santa Clara,76,64,0,12,2014-02-01
Quinnipiac,Siena,103,95,0,8,2014-02-01
Little Rock,South Alabama,62,58,0,4,2014-02-01
South Dakota State,South Dakota,70,68,0,2,2014-02-01
Alcorn State,Southern,54,62,1,-8,2014-02-01
Loyola (IL),Southern Illinois,76,81,1,-5,2014-02-01
Memphis,SMU,72,87,1,-15,2014-02-01
Tulane,Southern Miss,47,78,1,-31,2014-02-01
Montana State,Southern Utah,54,52,0,2,2014-02-01
Wagner,St. Francis (NY),72,73,1,-1,2014-02-01
Marquette,St. John's (NY),59,74,1,-15,2014-02-01
Arizona State,Stanford,70,76,1,-6,2014-02-01
Incarnate Word,Stephen F. Austin,74,76,1,-2,2014-02-01
Hartford,Stony Brook,52,56,1,-4,2014-02-01
Duke,Syracuse,89,91,1,-2,2014-02-01
Villanova,Temple,90,74,0,16,2014-02-01
Belmont,Tennessee Tech,76,81,1,-5,2014-02-01
Kansas,Texas,69,81,1,-12,2014-02-01
Rice,UTEP,57,68,1,-11,2014-02-01
Cal State Bakersfield,Texas-Rio Grande Valley,72,64,0,8,2014-02-01
Louisiana Tech,UTSA,87,72,0,15,2014-02-01
TCU,Texas Tech,54,60,1,-6,2014-02-01
Drexel,Towson,73,75,1,-2,2014-02-01
Arkansas State,Troy,83,73,0,10,2014-02-01
North Texas,Tulsa,63,94,1,-31,2014-02-01
Mississippi State,Vanderbilt,49,55,1,-6,2014-02-01
Richmond,VCU,70,81,1,-11,2014-02-01
Maryland,Virginia Tech,80,60,0,20,2014-02-01
Georgia Tech,Wake Forest,79,70,0,9,2014-02-01
Washington,Washington State,67,72,1,-5,2014-02-01
Kansas State,West Virginia,71,81,1,-10,2014-02-01
Texas State,Western Kentucky,64,68,1,-4,2014-02-01
Central Michigan,Western Michigan,72,75,1,-3,2014-02-01
Evansville,Wichita State,67,81,1,-14,2014-02-01
Ohio State,Wisconsin,59,58,0,1,2014-02-01
Samford,Wofford,58,77,1,-19,2014-02-01
Utah State,Wyoming,57,74,1,-17,2014-02-01
Seton Hall,Xavier,68,60,0,8,2014-02-01
Cornell,Yale,57,61,1,-4,2014-02-01
Buffalo,Bowling Green State,68,74,1,-6,2014-02-02
South Florida,Cincinnati,45,50,1,-5,2014-02-02
Kennesaw State,ETSU,73,86,1,-13,2014-02-02
Michigan,Indiana,52,63,1,-11,2014-02-02
William & Mary,James Madison,81,79,0,2,2014-02-02
Oakland,Milwaukee,64,86,1,-22,2014-02-02
UCLA,Oregon State,67,71,1,-4,2014-02-02
Purdue,Penn State,68,79,1,-11,2014-02-02
Virginia,Pitt,48,45,0,3,2014-02-02
Bryant,Sacred Heart,76,67,0,9,2014-02-02
Mercer,USC Upstate,61,80,1,-19,2014-02-02
Prairie View,Alabama A&M,55,67,1,-12,2014-02-03
Texas Southern,Alabama State,73,79,1,-6,2014-02-03
Jackson State,Arkansas-Pine Bluff,69,70,1,-1,2014-02-03
South Carolina State,Bethune-Cookman,59,91,1,-32,2014-02-03
Delaware State,Coppin State,53,54,1,-1,2014-02-03
Northeastern,Delaware,67,80,1,-13,2014-02-03
Georgetown,DePaul,71,59,0,12,2014-02-03
UNC Wilmington,Drexel,50,61,1,-11,2014-02-03
Savannah State,Florida A&M,51,54,1,-3,2014-02-03
Samford,Furman,76,68,0,8,2014-02-03
South Alabama,Georgia State,65,85,1,-20,2014-02-03
North Carolina A&T,Howard,60,68,1,-8,2014-02-03
North Carolina Central,Maryland-Eastern Shore,66,62,0,4,2014-02-03
NJIT,UMass-Lowell,64,73,1,-9,2014-02-03
Grambling,Mississippi Valley State,67,75,1,-8,2014-02-03
Montana,Montana State,70,66,0,4,2014-02-03
Hampton,Morgan State,92,94,1,-2,2014-02-03
Iowa State,Oklahoma State,98,97,0,1,2014-02-03
Fairfield,Rider,65,73,1,-8,2014-02-03
Notre Dame,Syracuse,55,61,1,-6,2014-02-03
Xavier,Villanova,58,81,1,-23,2014-02-03
Kansas,Baylor,69,52,0,17,2014-02-04
Stony Brook,Binghamton,58,53,0,5,2014-02-04
Georgia Tech,Clemson,41,45,1,-4,2014-02-04
Holy Cross,Colgate,69,68,0,1,2014-02-04
Southern Illinois,Drake,74,58,0,16,2014-02-04
Wake Forest,Duke,63,83,1,-20,2014-02-04
Chattanooga,Eastern Kentucky,63,74,1,-11,2014-02-04
Missouri,Florida,58,68,1,-10,2014-02-04
Wisconsin,Illinois,75,63,0,12,2014-02-04
Ohio State,Iowa,76,69,0,7,2014-02-04
Ole Miss,Kentucky,64,80,1,-16,2014-02-04
Winthrop,Liberty,73,62,0,11,2014-02-04
St. Peter's,Manhattan,49,64,1,-15,2014-02-04
Butler,Marquette,62,69,1,-7,2014-02-04
Rutgers,Memphis,69,101,1,-32,2014-02-04
Iona,Monmouth,89,71,0,18,2014-02-04
Maryland,UNC,63,75,1,-12,2014-02-04
Miami (OH),Northern Illinois,41,53,1,-12,2014-02-04
St. John's (NY),Providence,86,76,0,10,2014-02-04
Peru State,South Dakota,40,80,1,-40,2014-02-04
Texas,TCU,59,54,0,5,2014-02-04
James Madison,Towson,71,80,1,-9,2014-02-04
Maine,Vermont,65,93,1,-28,2014-02-04
Fresno State,Air Force,68,51,0,17,2014-02-05
Eastern Michigan,Akron,48,52,1,-4,2014-02-05
UMass-Lowell,Albany (NY),56,73,1,-17,2014-02-05
Alabama,Arkansas,58,65,1,-7,2014-02-05
Lehigh,Army,51,70,1,-19,2014-02-05
San Diego State,Boise State,67,65,0,2,2014-02-05
Lafayette,Bucknell,66,58,0,8,2014-02-05
Ball State,Buffalo,48,69,1,-21,2014-02-05
Stanford,California,80,69,0,11,2014-02-05
South Florida,UCF,79,78,0,1,2014-02-05
Kent State,Central Michigan,73,78,1,-5,2014-02-05
Radford,Charleston Southern,82,76,0,6,2014-02-05
High Point,Coastal Carolina,77,74,0,3,2014-02-05
Washington State,Colorado,63,68,1,-5,2014-02-05
UNLV,Colorado State,57,75,1,-18,2014-02-05
College of Charleston,Delaware,64,67,1,-3,2014-02-05
Missouri State,Evansville,66,54,0,12,2014-02-05
Virginia Tech,Florida State,50,70,1,-20,2014-02-05
VMI,Gardner-Webb,108,104,0,4,2014-02-05
Dayton,George Mason,84,67,0,17,2014-02-05
Duquesne,George Washington,57,71,1,-14,2014-02-05
Portland,Gonzaga,66,71,1,-5,2014-02-05
UIC,Green Bay,70,81,1,-11,2014-02-05
Louisville,Houston,77,62,0,15,2014-02-05
Northern Iowa,Illinois State,65,76,1,-11,2014-02-05
Wichita State,Indiana State,65,58,0,7,2014-02-05
American,Loyola (MD),58,62,1,-4,2014-02-05
New Hampshire,UMBC,57,68,1,-11,2014-02-05
La Salle,UMass,67,79,1,-12,2014-02-05
Pitt,Miami (FL),59,55,0,4,2014-02-05
Nebraska,Michigan,50,79,1,-29,2014-02-05
Boston University,Navy,61,48,0,13,2014-02-05
Peru State,Omaha,62,86,1,-24,2014-02-05
Wyoming,New Mexico,61,66,1,-5,2014-02-05
Campbell,UNC Asheville,73,86,1,-13,2014-02-05
William & Mary,UNC Wilmington,54,50,0,4,2014-02-05
Hofstra,Northeastern,73,81,1,-8,2014-02-05
Longwood,Presbyterian,62,77,1,-15,2014-02-05
Minnesota,Purdue,74,77,1,-3,2014-02-05
St. Bonaventure,Richmond,62,64,1,-2,2014-02-05
Saint Louis,St. Joseph's,65,49,0,16,2014-02-05
Auburn,South Carolina,79,74,0,5,2014-02-05
Mississippi State,Texas A&M,52,72,1,-20,2014-02-05
Bowling Green State,Toledo,76,83,1,-7,2014-02-05
Nevada,Utah State,75,83,1,-8,2014-02-05
Tennessee,Vanderbilt,60,64,1,-4,2014-02-05
Boston College,Virginia,67,77,1,-10,2014-02-05
Oklahoma,West Virginia,86,91,1,-5,2014-02-05
Ohio,Western Michigan,74,90,1,-16,2014-02-05
Youngstown State,Wright State,67,77,1,-10,2014-02-05
Houston Baptist,Abilene Christian,81,87,1,-6,2014-02-06
Citadel,Appalachian State,45,54,1,-9,2014-02-06
Oregon,Arizona,65,67,1,-2,2014-02-06
Oregon State,Arizona State,82,86,1,-4,2014-02-06
Georgia State,Little Rock,68,57,0,11,2014-02-06
Murray State,Belmont,96,99,1,-3,2014-02-06
Santa Clara,BYU,76,89,1,-13,2014-02-06
Cal State Northridge,UC-Davis,86,90,1,-4,2014-02-06
Long Beach State,UC-Irvine,58,61,1,-3,2014-02-06
Cal State Fullerton,UC-Riverside,69,72,1,-3,2014-02-06
Southeastern Louisiana,Central Arkansas,71,85,1,-14,2014-02-06
Bryant,Central Connecticut,79,68,0,11,2014-02-06
UConn,Cincinnati,58,63,1,-5,2014-02-06
UTEP,East Carolina,58,47,0,11,2014-02-06
UT-Martin,Eastern Illinois,79,91,1,-12,2014-02-06
UNC Greensboro,Elon,66,72,1,-6,2014-02-06
Middle Tennessee,Florida Atlantic,67,63,0,4,2014-02-06
Jacksonville,Florida Gulf Coast,71,100,1,-29,2014-02-06
Alabama-Birmingham,Florida International,73,78,1,-5,2014-02-06
LSU,Georgia,78,91,1,-13,2014-02-06
Utah Valley,Grand Canyon,79,68,0,11,2014-02-06
UCSB,Hawaii,75,64,0,11,2014-02-06
New Mexico State,Idaho,67,73,1,-6,2014-02-06
Northern Colorado,Idaho State,70,73,1,-3,2014-02-06
Texas A&M-Corpus Christi,Incarnate Word,78,82,1,-4,2014-02-06
USC Upstate,Lipscomb,75,77,1,-2,2014-02-06
Robert Morris,LIU-Brooklyn,65,56,0,9,2014-02-06
Tulsa,Louisiana Tech,61,66,1,-5,2014-02-06
Bradley,Loyola (IL),63,54,0,9,2014-02-06
Saint Mary's,Loyola Marymount,77,58,0,19,2014-02-06
Penn State,Michigan State,67,82,1,-15,2014-02-06
Portland State,Montana,76,82,1,-6,2014-02-06
Eastern Washington,Montana State,79,50,0,29,2014-02-06
Wheelock,NJIT,46,110,1,-64,2014-02-06
IUPUI,North Dakota State,60,66,1,-6,2014-02-06
ETSU,Northern Kentucky,64,50,0,14,2014-02-06
McNeese State,Northwestern State,74,85,1,-11,2014-02-06
Cleveland State,Oakland,92,85,0,7,2014-02-06
UTSA,Old Dominion,61,69,1,-8,2014-02-06
New Orleans,Oral Roberts,59,79,1,-20,2014-02-06
Pacific,Pepperdine,69,80,1,-11,2014-02-06
North Texas,Rice,70,75,1,-5,2014-02-06
Marist,Rider,68,61,0,7,2014-02-06
Northern Arizona,Sacramento State,70,87,1,-17,2014-02-06
Mount St. Mary's,Sacred Heart,73,60,0,13,2014-02-06
Davidson,Samford,109,88,0,21,2014-02-06
San Francisco,San Diego,74,67,0,7,2014-02-06
Texas-Rio Grande Valley,Seattle,62,83,1,-21,2014-02-06
Purdue-Fort Wayne,South Dakota State,51,79,1,-28,2014-02-06
Southeast Missouri State,SIU-Edwardsville,88,93,1,-5,2014-02-06
Temple,SMU,52,75,1,-23,2014-02-06
Saint Francis (PA),St. Francis (NY),52,78,1,-26,2014-02-06
Nicholls State,Stephen F. Austin,64,93,1,-29,2014-02-06
North Florida,Stetson,54,52,0,2,2014-02-06
Austin Peay,Tennessee State,75,65,0,10,2014-02-06
Louisiana,Texas-Arlington,92,89,0,3,2014-02-06
Louisiana-Monroe,Texas State,57,65,1,-8,2014-02-06
South Alabama,Troy,74,79,1,-5,2014-02-06
Washington,Utah,69,78,1,-9,2014-02-06
Rhode Island,VCU,52,68,1,-16,2014-02-06
Fairleigh Dickinson,Wagner,68,75,1,-7,2014-02-06
North Dakota,Weber State,72,84,1,-12,2014-02-06
Barber-Scotia,Winthrop,62,92,1,-30,2014-02-06
Georgia Southern,Wofford,61,74,1,-13,2014-02-06
Manhattan,Canisius,84,73,0,11,2014-02-07
DePaul,Creighton,66,78,1,-12,2014-02-07
Yale,Dartmouth,67,54,0,13,2014-02-07
Monmouth,Fairfield,56,60,1,-4,2014-02-07
Brown,Harvard,45,52,1,-7,2014-02-07
Mercer,Kennesaw State,75,68,0,7,2014-02-07
Iona,Niagara,90,89,0,1,2014-02-07
Cornell,Penn,83,90,1,-7,2014-02-07
Columbia,Princeton,53,52,0,1,2014-02-07
Siena,St. Peter's,53,66,1,-13,2014-02-07
Marshall,Southern Miss,57,60,1,-3,2014-02-07
Charlotte,Tulane,63,64,1,-1,2014-02-07
Detroit,Valparaiso,59,57,0,2,2014-02-07
Seton Hall,Villanova,53,70,1,-17,2014-02-07
Texas A&M-Corpus Christi,Abilene Christian,71,69,0,2,2014-02-08
Colorado State,Air Force,68,56,0,12,2014-02-08
Colgate,American,63,60,0,3,2014-02-08
Oregon,Arizona State,72,74,1,-2,2014-02-08
Western Kentucky,Little Rock,79,78,0,1,2014-02-08
Alabama A&M,Arkansas-Pine Bluff,61,64,1,-3,2014-02-08
Navy,Army,79,57,0,22,2014-02-08
Toledo,Ball State,80,73,0,7,2014-02-08
Austin Peay,Belmont,68,93,1,-25,2014-02-08
Maine,Binghamton,58,73,1,-15,2014-02-08
Duke,Boston College,89,68,0,21,2014-02-08
Lafayette,Boston University,54,88,1,-34,2014-02-08
San Francisco,BYU,63,68,1,-5,2014-02-08
Mount St. Mary's,Bryant,75,78,1,-3,2014-02-08
Cal State Fullerton,Cal State Northridge,83,92,1,-9,2014-02-08
UC-Irvine,UC-Davis,61,59,0,2,2014-02-08
Long Beach State,UC-Riverside,88,76,0,12,2014-02-08
New Orleans,Central Arkansas,88,79,0,9,2014-02-08
Fairleigh Dickinson,Central Connecticut,86,91,1,-5,2014-02-08
Buffalo,Central Michigan,79,70,0,9,2014-02-08
UMKC,Chicago State,74,81,1,-7,2014-02-08
Wofford,Citadel,77,56,0,21,2014-02-08
Longwood,Coastal Carolina,58,67,1,-9,2014-02-08
Brown,Dartmouth,75,62,0,13,2014-02-08
Furman,Davidson,50,65,1,-15,2014-02-08
South Carolina State,Delaware State,53,61,1,-8,2014-02-08
South Dakota,Denver,67,75,1,-8,2014-02-08
James Madison,Drexel,60,78,1,-18,2014-02-08
George Mason,Duquesne,74,68,0,6,2014-02-08
UTSA,East Carolina,71,81,1,-10,2014-02-08
Southeast Missouri State,Eastern Illinois,74,68,0,6,2014-02-08
Morehead State,Eastern Kentucky,86,79,0,7,2014-02-08
Kent State,Eastern Michigan,53,70,1,-17,2014-02-08
Georgia Southern,Elon,59,60,1,-1,2014-02-08
Alabama,Florida,69,78,1,-9,2014-02-08
Alabama-Birmingham,Florida Atlantic,71,82,1,-11,2014-02-08
North Florida,Florida Gulf Coast,46,73,1,-27,2014-02-08
Middle Tennessee,Florida International,70,68,0,2,2014-02-08
San Jose State,Fresno State,56,82,1,-26,2014-02-08
High Point,Gardner-Webb,76,80,1,-4,2014-02-08
Fordham,George Washington,67,93,1,-26,2014-02-08
Butler,Georgetown,63,71,1,-8,2014-02-08
Texas A&M,Georgia,50,62,1,-12,2014-02-08
Virginia,Georgia Tech,64,45,0,19,2014-02-08
Southern,Grambling,104,54,0,50,2014-02-08
Cal State Bakersfield,Grand Canyon,70,79,1,-9,2014-02-08
Milwaukee,Green Bay,73,63,0,10,2014-02-08
Howard,Hampton,47,63,1,-16,2014-02-08
Albany (NY),Hartford,54,67,1,-13,2014-02-08
Yale,Harvard,74,67,0,7,2014-02-08
Cal Poly,Hawaii,60,69,1,-9,2014-02-08
UNC Wilmington,Hofstra,52,61,1,-9,2014-02-08
Texas-Rio Grande Valley,Idaho,63,70,1,-7,2014-02-08
North Dakota,Idaho State,80,75,0,5,2014-02-08
Houston Baptist,Incarnate Word,82,89,1,-7,2014-02-08
Michigan,Iowa,67,85,1,-18,2014-02-08
TCU,Iowa State,69,84,1,-15,2014-02-08
Alcorn State,Jackson State,61,71,1,-10,2014-02-08
Tennessee Tech,Jacksonville State,72,60,0,12,2014-02-08
West Virginia,Kansas,69,83,1,-14,2014-02-08
Texas,Kansas State,57,74,1,-17,2014-02-08
Saint Louis,La Salle,65,63,0,2,2014-02-08
Loyola (MD),Lehigh,52,66,1,-14,2014-02-08
ETSU,Lipscomb,96,88,0,8,2014-02-08
Saint Francis (PA),LIU-Brooklyn,74,58,0,16,2014-02-08
Auburn,LSU,80,87,1,-7,2014-02-08
North Texas,Louisiana Tech,75,90,1,-15,2014-02-08
Pacific,Loyola Marymount,82,72,0,10,2014-02-08
Florida State,Maryland,71,83,1,-12,2014-02-08
UMass-Lowell,UMBC,71,61,0,10,2014-02-08
Coppin State,Maryland-Eastern Shore,58,50,0,8,2014-02-08
Gonzaga,Memphis,54,60,1,-6,2014-02-08
NC State,Miami (FL),56,55,0,1,2014-02-08
Indiana,Minnesota,60,66,1,-6,2014-02-08
Missouri,Ole Miss,88,91,1,-3,2014-02-08
Kentucky,Mississippi State,69,59,0,10,2014-02-08
Alabama State,Mississippi Valley State,75,70,0,5,2014-02-08
Eastern Washington,Montana,77,82,1,-5,2014-02-08
Portland State,Montana State,64,69,1,-5,2014-02-08
Norfolk State,Morgan State,64,53,0,11,2014-02-08
Western Illinois,Omaha,60,71,1,-11,2014-02-08
Wyoming,UNLV,46,48,1,-2,2014-02-08
Liberty,UNC Asheville,72,75,1,-3,2014-02-08
Florida A&M,North Carolina A&T,78,84,1,-6,2014-02-08
Bethune-Cookman,North Carolina Central,54,77,1,-23,2014-02-08
Purdue-Fort Wayne,North Dakota State,58,69,1,-11,2014-02-08
William & Mary,Northeastern,82,70,0,12,2014-02-08
Southern Utah,Northern Arizona,57,64,1,-7,2014-02-08
Wichita State,Northern Iowa,82,73,0,9,2014-02-08
USC Upstate,Northern Kentucky,76,59,0,17,2014-02-08
Nebraska,Northwestern,53,49,0,4,2014-02-08
Nicholls State,Northwestern State,73,86,1,-13,2014-02-08
UNC,Notre Dame,73,62,0,11,2014-02-08
Miami (OH),Ohio,75,82,1,-7,2014-02-08
Purdue,Ohio State,49,67,1,-18,2014-02-08
Baylor,Oklahoma,72,88,1,-16,2014-02-08
UTEP,Old Dominion,63,49,0,14,2014-02-08
Southeastern Louisiana,Oral Roberts,54,71,1,-17,2014-02-08
Columbia,Penn,60,68,1,-8,2014-02-08
Saint Mary's,Pepperdine,69,67,0,2,2014-02-08
Virginia Tech,Pitt,57,62,1,-5,2014-02-08
Texas Southern,Prairie View,77,85,1,-8,2014-02-08
Radford,Presbyterian,83,66,0,17,2014-02-08
Cornell,Princeton,48,69,1,-21,2014-02-08
Rider,Quinnipiac,61,82,1,-21,2014-02-08
Tulsa,Rice,66,56,0,10,2014-02-08
Wagner,Sacred Heart,62,55,0,7,2014-02-08
VCU,St. Joseph's,62,69,1,-7,2014-02-08
Lamar,Sam Houston State,70,84,1,-14,2014-02-08
Chattanooga,Samford,85,92,1,-7,2014-02-08
Santa Clara,San Diego,69,63,0,6,2014-02-08
Nevada,San Diego State,58,73,1,-15,2014-02-08
New Mexico State,Seattle,92,77,0,15,2014-02-08
IUPUI,South Dakota State,59,83,1,-24,2014-02-08
Rutgers,South Florida,79,69,0,10,2014-02-08
UCLA,USC,83,73,0,10,2014-02-08
Missouri State,Southern Illinois,54,72,1,-18,2014-02-08
UT-Martin,SIU-Edwardsville,78,84,1,-6,2014-02-08
Cincinnati,SMU,55,76,1,-21,2014-02-08
Dayton,St. Bonaventure,72,69,0,3,2014-02-08
Robert Morris,St. Francis (NY),72,50,0,22,2014-02-08
McNeese State,Stephen F. Austin,54,74,1,-20,2014-02-08
Jacksonville,Stetson,68,73,1,-5,2014-02-08
New Hampshire,Stony Brook,73,69,0,4,2014-02-08
South Carolina,Tennessee,53,72,1,-19,2014-02-08
Murray State,Tennessee State,73,65,0,8,2014-02-08
Louisiana,Texas State,67,66,0,1,2014-02-08
Oklahoma State,Texas Tech,61,65,1,-4,2014-02-08
College of Charleston,Towson,61,68,1,-7,2014-02-08
Washington State,Utah,63,81,1,-18,2014-02-08
Boise State,Utah State,70,76,1,-6,2014-02-08
Arkansas,Vanderbilt,77,75,0,2,2014-02-08
Charleston Southern,VMI,84,92,1,-8,2014-02-08
Northern Colorado,Weber State,65,79,1,-14,2014-02-08
Appalachian State,Western Carolina,75,84,1,-9,2014-02-08
Campbell,Winthrop,62,88,1,-26,2014-02-08
Cleveland State,Wright State,72,68,0,4,2014-02-08
Providence,Xavier,53,59,1,-6,2014-02-08
Oregon State,Arizona,54,76,1,-22,2014-02-09
Akron,Bowling Green State,65,63,0,2,2014-02-09
Evansville,Bradley,66,83,1,-17,2014-02-09
Iona,Canisius,101,91,0,10,2014-02-09
UConn,UCF,75,55,0,20,2014-02-09
Washington,Colorado,65,91,1,-26,2014-02-09
Youngstown State,Detroit,81,83,1,-2,2014-02-09
Bucknell,Holy Cross,50,66,1,-16,2014-02-09
Temple,Houston,74,88,1,-14,2014-02-09
Drake,Indiana State,56,60,1,-4,2014-02-09
Illinois State,Loyola (IL),69,79,1,-10,2014-02-09
Manhattan,Niagara,78,77,0,1,2014-02-09
Western Michigan,Northern Illinois,74,71,0,3,2014-02-09
Illinois,Penn State,60,55,0,5,2014-02-09
UMass,Rhode Island,73,68,0,5,2014-02-09
Monmouth,St. Peter's,50,61,1,-11,2014-02-09
Charlotte,Southern Miss,64,81,1,-17,2014-02-09
Creighton,St. John's (NY),65,70,1,-5,2014-02-09
Clemson,Syracuse,44,57,1,-13,2014-02-09
Marshall,Tulane,65,68,1,-3,2014-02-09
Oakland,Valparaiso,60,63,1,-3,2014-02-09
Michigan State,Wisconsin,58,60,1,-2,2014-02-09
Alabama State,Arkansas-Pine Bluff,71,76,1,-5,2014-02-10
Western Kentucky,Arkansas State,58,72,1,-14,2014-02-10
Morgan State,Coppin State,82,77,0,5,2014-02-10
Savannah State,Delaware State,59,79,1,-20,2014-02-10
USC Upstate,ETSU,75,63,0,12,2014-02-10
Miami (FL),Florida State,77,73,0,4,2014-02-10
Providence,Georgetown,71,83,1,-12,2014-02-10
Alcorn State,Grambling,80,95,1,-15,2014-02-10
Maryland-Eastern Shore,Hampton,65,71,1,-6,2014-02-10
Southern,Jackson State,68,63,0,5,2014-02-10
Hofstra,James Madison,53,59,1,-6,2014-02-10
Kansas,Kansas State,82,85,1,-3,2014-02-10
Alabama A&M,Mississippi Valley State,91,82,0,9,2014-02-10
Howard,Norfolk State,49,75,1,-26,2014-02-10
Bethune-Cookman,North Carolina A&T,72,71,0,1,2014-02-10
Florida A&M,North Carolina Central,49,92,1,-43,2014-02-10
Towson,UNC Wilmington,53,66,1,-13,2014-02-10
Marist,Quinnipiac,78,83,1,-5,2014-02-10
Southern Utah,Sacramento State,56,68,1,-12,2014-02-10
Fairfield,Siena,75,77,1,-2,2014-02-10
Maryland,Virginia,53,61,1,-8,2014-02-10
Iowa State,West Virginia,77,102,1,-25,2014-02-10
Furman,Western Carolina,75,83,1,-8,2014-02-10
Hiwassee,Wofford,60,95,1,-35,2014-02-10
Ole Miss,Alabama,64,67,1,-3,2014-02-11
Xavier,Butler,64,50,0,14,2014-02-11
Utah State,Colorado State,71,62,0,9,2014-02-11
Gardner-Webb,Liberty,68,52,0,16,2014-02-11
Wake Forest,NC State,67,82,1,-15,2014-02-11
Clemson,Notre Dame,64,68,1,-4,2014-02-11
Michigan,Ohio State,70,60,0,10,2014-02-11
Marquette,Seton Hall,77,66,0,11,2014-02-11
Florida,Tennessee,67,58,0,9,2014-02-11
Oklahoma State,Texas,68,87,1,-19,2014-02-11
Southern Illinois,Wichita State,67,78,1,-11,2014-02-11
San Diego State,Wyoming,62,68,1,-6,2014-02-11
Lehigh,American,44,64,1,-20,2014-02-12
Kentucky,Auburn,64,56,0,8,2014-02-12
Eastern Michigan,Ball State,73,62,0,11,2014-02-12
New Mexico,Boise State,70,71,1,-1,2014-02-12
Indiana State,Bradley,68,62,0,6,2014-02-12
Navy,Bucknell,57,78,1,-21,2014-02-12
Presbyterian,Campbell,66,77,1,-11,2014-02-12
Boston University,Colgate,76,74,0,2,2014-02-12
South Florida,UConn,40,83,1,-43,2014-02-12
Rhode Island,Dayton,69,76,1,-7,2014-02-12
James Madison,Delaware,65,81,1,-16,2014-02-12
Villanova,DePaul,87,62,0,25,2014-02-12
Richmond,Duquesne,75,58,0,17,2014-02-12
Illinois State,Evansville,98,104,1,-6,2014-02-12
St. Bonaventure,Fordham,76,65,0,11,2014-02-12
Army,Holy Cross,63,66,1,-3,2014-02-12
Penn State,Indiana,66,65,0,1,2014-02-12
St. Peter's,Iona,59,62,1,-3,2014-02-12
Bowling Green State,Kent State,61,62,1,-1,2014-02-12
Loyola (MD),Lafayette,44,61,1,-17,2014-02-12
Winthrop,Longwood,76,59,0,17,2014-02-12
Hartford,Maine,91,79,0,12,2014-02-12
Albany (NY),UMBC,69,71,1,-2,2014-02-12
George Mason,UMass,91,80,0,11,2014-02-12
UCF,Memphis,70,76,1,-6,2014-02-12
Buffalo,Miami (OH),75,62,0,13,2014-02-12
Georgia,Mississippi State,75,55,0,20,2014-02-12
Drake,Missouri State,63,69,1,-6,2014-02-12
Illinois,Nebraska,58,67,1,-9,2014-02-12
Fresno State,Nevada,75,67,0,8,2014-02-12
Binghamton,New Hampshire,72,71,0,1,2014-02-12
Maine-Fort Kent,NJIT,45,84,1,-39,2014-02-12
Central Michigan,Northern Illinois,63,88,1,-25,2014-02-12
Loyola (IL),Northern Iowa,58,80,1,-22,2014-02-12
Texas Tech,Oklahoma,68,60,0,8,2014-02-12
Syracuse,Pitt,58,56,0,2,2014-02-12
Air Force,San Jose State,51,48,0,3,2014-02-12
UT-Martin,Southeast Missouri State,79,70,0,9,2014-02-12
LSU,Texas A&M,73,83,1,-10,2014-02-12
Baylor,TCU,91,58,0,33,2014-02-12
Ohio,Toledo,76,82,1,-6,2014-02-12
UMass-Lowell,Vermont,58,83,1,-25,2014-02-12
George Washington,VCU,75,92,1,-17,2014-02-12
Coastal Carolina,VMI,83,78,0,5,2014-02-12
Stanford,Washington,60,64,1,-4,2014-02-12
California,Washington State,80,76,0,4,2014-02-12
Akron,Western Michigan,54,57,1,-3,2014-02-12
Southern Miss,Alabama-Birmingham,60,84,1,-24,2014-02-13
Samford,Appalachian State,68,74,1,-6,2014-02-13
Eastern Illinois,Austin Peay,83,88,1,-5,2014-02-13
Tennessee State,Belmont,71,73,1,-2,2014-02-13
Creighton,Butler,68,63,0,5,2014-02-13
Idaho,Cal State Bakersfield,67,76,1,-9,2014-02-13
UC-Davis,Cal State Fullerton,64,74,1,-10,2014-02-13
Cal Poly,Cal State Northridge,62,55,0,7,2014-02-13
Hawaii,UC-Riverside,87,76,0,11,2014-02-13
UIC,Cleveland State,53,73,1,-20,2014-02-13
Drexel,College of Charleston,46,47,1,-1,2014-02-13
Florida Gulf Coast,ETSU,81,89,1,-8,2014-02-13
Sacramento State,Eastern Washington,72,85,1,-13,2014-02-13
Quinnipiac,Fairfield,80,72,0,8,2014-02-13
UNC Greensboro,Georgia Southern,68,56,0,12,2014-02-13
Boston College,Georgia Tech,71,74,1,-3,2014-02-13
Pepperdine,Gonzaga,68,83,1,-15,2014-02-13
Oral Roberts,Houston Baptist,80,66,0,14,2014-02-13
Abilene Christian,Incarnate Word,68,80,1,-12,2014-02-13
South Dakota,Purdue-Fort Wayne,69,75,1,-6,2014-02-13
Denver,IUPUI,49,59,1,-10,2014-02-13
Morehead State,Jacksonville State,69,67,0,2,2014-02-13
Stephen F. Austin,Lamar,78,69,0,9,2014-02-13
UCSB,Long Beach State,65,64,0,1,2014-02-13
Little Rock,Louisiana,87,93,1,-6,2014-02-13
Texas-Arlington,Louisiana-Monroe,85,74,0,11,2014-02-13
Northwestern,Michigan State,70,85,1,-15,2014-02-13
Tulane,Middle Tennessee,44,71,1,-27,2014-02-13
Arkansas,Missouri,85,86,1,-1,2014-02-13
SIU-Edwardsville,Murray State,72,82,1,-10,2014-02-13
South Dakota State,Omaha,77,60,0,17,2014-02-13
UMKC,New Mexico State,48,71,1,-23,2014-02-13
Nicholls State,New Orleans,64,70,1,-6,2014-02-13
Northeastern,UNC Wilmington,45,55,1,-10,2014-02-13
Montana State,North Dakota,78,70,0,8,2014-02-13
Old Dominion,North Texas,72,62,0,10,2014-02-13
Montana,Northern Colorado,86,89,1,-3,2014-02-13
BYU,Pacific,82,89,1,-7,2014-02-13
Loyola Marymount,Portland,64,71,1,-7,2014-02-13
Northern Arizona,Portland State,65,63,0,2,2014-02-13
UNC Asheville,Radford,92,102,1,-10,2014-02-13
Manhattan,Rider,86,69,0,17,2014-02-13
Robert Morris,Saint Francis (PA),66,60,0,6,2014-02-13
San Diego,Saint Mary's,57,69,1,-12,2014-02-13
Northwestern State,Sam Houston State,64,67,1,-3,2014-02-13
St. John's (NY),Seton Hall,68,67,0,1,2014-02-13
Arkansas State,South Alabama,85,61,0,24,2014-02-13
Vanderbilt,South Carolina,59,65,1,-6,2014-02-13
McNeese State,Southeastern Louisiana,53,62,1,-9,2014-02-13
Utah,USC,79,71,0,8,2014-02-13
Weber State,Southern Utah,75,55,0,20,2014-02-13
Eastern Kentucky,Tennessee Tech,66,72,1,-6,2014-02-13
Central Arkansas,Texas A&M-Corpus Christi,73,84,1,-11,2014-02-13
Florida Atlantic,UTEP,71,69,0,2,2014-02-13
Chicago State,Texas-Rio Grande Valley,68,71,1,-3,2014-02-13
Florida International,UTSA,80,72,0,8,2014-02-13
East Carolina,Tulsa,58,76,1,-18,2014-02-13
Colorado,UCLA,74,92,1,-18,2014-02-13
Seattle,Utah Valley,71,57,0,14,2014-02-13
North Dakota State,Western Illinois,56,52,0,4,2014-02-13
Troy,Western Kentucky,76,81,1,-5,2014-02-13
Minnesota,Wisconsin,70,78,1,-8,2014-02-13
Green Bay,Youngstown State,71,40,0,31,2014-02-13
Arizona,Arizona State,66,69,1,-3,2014-02-14
Princeton,Brown,69,65,0,4,2014-02-14
Western Carolina,Chattanooga,73,83,1,-10,2014-02-14
Harvard,Columbia,88,84,0,4,2014-02-14
Dartmouth,Cornell,67,70,1,-3,2014-02-14
Monmouth,Iona,70,89,1,-19,2014-02-14
North Florida,Jacksonville,79,74,0,5,2014-02-14
Northern Kentucky,Kennesaw State,67,69,1,-2,2014-02-14
Siena,Marist,64,65,1,-1,2014-02-14
Lipscomb,Mercer,48,79,1,-31,2014-02-14
Canisius,Niagara,71,65,0,6,2014-02-14
Detroit,Oakland,82,83,1,-1,2014-02-14
SMU,Rutgers,77,65,0,12,2014-02-14
Louisville,Temple,82,58,0,24,2014-02-14
Penn,Yale,54,69,1,-15,2014-02-14
Dallas Christian,Abilene Christian,69,108,1,-39,2014-02-15
Northern Illinois,Akron,54,62,1,-8,2014-02-15
Alabama State,Alabama A&M,65,68,1,-3,2014-02-15
Tulane,Alabama-Birmingham,86,80,0,6,2014-02-15
Maine,Albany (NY),63,74,1,-11,2014-02-15
Mississippi Valley State,Alcorn State,63,67,1,-4,2014-02-15
Wofford,Appalachian State,64,58,0,6,2014-02-15
LSU,Arkansas,70,81,1,-11,2014-02-15
Mississippi State,Auburn,82,92,1,-10,2014-02-15
SIU-Edwardsville,Austin Peay,83,68,0,15,2014-02-15
Bowling Green State,Ball State,66,64,0,2,2014-02-15
Kansas State,Baylor,73,87,1,-14,2014-02-15
Delaware State,Bethune-Cookman,79,67,0,12,2014-02-15
Penn,Brown,55,62,1,-7,2014-02-15
Army,Bucknell,61,73,1,-12,2014-02-15
Ohio,Buffalo,73,70,0,3,2014-02-15
Seattle,Cal State Bakersfield,65,83,1,-18,2014-02-15
Hawaii,Cal State Fullerton,83,80,0,3,2014-02-15
UC-Riverside,UC-Irvine,52,70,1,-18,2014-02-15
Cal State Northridge,UCSB,80,78,0,2,2014-02-15
Longwood,Campbell,76,53,0,23,2014-02-15
Sacred Heart,Central Connecticut,69,74,1,-5,2014-02-15
Winthrop,Charleston Southern,64,84,1,-20,2014-02-15
Marshall,Charlotte,59,56,0,3,2014-02-15
Houston,Cincinnati,62,73,1,-11,2014-02-15
Virginia,Clemson,63,58,0,5,2014-02-15
Green Bay,Cleveland State,68,54,0,14,2014-02-15
Gardner-Webb,Coastal Carolina,60,75,1,-15,2014-02-15
Northeastern,College of Charleston,60,44,0,16,2014-02-15
Dartmouth,Columbia,59,69,1,-10,2014-02-15
Memphis,UConn,81,86,1,-5,2014-02-15
Harvard,Cornell,67,44,0,23,2014-02-15
Loyola (IL),Drake,62,70,1,-8,2014-02-15
Maryland,Duke,67,69,1,-2,2014-02-15
Stetson,ETSU,66,93,1,-27,2014-02-15
Toledo,Eastern Michigan,44,65,1,-21,2014-02-15
Northern Arizona,Eastern Washington,65,84,1,-19,2014-02-15
Samford,Elon,69,86,1,-17,2014-02-15
Rider,Fairfield,71,62,0,9,2014-02-15
Saint Francis (PA),Fairleigh Dickinson,89,82,0,7,2014-02-15
Coppin State,Florida A&M,71,82,1,-11,2014-02-15
Colorado State,Fresno State,66,75,1,-9,2014-02-15
Citadel,Furman,67,76,1,-9,2014-02-15
St. Bonaventure,George Mason,85,73,0,12,2014-02-15
UMass,George Washington,67,61,0,6,2014-02-15
Ole Miss,Georgia,60,61,1,-1,2014-02-15
Davidson,Georgia Southern,88,73,0,15,2014-02-15
Loyola Marymount,Gonzaga,67,86,1,-19,2014-02-15
New Hampshire,Hartford,59,61,1,-2,2014-02-15
Central Arkansas,Houston Baptist,83,99,1,-16,2014-02-15
Ohio State,Illinois,48,39,0,9,2014-02-15
Bradley,Illinois State,54,70,1,-16,2014-02-15
Southern Illinois,Indiana State,57,60,1,-3,2014-02-15
Texas Tech,Iowa State,64,70,1,-6,2014-02-15
Denver,Purdue-Fort Wayne,73,62,0,11,2014-02-15
South Dakota,IUPUI,71,67,0,4,2014-02-15
Eastern Kentucky,Jacksonville State,86,65,0,21,2014-02-15
UNC Wilmington,James Madison,62,64,1,-2,2014-02-15
TCU,Kansas,65,95,1,-30,2014-02-15
Central Michigan,Kent State,75,83,1,-8,2014-02-15
Florida,Kentucky,69,59,0,10,2014-02-15
St. Joseph's,La Salle,75,64,0,11,2014-02-15
American,Lafayette,62,74,1,-12,2014-02-15
Northwestern State,Lamar,87,67,0,20,2014-02-15
Holy Cross,Lehigh,72,67,0,5,2014-02-15
VMI,Liberty,77,70,0,7,2014-02-15
Cal Poly,Long Beach State,65,74,1,-9,2014-02-15
Arkansas State,Louisiana,67,85,1,-18,2014-02-15
Little Rock,Louisiana-Monroe,49,65,1,-16,2014-02-15
Rice,Louisiana Tech,46,85,1,-39,2014-02-15
Boston University,Loyola (MD),87,72,0,15,2014-02-15
Xavier,Marquette,72,81,1,-9,2014-02-15
Howard,Maryland-Eastern Shore,73,87,1,-14,2014-02-15
Stony Brook,UMass-Lowell,78,68,0,10,2014-02-15
Southern Miss,Middle Tennessee,64,81,1,-17,2014-02-15
Valparaiso,Milwaukee,77,62,0,15,2014-02-15
Tennessee,Missouri,70,75,1,-5,2014-02-15
Northern Iowa,Missouri State,60,58,0,2,2014-02-15
Eastern Illinois,Murray State,60,72,1,-12,2014-02-15
Colgate,Navy,61,71,1,-10,2014-02-15
North Dakota State,Omaha,75,59,0,16,2014-02-15
Nevada,New Mexico,72,90,1,-18,2014-02-15
Chicago State,New Mexico State,55,84,1,-29,2014-02-15
Hampton,Norfolk State,79,73,0,6,2014-02-15
Pitt,UNC,71,75,1,-4,2014-02-15
Montana,North Dakota,69,74,1,-5,2014-02-15
East Carolina,North Texas,51,53,1,-2,2014-02-15
Montana State,Northern Colorado,73,83,1,-10,2014-02-15
Oklahoma,Oklahoma State,77,74,0,3,2014-02-15
San Diego,Pacific,70,55,0,15,2014-02-15
Iowa,Penn State,82,70,0,12,2014-02-15
Pepperdine,Portland,62,74,1,-12,2014-02-15
Sacramento State,Portland State,72,65,0,7,2014-02-15
Jackson State,Prairie View,50,53,1,-3,2014-02-15
UNC Asheville,Presbyterian,71,72,1,-1,2014-02-15
DePaul,Providence,61,84,1,-23,2014-02-15
Indiana,Purdue,64,82,1,-18,2014-02-15
High Point,Radford,72,65,0,7,2014-02-15
Duquesne,Rhode Island,83,71,0,12,2014-02-15
Fordham,Richmond,70,82,1,-12,2014-02-15
Mount St. Mary's,Robert Morris,61,69,1,-8,2014-02-15
VCU,Saint Louis,62,64,1,-2,2014-02-15
BYU,Saint Mary's,60,57,0,3,2014-02-15
Stephen F. Austin,Sam Houston State,67,60,0,7,2014-02-15
Air Force,San Diego State,56,64,1,-8,2014-02-15
Wyoming,San Jose State,46,38,0,8,2014-02-15
San Francisco,Santa Clara,69,63,0,6,2014-02-15
North Carolina A&T,Savannah State,48,73,1,-25,2014-02-15
Alabama,South Carolina,66,67,1,-1,2014-02-15
North Carolina Central,South Carolina State,67,53,0,14,2014-02-15
Florida Gulf Coast,USC Upstate,84,80,0,4,2014-02-15
UCF,South Florida,75,74,0,1,2014-02-15
Nicholls State,Southeastern Louisiana,66,71,1,-5,2014-02-15
Arkansas-Pine Bluff,Southern,64,58,0,6,2014-02-15
Idaho State,Southern Utah,75,65,0,10,2014-02-15
NC State,Syracuse,55,56,1,-1,2014-02-15
Morehead State,Tennessee Tech,79,53,0,26,2014-02-15
West Virginia,Texas,71,88,1,-17,2014-02-15
Oral Roberts,Texas A&M-Corpus Christi,72,74,1,-2,2014-02-15
Texas State,Texas-Arlington,62,69,1,-7,2014-02-15
Florida International,UTEP,71,84,1,-13,2014-02-15
UMKC,Texas-Rio Grande Valley,59,68,1,-9,2014-02-15
Florida Atlantic,UTSA,56,66,1,-10,2014-02-15
Grambling,Texas Southern,71,74,1,-3,2014-02-15
Georgia State,Troy,81,85,1,-4,2014-02-15
Old Dominion,Tulsa,37,76,1,-39,2014-02-15
Utah,UCLA,66,80,1,-14,2014-02-15
UNLV,Utah State,73,62,0,11,2014-02-15
Idaho,Utah Valley,88,89,1,-1,2014-02-15
Texas A&M,Vanderbilt,54,57,1,-3,2014-02-15
UMBC,Vermont,52,76,1,-24,2014-02-15
Miami (FL),Virginia Tech,45,52,1,-7,2014-02-15
Florida State,Wake Forest,67,60,0,7,2014-02-15
California,Washington,72,59,0,13,2014-02-15
Stanford,Washington State,69,56,0,13,2014-02-15
South Dakota State,Western Illinois,62,50,0,12,2014-02-15
South Alabama,Western Kentucky,69,62,0,7,2014-02-15
Miami (OH),Western Michigan,57,68,1,-11,2014-02-15
Towson,William & Mary,85,70,0,15,2014-02-15
Princeton,Yale,65,66,1,-1,2014-02-15
UIC,Youngstown State,56,59,1,-3,2014-02-15
Notre Dame,Boston College,73,69,0,4,2014-02-16
Villanova,Creighton,80,101,1,-21,2014-02-16
Hofstra,Drexel,63,74,1,-11,2014-02-16
Wichita State,Evansville,84,68,0,16,2014-02-16
Lipscomb,Kennesaw State,76,73,0,3,2014-02-16
St. Francis (NY),LIU-Brooklyn,68,69,1,-1,2014-02-16
Rutgers,Louisville,54,102,1,-48,2014-02-16
Niagara,Manhattan,72,90,1,-18,2014-02-16
Northern Kentucky,Mercer,67,89,1,-22,2014-02-16
Wisconsin,Michigan,75,62,0,13,2014-02-16
Nebraska,Michigan State,60,51,0,9,2014-02-16
Marist,Monmouth,96,92,0,4,2014-02-16
McNeese State,New Orleans,72,69,0,3,2014-02-16
Western Carolina,UNC Greensboro,82,77,0,5,2014-02-16
Minnesota,Northwestern,54,48,0,6,2014-02-16
Wright State,Oakland,72,71,0,1,2014-02-16
Oregon State,Oregon,83,93,1,-10,2014-02-16
St. Peter's,Quinnipiac,64,74,1,-10,2014-02-16
Canisius,Siena,92,88,0,4,2014-02-16
Colorado,USC,83,74,0,9,2014-02-16
Georgetown,St. John's (NY),60,82,1,-22,2014-02-16
SMU,Temple,64,71,1,-7,2014-02-16
Bryant,Wagner,61,73,1,-12,2014-02-16
Arkansas-Pine Bluff,Alcorn State,54,57,1,-3,2014-02-17
Oklahoma State,Baylor,64,70,1,-6,2014-02-17
Davidson,Citadel,83,76,0,7,2014-02-17
Delaware State,Florida A&M,63,68,1,-5,2014-02-17
UNC,Florida State,81,75,0,6,2014-02-17
Texas State,Georgia State,41,68,1,-27,2014-02-17
Charleston Southern,High Point,70,76,1,-6,2014-02-17
Weber State,Idaho State,75,78,1,-3,2014-02-17
Morgan State,Maryland-Eastern Shore,88,72,0,16,2014-02-17
Grambling,Prairie View,83,81,0,2,2014-02-17
North Carolina Central,Savannah State,76,62,0,14,2014-02-17
North Carolina A&T,South Carolina State,70,75,1,-5,2014-02-17
Stetson,USC Upstate,48,66,1,-18,2014-02-17
Mississippi Valley State,Southern,74,83,1,-9,2014-02-17
Jackson State,Texas Southern,75,73,0,2,2014-02-17
Delaware,Towson,63,78,1,-15,2014-02-17
UNC Wilmington,William & Mary,70,93,1,-23,2014-02-17
Arlington Baptist,Abilene Christian,66,80,1,-14,2014-02-18
NC State,Clemson,56,73,1,-17,2014-02-18
Boise State,Colorado State,84,72,0,12,2014-02-18
Northern Iowa,Drake,67,70,1,-3,2014-02-18
Duke,Georgia Tech,68,51,0,17,2014-02-18
Cal State Northridge,Idaho,88,96,1,-8,2014-02-18
Detroit,UIC,65,59,0,6,2014-02-18
Missouri State,Illinois State,63,67,1,-4,2014-02-18
Texas,Iowa State,76,85,1,-9,2014-02-18
South Florida,Louisville,54,80,1,-26,2014-02-18
Wake Forest,Maryland,60,71,1,-11,2014-02-18
Kentucky,Ole Miss,84,70,0,14,2014-02-18
San Jose State,Nevada,66,64,0,2,2014-02-18
Villanova,Providence,82,79,0,3,2014-02-18
George Washington,Richmond,73,65,0,8,2014-02-18
Utah State,San Diego State,45,60,1,-15,2014-02-18
Bradley,Southern Illinois,64,75,1,-11,2014-02-18
Central Connecticut,St. Francis (NY),73,71,0,2,2014-02-18
Butler,St. John's (NY),52,77,1,-25,2014-02-18
Georgia,Tennessee,48,67,1,-19,2014-02-18
Kansas,Texas Tech,64,63,0,1,2014-02-18
Virginia,Virginia Tech,57,53,0,4,2014-02-18
Fresno State,Wyoming,66,72,1,-6,2014-02-18
South Carolina,Arkansas,64,71,1,-7,2014-02-19
Colgate,Army,66,74,1,-8,2014-02-19
Albany (NY),Binghamton,57,48,0,9,2014-02-19
American,Boston University,62,71,1,-9,2014-02-19
Akron,Buffalo,90,96,1,-6,2014-02-19
UCLA,California,86,66,0,20,2014-02-19
Cincinnati,UCF,77,49,0,28,2014-02-19
Ball State,Central Michigan,95,101,1,-6,2014-02-19
William & Mary,College of Charleston,54,87,1,-33,2014-02-19
Arizona State,Colorado,52,61,1,-9,2014-02-19
La Salle,Dayton,53,65,1,-12,2014-02-19
Auburn,Florida,66,71,1,-5,2014-02-19
Presbyterian,Gardner-Webb,70,79,1,-9,2014-02-19
Saint Louis,George Mason,89,85,0,4,2014-02-19
Liberty,High Point,60,67,1,-7,2014-02-19
Delaware,Hofstra,81,77,0,4,2014-02-19
Lafayette,Holy Cross,76,64,0,12,2014-02-19
Evansville,Indiana State,54,59,1,-5,2014-02-19
Drexel,James Madison,61,63,1,-2,2014-02-19
TCU,Kansas State,53,65,1,-12,2014-02-19
Navy,Lehigh,65,72,1,-7,2014-02-19
Radford,Longwood,86,75,0,11,2014-02-19
Mississippi State,LSU,81,92,1,-11,2014-02-19
Wichita State,Loyola (IL),88,74,0,14,2014-02-19
Bucknell,Loyola (MD),55,53,0,2,2014-02-19
Creighton,Marquette,85,70,0,15,2014-02-19
NJIT,Maryland-Eastern Shore,77,76,0,1,2014-02-19
Hartford,UMass-Lowell,75,68,0,7,2014-02-19
Notre Dame,Miami (FL),64,71,1,-7,2014-02-19
Kent State,Miami (OH),75,63,0,12,2014-02-19
Illinois,Minnesota,62,49,0,13,2014-02-19
Vanderbilt,Missouri,64,67,1,-3,2014-02-19
Manhattan,Monmouth,75,61,0,14,2014-02-19
Austin Peay,Morehead State,88,90,1,-2,2014-02-19
Coppin State,Morgan State,69,78,1,-9,2014-02-19
New Mexico,UNLV,68,56,0,12,2014-02-19
Vermont,New Hampshire,79,44,0,35,2014-02-19
Charleston Southern,UNC Asheville,71,82,1,-11,2014-02-19
Elon,UNC Greensboro,81,68,0,13,2014-02-19
Western Michigan,Ohio,73,63,0,10,2014-02-19
Northwestern,Ohio State,60,76,1,-16,2014-02-19
Washington,Oregon,71,78,1,-7,2014-02-19
St. Joseph's,Rhode Island,57,54,0,3,2014-02-19
Houston,SMU,64,68,1,-4,2014-02-19
Duquesne,St. Bonaventure,67,71,1,-4,2014-02-19
UMBC,Stony Brook,53,72,1,-19,2014-02-19
Boston College,Syracuse,62,59,0,3,2014-02-19
Arizona,Utah,67,63,0,4,2014-02-19
Campbell,VMI,81,84,1,-3,2014-02-19
Coastal Carolina,Winthrop,65,75,1,-10,2014-02-19
DePaul,Xavier,64,83,1,-19,2014-02-19
Western Carolina,Appalachian State,74,61,0,13,2014-02-20
Texas-Arlington,Arkansas State,60,83,1,-23,2014-02-20
Eastern Illinois,Belmont,63,82,1,-19,2014-02-20
Toledo,Bowling Green State,60,58,0,2,2014-02-20
Gonzaga,BYU,65,73,1,-8,2014-02-20
Fairleigh Dickinson,Bryant,63,52,0,11,2014-02-20
Cal State Fullerton,Cal Poly,67,59,0,8,2014-02-20
Long Beach State,UC-Davis,79,57,0,22,2014-02-20
UC-Riverside,UCSB,54,55,1,-1,2014-02-20
Quinnipiac,Canisius,88,81,0,7,2014-02-20
Mount St. Mary's,Central Connecticut,87,76,0,11,2014-02-20
Middle Tennessee,Charlotte,71,49,0,22,2014-02-20
Georgia Southern,Chattanooga,77,61,0,16,2014-02-20
Utah Valley,Chicago State,79,70,0,9,2014-02-20
Western Illinois,Denver,67,75,1,-8,2014-02-20
Louisiana Tech,East Carolina,68,75,1,-7,2014-02-20
Tulsa,Florida Atlantic,71,52,0,19,2014-02-20
North Texas,Florida International,65,63,0,2,2014-02-20
Louisiana-Monroe,Georgia State,60,75,1,-15,2014-02-20
Valparaiso,Green Bay,53,67,1,-14,2014-02-20
UC-Irvine,Hawaii,60,56,0,4,2014-02-20
ETSU,Jacksonville,86,91,1,-5,2014-02-20
Troy,Louisiana,63,78,1,-15,2014-02-20
Pepperdine,Loyola Marymount,72,69,0,3,2014-02-20
Alabama-Birmingham,Marshall,68,62,0,6,2014-02-20
Cal State Bakersfield,UMKC,74,69,0,5,2014-02-20
Weber State,Montana,57,68,1,-11,2014-02-20
Idaho State,Montana State,60,66,1,-6,2014-02-20
Penn State,Nebraska,67,80,1,-13,2014-02-20
Southeastern Louisiana,New Orleans,58,67,1,-9,2014-02-20
Fairfield,Niagara,72,66,0,6,2014-02-20
Duke,UNC,66,74,1,-8,2014-02-20
USC Upstate,North Florida,81,70,0,11,2014-02-20
Towson,Northeastern,79,70,0,9,2014-02-20
Northern Colorado,Northern Arizona,74,59,0,15,2014-02-20
Eastern Michigan,Northern Illinois,59,61,1,-2,2014-02-20
Rice,Old Dominion,51,55,1,-4,2014-02-20
Washington State,Oregon State,57,68,1,-11,2014-02-20
Michigan State,Purdue,94,79,0,15,2014-02-20
LIU-Brooklyn,Robert Morris,64,73,1,-9,2014-02-20
Memphis,Rutgers,64,59,0,5,2014-02-20
North Dakota,Sacramento State,65,71,1,-6,2014-02-20
St. Francis (NY),Saint Francis (PA),73,44,0,29,2014-02-20
Marist,St. Peter's,57,58,1,-1,2014-02-20
Portland,San Diego,59,61,1,-2,2014-02-20
Saint Mary's,San Francisco,62,73,1,-11,2014-02-20
Pacific,Santa Clara,50,70,1,-20,2014-02-20
Grand Canyon,Seattle,74,73,0,1,2014-02-20
Georgetown,Seton Hall,67,82,1,-15,2014-02-20
Omaha,South Dakota,86,87,1,-1,2014-02-20
Jacksonville State,Southeast Missouri State,70,87,1,-17,2014-02-20
UTSA,Southern Miss,56,85,1,-29,2014-02-20
Portland State,Southern Utah,86,79,0,7,2014-02-20
USC,Stanford,59,80,1,-21,2014-02-20
UConn,Temple,68,55,0,13,2014-02-20
Tennessee Tech,UT-Martin,91,83,0,8,2014-02-20
SIU-Edwardsville,Tennessee State,61,66,1,-5,2014-02-20
Alabama,Texas A&M,48,63,1,-15,2014-02-20
New Mexico State,Texas-Rio Grande Valley,78,61,0,17,2014-02-20
South Alabama,Texas State,66,67,1,-1,2014-02-20
UTEP,Tulane,72,54,0,18,2014-02-20
Sacred Heart,Wagner,62,74,1,-12,2014-02-20
Furman,Wofford,50,70,1,-20,2014-02-20
Milwaukee,Youngstown State,83,88,1,-5,2014-02-20
Brown,Columbia,68,70,1,-2,2014-02-21
Yale,Cornell,82,65,0,17,2014-02-21
Mercer,Florida Gulf Coast,61,75,1,-14,2014-02-21
Oakland,UIC,86,71,0,15,2014-02-21
Northern Kentucky,Lipscomb,66,70,1,-4,2014-02-21
VCU,UMass,75,80,1,-5,2014-02-21
Harvard,Penn,83,63,0,20,2014-02-21
Dartmouth,Princeton,57,67,1,-10,2014-02-21
Iona,Rider,80,77,0,3,2014-02-21
Manhattan,Siena,63,67,1,-4,2014-02-21
Kennesaw State,Stetson,67,63,0,4,2014-02-21
Detroit,Wright State,61,65,1,-4,2014-02-21
Southwestern Adventist,Abilene Christian,57,124,1,-67,2014-02-22
Nevada,Air Force,75,56,0,19,2014-02-22
Ohio,Akron,66,50,0,16,2014-02-22
Missouri,Alabama,73,80,1,-7,2014-02-22
Southern,Alabama A&M,70,62,0,8,2014-02-22
Alcorn State,Alabama State,86,92,1,-6,2014-02-22
Army,American,54,58,1,-4,2014-02-22
Texas-Arlington,Little Rock,75,71,0,4,2014-02-22
Prairie View,Arkansas-Pine Bluff,61,76,1,-15,2014-02-22
Texas State,Arkansas State,68,73,1,-5,2014-02-22
Vanderbilt,Auburn,67,59,0,8,2014-02-22
Eastern Kentucky,Austin Peay,96,75,0,21,2014-02-22
Florida A&M,Bethune-Cookman,80,75,0,5,2014-02-22
UNLV,Boise State,90,91,1,-1,2014-02-22
Loyola (IL),Bradley,38,55,1,-17,2014-02-22
Portland,BYU,72,89,1,-17,2014-02-22
Central Connecticut,Bryant,65,68,1,-3,2014-02-22
UC-Riverside,Cal Poly,64,69,1,-5,2014-02-22
UC-Irvine,Cal State Northridge,75,81,1,-6,2014-02-22
Cal State Fullerton,UCSB,65,80,1,-15,2014-02-22
Liberty,Campbell,79,59,0,20,2014-02-22
Fairfield,Canisius,78,90,1,-12,2014-02-22
Oral Roberts,Central Arkansas,63,50,0,13,2014-02-22
Alabama-Birmingham,Charlotte,64,62,0,2,2014-02-22
Cal State Bakersfield,Chicago State,68,73,1,-5,2014-02-22
Louisville,Cincinnati,58,57,0,1,2014-02-22
Milwaukee,Cleveland State,50,74,1,-24,2014-02-22
Loyola (MD),Colgate,60,84,1,-24,2014-02-22
Arizona,Colorado,88,61,0,27,2014-02-22
Wyoming,Colorado State,67,82,1,-15,2014-02-22
Norfolk State,Coppin State,73,68,0,5,2014-02-22
Brown,Cornell,81,75,0,6,2014-02-22
Wofford,Davidson,49,59,1,-10,2014-02-22
Maryland-Eastern Shore,Delaware State,71,84,1,-13,2014-02-22
Omaha,Denver,60,72,1,-12,2014-02-22
Marquette,DePaul,96,94,0,2,2014-02-22
Syracuse,Duke,60,66,1,-6,2014-02-22
Dayton,Duquesne,57,54,0,3,2014-02-22
Rice,East Carolina,55,67,1,-12,2014-02-22
Southern Illinois,Evansville,61,56,0,5,2014-02-22
Sacred Heart,Fairleigh Dickinson,66,73,1,-7,2014-02-22
North Texas,Florida Atlantic,78,76,0,2,2014-02-22
Tulsa,Florida International,77,65,0,12,2014-02-22
Appalachian State,Furman,53,68,1,-15,2014-02-22
Winthrop,Gardner-Webb,79,85,1,-6,2014-02-22
Xavier,Georgetown,52,74,1,-22,2014-02-22
Elon,Georgia Southern,66,61,0,5,2014-02-22
Louisiana,Georgia State,77,80,1,-3,2014-02-22
Clemson,Georgia Tech,63,55,0,8,2014-02-22
Jackson State,Grambling,79,59,0,20,2014-02-22
UC-Davis,Hawaii,77,86,1,-9,2014-02-22
Towson,Hofstra,83,77,0,6,2014-02-22
UCF,Houston,84,88,1,-4,2014-02-22
Texas A&M-Corpus Christi,Houston Baptist,66,61,0,5,2014-02-22
Hampton,Howard,81,78,0,3,2014-02-22
Grand Canyon,Idaho,77,83,1,-6,2014-02-22
Wisconsin,Iowa,79,74,0,5,2014-02-22
Purdue-Fort Wayne,IUPUI,84,60,0,24,2014-02-22
USC Upstate,Jacksonville,82,88,1,-6,2014-02-22
Texas,Kansas,54,85,1,-31,2014-02-22
Buffalo,Kent State,78,69,0,9,2014-02-22
LSU,Kentucky,76,77,1,-1,2014-02-22
Sam Houston State,Lamar,74,71,0,3,2014-02-22
High Point,Longwood,85,59,0,26,2014-02-22
Middle Tennessee,Marshall,56,53,0,3,2014-02-22
Binghamton,UMBC,72,70,0,2,2014-02-22
Temple,Memphis,79,82,1,-3,2014-02-22
Boston College,Miami (FL),42,69,1,-27,2014-02-22
Florida,Ole Miss,75,71,0,4,2014-02-22
Arkansas,Mississippi State,73,69,0,4,2014-02-22
Texas Southern,Mississippi Valley State,73,65,0,8,2014-02-22
Utah Valley,UMKC,56,74,1,-18,2014-02-22
Indiana State,Missouri State,66,77,1,-11,2014-02-22
St. Peter's,Monmouth,61,51,0,10,2014-02-22
Idaho State,Montana,61,62,1,-1,2014-02-22
Weber State,Montana State,86,68,0,18,2014-02-22
Morehead State,Murray State,58,69,1,-11,2014-02-22
UMass-Lowell,New Hampshire,58,52,0,6,2014-02-22
San Diego State,New Mexico,44,58,1,-14,2014-02-22
Quinnipiac,Niagara,90,88,0,2,2014-02-22
McNeese State,Nicholls State,59,68,1,-9,2014-02-22
Fisher College,NJIT,67,99,1,-32,2014-02-22
Wake Forest,UNC,72,105,1,-33,2014-02-22
Coastal Carolina,UNC Asheville,85,100,1,-15,2014-02-22
North Carolina Central,North Carolina A&T,73,55,0,18,2014-02-22
College of Charleston,UNC Wilmington,55,57,1,-2,2014-02-22
South Dakota State,North Dakota State,59,74,1,-15,2014-02-22
ETSU,North Florida,88,85,0,3,2014-02-22
North Dakota,Northern Arizona,75,63,0,12,2014-02-22
Indiana,Northwestern,61,56,0,5,2014-02-22
Minnesota,Ohio State,46,64,1,-18,2014-02-22
Kansas State,Oklahoma,73,86,1,-13,2014-02-22
Texas Tech,Oklahoma State,62,84,1,-22,2014-02-22
Louisiana Tech,Old Dominion,71,66,0,5,2014-02-22
Washington,Oregon State,86,62,0,24,2014-02-22
Dartmouth,Penn,65,74,1,-9,2014-02-22
Charleston Southern,Presbyterian,86,47,0,39,2014-02-22
Harvard,Princeton,59,47,0,12,2014-02-22
La Salle,Richmond,49,62,1,-13,2014-02-22
St. Francis (NY),Robert Morris,70,71,1,-1,2014-02-22
Northern Colorado,Sacramento State,58,79,1,-21,2014-02-22
LIU-Brooklyn,Saint Francis (PA),64,83,1,-19,2014-02-22
Fordham,St. Joseph's,72,87,1,-15,2014-02-22
George Washington,Saint Louis,59,66,1,-7,2014-02-22
Gonzaga,San Diego,66,69,1,-3,2014-02-22
Pacific,San Francisco,59,64,1,-5,2014-02-22
Saint Mary's,Santa Clara,76,54,0,22,2014-02-22
Troy,South Alabama,78,86,1,-8,2014-02-22
Georgia,South Carolina,73,56,0,17,2014-02-22
Savannah State,South Carolina State,75,65,0,10,2014-02-22
Western Illinois,South Dakota,54,64,1,-10,2014-02-22
UTEP,Southern Miss,68,77,1,-9,2014-02-22
Eastern Washington,Southern Utah,85,74,0,11,2014-02-22
Rhode Island,St. Bonaventure,87,78,0,9,2014-02-22
UCLA,Stanford,74,83,1,-9,2014-02-22
Northwestern State,Stephen F. Austin,68,70,1,-2,2014-02-22
Southeast Missouri State,UT-Martin,77,74,0,3,2014-02-22
Jacksonville State,Tennessee Tech,57,69,1,-12,2014-02-22
Tennessee,Texas A&M,65,68,1,-3,2014-02-22
Iowa State,TCU,71,60,0,11,2014-02-22
UTSA,Tulane,56,68,1,-12,2014-02-22
Fresno State,Utah State,79,76,0,3,2014-02-22
Youngstown State,Valparaiso,66,68,1,-2,2014-02-22
St. John's (NY),Villanova,54,57,1,-3,2014-02-22
Notre Dame,Virginia,49,70,1,-21,2014-02-22
Radford,VMI,76,88,1,-12,2014-02-22
NC State,Virginia Tech,71,64,0,7,2014-02-22
Mount St. Mary's,Wagner,66,71,1,-5,2014-02-22
Baylor,West Virginia,88,75,0,13,2014-02-22
Citadel,Western Carolina,52,70,1,-18,2014-02-22
Louisiana-Monroe,Western Kentucky,63,72,1,-9,2014-02-22
Drake,Wichita State,54,83,1,-29,2014-02-22
Northeastern,William & Mary,67,81,1,-14,2014-02-22
Bucknell,Boston University,63,53,0,10,2014-02-23
Providence,Butler,87,81,0,6,2014-02-23
USC,California,64,77,1,-13,2014-02-23
Northern Illinois,Central Michigan,67,70,1,-3,2014-02-23
Yale,Columbia,46,62,1,-16,2014-02-23
SMU,UConn,64,55,0,9,2014-02-23
Seton Hall,Creighton,71,72,1,-1,2014-02-23
Drexel,Delaware,69,65,0,4,2014-02-23
Kennesaw State,Florida Gulf Coast,68,78,1,-10,2014-02-23
Navy,Holy Cross,57,74,1,-17,2014-02-23
Lehigh,Lafayette,71,77,1,-6,2014-02-23
Stony Brook,Maine,83,79,0,4,2014-02-23
Iona,Marist,86,67,0,19,2014-02-23
Bowling Green State,Miami (OH),52,55,1,-3,2014-02-23
Michigan State,Michigan,70,79,1,-9,2014-02-23
Purdue,Nebraska,57,76,1,-19,2014-02-23
Chattanooga,UNC Greensboro,84,88,1,-4,2014-02-23
Illinois State,Northern Iowa,59,72,1,-13,2014-02-23
Washington State,Oregon,53,67,1,-14,2014-02-23
Florida State,Pitt,71,66,0,5,2014-02-23
Siena,Rider,69,60,0,9,2014-02-23
Mercer,Stetson,73,52,0,21,2014-02-23
Ball State,Toledo,74,85,1,-11,2014-02-23
Arizona State,Utah,63,86,1,-23,2014-02-23
Hartford,Vermont,47,72,1,-25,2014-02-23
Eastern Michigan,Western Michigan,67,75,1,-8,2014-02-23
Alcorn State,Alabama A&M,64,56,0,8,2014-02-24
Southern,Alabama State,87,64,0,23,2014-02-24
Texas Southern,Arkansas-Pine Bluff,65,55,0,10,2014-02-24
Samford,Citadel,71,81,1,-10,2014-02-24
Morgan State,Delaware State,56,59,1,-3,2014-02-24
Chicago State,Eastern Illinois,62,84,1,-22,2014-02-24
Portland State,Eastern Washington,87,76,0,11,2014-02-24
Wagner,Fairleigh Dickinson,67,64,0,3,2014-02-24
Elon,Furman,78,49,0,29,2014-02-24
Norfolk State,Howard,66,60,0,6,2014-02-24
Oklahoma,Kansas,75,83,1,-8,2014-02-24
Syracuse,Maryland,57,55,0,2,2014-02-24
Hampton,Maryland-Eastern Shore,104,89,0,15,2014-02-24
Prairie View,Mississippi Valley State,69,75,1,-6,2014-02-24
Bryant,Mount St. Mary's,73,88,1,-15,2014-02-24
Oklahoma State,TCU,76,54,0,22,2014-02-24
Lyon,Arkansas State,39,65,1,-26,2014-02-25
Wichita State,Bradley,69,49,0,20,2014-02-25
Youngstown State,Cleveland State,69,70,1,-1,2014-02-25
Seton Hall,DePaul,60,65,1,-5,2014-02-25
Virginia Tech,Duke,48,66,1,-18,2014-02-25
Drake,Evansville,48,61,1,-13,2014-02-25
Missouri,Georgia,56,71,1,-15,2014-02-25
Arlington Baptist,Houston Baptist,55,107,1,-52,2014-02-25
Longwood,Liberty,76,90,1,-14,2014-02-25
UIC,Milwaukee,80,58,0,22,2014-02-25
Iowa,Minnesota,89,95,1,-6,2014-02-25
Loyola (IL),Missouri State,56,72,1,-16,2014-02-25
Utah State,New Mexico,58,67,1,-9,2014-02-25
North Carolina Central,NJIT,81,62,0,19,2014-02-25
LIU-Brooklyn,Sacred Heart,80,75,0,5,2014-02-25
Dayton,St. Joseph's,53,79,1,-26,2014-02-25
Fairfield,St. Peter's,62,63,1,-1,2014-02-25
San Jose State,San Diego State,64,90,1,-26,2014-02-25
Xavier,St. John's (NY),65,53,0,12,2014-02-25
Kansas State,Texas Tech,60,56,0,4,2014-02-25
Florida,Vanderbilt,57,54,0,3,2014-02-25
Clemson,Wake Forest,57,62,1,-5,2014-02-25
Indiana,Wisconsin,58,69,1,-11,2014-02-25
Valparaiso,Wright State,58,67,1,-9,2014-02-25
Air Force,Wyoming,55,53,0,2,2014-02-25
California,Arizona,59,87,1,-28,2014-02-26
Stanford,Arizona State,64,76,1,-12,2014-02-26
Boston University,Army,71,70,0,1,2014-02-26
South Carolina,Auburn,67,83,1,-16,2014-02-26
Western Michigan,Ball State,88,81,0,7,2014-02-26
Pitt,Boston College,66,59,0,7,2014-02-26
Kent State,Bowling Green State,66,73,1,-7,2014-02-26
Lehigh,Bucknell,61,65,1,-4,2014-02-26
Rutgers,UCF,65,67,1,-2,2014-02-26
Gardner-Webb,Charleston Southern,78,76,0,2,2014-02-26
Presbyterian,Coastal Carolina,51,70,1,-19,2014-02-26
Lafayette,Colgate,66,83,1,-17,2014-02-26
College of Charleston,Drexel,45,56,1,-11,2014-02-26
Central Michigan,Eastern Michigan,42,64,1,-22,2014-02-26
Edward Waters,Florida A&M,69,104,1,-35,2014-02-26
Boise State,Fresno State,56,76,1,-20,2014-02-26
Richmond,George Mason,60,69,1,-9,2014-02-26
VMI,High Point,67,70,1,-3,2014-02-26
Nebraska,Illinois,49,60,1,-11,2014-02-26
Indiana State,Illinois State,59,77,1,-18,2014-02-26
West Virginia,Iowa State,66,83,1,-17,2014-02-26
Towson,James Madison,69,66,0,3,2014-02-26
St. Bonaventure,La Salle,67,75,1,-8,2014-02-26
Texas A&M,LSU,49,68,1,-19,2014-02-26
Holy Cross,Loyola (MD),65,52,0,13,2014-02-26
Rhode Island,UMass,67,70,1,-3,2014-02-26
Akron,Miami (OH),61,65,1,-4,2014-02-26
Alabama,Ole Miss,67,79,1,-12,2014-02-26
Tennessee,Mississippi State,75,68,0,7,2014-02-26
American,Navy,64,55,0,9,2014-02-26
Colorado State,UNLV,70,78,1,-8,2014-02-26
UNC,NC State,85,84,0,1,2014-02-26
Delaware,UNC Wilmington,70,57,0,13,2014-02-26
Toledo,Northern Illinois,66,74,1,-8,2014-02-26
Southern Illinois,Northern Iowa,54,73,1,-19,2014-02-26
Georgia Tech,Notre Dame,62,65,1,-3,2014-02-26
Buffalo,Ohio,69,64,0,5,2014-02-26
Michigan,Purdue,77,76,0,1,2014-02-26
Campbell,Radford,78,82,1,-4,2014-02-26
UConn,South Florida,61,56,0,5,2014-02-26
Belmont,SIU-Edwardsville,94,75,0,19,2014-02-26
Baylor,Texas,69,74,1,-5,2014-02-26
Florida Atlantic,Tulane,64,72,1,-8,2014-02-26
Butler,Villanova,48,67,1,-19,2014-02-26
Miami (FL),Virginia,40,65,1,-25,2014-02-26
Hofstra,William & Mary,74,79,1,-5,2014-02-26
UNC Asheville,Winthrop,100,107,1,-7,2014-02-26
New Hampshire,Albany (NY),48,66,1,-18,2014-02-27
Texas-Rio Grande Valley,Cal State Bakersfield,63,61,0,2,2014-02-27
Cal State Northridge,Cal State Fullerton,81,82,1,-1,2014-02-27
Cal Poly,UC-Davis,73,85,1,-12,2014-02-27
UCSB,UC-Irvine,60,71,1,-11,2014-02-27
Sam Houston State,Central Arkansas,71,80,1,-9,2014-02-27
UNC Greensboro,Davidson,46,79,1,-33,2014-02-27
Milwaukee,Detroit,68,62,0,6,2014-02-27
Charlotte,East Carolina,68,75,1,-7,2014-02-27
Tennessee Tech,Eastern Kentucky,67,74,1,-7,2014-02-27
Wofford,Elon,63,59,0,4,2014-02-27
Robert Morris,Fairleigh Dickinson,69,64,0,5,2014-02-27
VCU,Fordham,85,66,0,19,2014-02-27
Georgia Southern,Furman,82,73,0,9,2014-02-27
UMKC,Grand Canyon,85,80,0,5,2014-02-27
Binghamton,Hartford,83,89,1,-6,2014-02-27
Memphis,Houston,68,77,1,-9,2014-02-27
Northern Arizona,Idaho State,66,65,0,1,2014-02-27
Iowa,Indiana,86,93,1,-7,2014-02-27
Jacksonville,Kennesaw State,71,69,0,2,2014-02-27
Arkansas,Kentucky,71,67,0,4,2014-02-27
Florida Gulf Coast,Lipscomb,71,92,1,-21,2014-02-27
Hawaii,Long Beach State,61,63,1,-2,2014-02-27
Central Connecticut,LIU-Brooklyn,86,82,0,4,2014-02-27
South Alabama,Louisiana-Monroe,54,71,1,-17,2014-02-27
Middle Tennessee,Louisiana Tech,39,55,1,-16,2014-02-27
Temple,Louisville,66,88,1,-22,2014-02-27
Santa Clara,Loyola Marymount,71,75,1,-4,2014-02-27
Georgetown,Marquette,73,75,1,-2,2014-02-27
Maine,UMass-Lowell,72,84,1,-12,2014-02-27
Incarnate Word,McNeese State,72,87,1,-15,2014-02-27
North Florida,Mercer,79,76,0,3,2014-02-27
Southern Utah,Montana State,72,77,1,-5,2014-02-27
Tennessee State,Morehead State,70,68,0,2,2014-02-27
Sacred Heart,Mount St. Mary's,72,65,0,7,2014-02-27
IUPUI,Omaha,66,88,1,-22,2014-02-27
Stephen F. Austin,New Orleans,103,63,0,40,2014-02-27
Abilene Christian,Nicholls State,60,79,1,-19,2014-02-27
Portland State,North Dakota,73,83,1,-10,2014-02-27
South Dakota,North Dakota State,54,82,1,-28,2014-02-27
Eastern Washington,Northern Colorado,80,66,0,14,2014-02-27
Stetson,Northern Kentucky,58,96,1,-38,2014-02-27
Green Bay,Oakland,71,63,0,8,2014-02-27
Marshall,Old Dominion,63,70,1,-7,2014-02-27
Lamar,Oral Roberts,67,75,1,-8,2014-02-27
Gonzaga,Pacific,70,53,0,17,2014-02-27
Ohio State,Penn State,63,65,1,-2,2014-02-27
San Francisco,Pepperdine,77,53,0,24,2014-02-27
Siena,Quinnipiac,72,70,0,2,2014-02-27
Alabama-Birmingham,Rice,61,60,0,1,2014-02-27
Duquesne,Saint Louis,71,64,0,7,2014-02-27
Portland,Saint Mary's,61,70,1,-9,2014-02-27
Appalachian State,Samford,63,57,0,6,2014-02-27
Chicago State,Seattle,84,77,0,7,2014-02-27
Denver,South Dakota State,69,78,1,-9,2014-02-27
Austin Peay,Southeast Missouri State,80,83,1,-3,2014-02-27
Northwestern State,Southeastern Louisiana,88,83,0,5,2014-02-27
Oregon State,USC,76,66,0,10,2014-02-27
Florida International,Southern Miss,66,78,1,-12,2014-02-27
Bryant,St. Francis (NY),59,62,1,-3,2014-02-27
Murray State,UT-Martin,86,72,0,14,2014-02-27
Georgia State,Texas-Arlington,77,49,0,28,2014-02-27
Tulsa,UTEP,65,60,0,5,2014-02-27
North Texas,UTSA,71,62,0,9,2014-02-27
Western Kentucky,Texas State,51,50,0,1,2014-02-27
Little Rock,Troy,62,55,0,7,2014-02-27
Oregon,UCLA,87,83,0,4,2014-02-27
New Mexico State,Utah Valley,61,66,1,-5,2014-02-27
Stony Brook,Vermont,53,69,1,-16,2014-02-27
Saint Francis (PA),Wagner,45,74,1,-29,2014-02-27
Sacramento State,Weber State,67,79,1,-12,2014-02-27
Chattanooga,Western Carolina,83,81,0,2,2014-02-27
Purdue-Fort Wayne,Western Illinois,65,56,0,9,2014-02-27
Columbia,Dartmouth,84,72,0,12,2014-02-28
Marist,Fairfield,74,78,1,-4,2014-02-28
Cornell,Harvard,47,72,1,-25,2014-02-28
Campbell,High Point,53,56,1,-3,2014-02-28
Iona,Manhattan,77,80,1,-3,2014-02-28
Niagara,Monmouth,50,75,1,-25,2014-02-28
Brown,Penn,76,67,0,9,2014-02-28
Yale,Princeton,46,57,1,-11,2014-02-28
Canisius,Rider,79,66,0,13,2014-02-28
Providence,Seton Hall,74,69,0,5,2014-02-28
ETSU,USC Upstate,73,79,1,-6,2014-02-28
Washington State,Washington,49,72,1,-23,2014-02-28
UNLV,Air Force,93,67,0,26,2014-03-01
Bowling Green State,Akron,47,57,1,-10,2014-03-01
Auburn,Alabama,57,73,1,-16,2014-03-01
Southern,Alcorn State,67,54,0,13,2014-03-01
Bucknell,American,56,51,0,5,2014-03-01
California,Arizona State,60,78,1,-18,2014-03-01
Georgia,Arkansas,75,87,1,-12,2014-03-01
Arkansas State,Little Rock,67,74,1,-7,2014-03-01
Lafayette,Army,84,87,1,-3,2014-03-01
Central Michigan,Ball State,71,74,1,-3,2014-03-01
Texas Tech,Baylor,49,59,1,-10,2014-03-01
Miami (OH),Buffalo,55,78,1,-23,2014-03-01
New Mexico State,Cal State Bakersfield,72,57,0,15,2014-03-01
Long Beach State,Cal State Fullerton,76,84,1,-8,2014-03-01
UCSB,UC-Davis,67,54,0,13,2014-03-01
Cal Poly,UC-Irvine,48,55,1,-7,2014-03-01
Cal State Northridge,UC-Riverside,105,106,1,-1,2014-03-01
Lamar,Central Arkansas,69,76,1,-7,2014-03-01
Appalachian State,Chattanooga,44,63,1,-19,2014-03-01
Georgia Southern,Citadel,63,80,1,-17,2014-03-01
Charleston Southern,Coastal Carolina,61,63,1,-2,2014-03-01
Delaware,College of Charleston,89,86,0,3,2014-03-01
Cincinnati,UConn,45,51,1,-6,2014-03-01
Maryland-Eastern Shore,Coppin State,68,67,0,1,2014-03-01
Cornell,Dartmouth,78,87,1,-9,2014-03-01
UMass,Dayton,79,86,1,-7,2014-03-01
Howard,Delaware State,55,53,0,2,2014-03-01
Green Bay,Detroit,75,66,0,9,2014-03-01
Bradley,Drake,66,71,1,-5,2014-03-01
Tennessee State,Eastern Kentucky,66,70,1,-4,2014-03-01
Northern Illinois,Eastern Michigan,52,56,1,-4,2014-03-01
Davidson,Elon,86,69,0,17,2014-03-01
LSU,Florida,61,79,1,-18,2014-03-01
La Salle,Fordham,64,62,0,2,2014-03-01
San Diego State,Fresno State,82,67,0,15,2014-03-01
Arkansas-Pine Bluff,Grambling,61,52,0,9,2014-03-01
Chicago State,Grand Canyon,74,84,1,-10,2014-03-01
Norfolk State,Hampton,53,61,1,-8,2014-03-01
Columbia,Harvard,47,80,1,-33,2014-03-01
James Madison,Hofstra,71,82,1,-11,2014-03-01
Boston University,Holy Cross,68,64,0,4,2014-03-01
Sacramento State,Idaho State,67,80,1,-13,2014-03-01
Wright State,UIC,68,61,0,7,2014-03-01
Northern Iowa,Indiana State,71,69,0,2,2014-03-01
Mississippi Valley State,Jackson State,64,82,1,-18,2014-03-01
Belmont,Jacksonville State,76,53,0,23,2014-03-01
Iowa State,Kansas State,73,80,1,-7,2014-03-01
North Florida,Kennesaw State,87,77,0,10,2014-03-01
Colgate,Lehigh,74,57,0,17,2014-03-01
Radford,Liberty,87,83,0,4,2014-03-01
Stetson,Lipscomb,76,83,1,-7,2014-03-01
Bryant,LIU-Brooklyn,81,62,0,19,2014-03-01
VMI,Longwood,86,66,0,20,2014-03-01
Troy,Louisiana-Monroe,61,46,0,15,2014-03-01
Evansville,Loyola (IL),75,72,0,3,2014-03-01
San Francisco,Loyola Marymount,65,61,0,4,2014-03-01
Abilene Christian,McNeese State,91,95,1,-4,2014-03-01
Louisville,Memphis,66,72,1,-6,2014-03-01
Jacksonville,Mercer,55,69,1,-14,2014-03-01
Minnesota,Michigan,56,66,1,-10,2014-03-01
Illinois,Michigan State,53,46,0,7,2014-03-01
Rice,Middle Tennessee,41,65,1,-24,2014-03-01
Mississippi State,Missouri,66,85,1,-19,2014-03-01
Southern Utah,Montana,54,82,1,-28,2014-03-01
Tennessee Tech,Morehead State,91,84,0,7,2014-03-01
Bethune-Cookman,Morgan State,61,65,1,-4,2014-03-01
Saint Francis (PA),Mount St. Mary's,55,78,1,-23,2014-03-01
Loyola (MD),Navy,67,65,0,2,2014-03-01
Northwestern,Nebraska,47,54,1,-7,2014-03-01
Purdue-Fort Wayne,Omaha,96,95,0,1,2014-03-01
Northwestern State,New Orleans,84,71,0,13,2014-03-01
Incarnate Word,Nicholls State,69,67,0,2,2014-03-01
Gardner-Webb,UNC Asheville,71,83,1,-12,2014-03-01
Savannah State,North Carolina A&T,71,67,0,4,2014-03-01
South Carolina State,North Carolina Central,44,86,1,-42,2014-03-01
Miami (FL),NC State,85,70,0,15,2014-03-01
Eastern Washington,North Dakota,67,69,1,-2,2014-03-01
Denver,North Dakota State,68,78,1,-10,2014-03-01
Drexel,Northeastern,52,54,1,-2,2014-03-01
Portland State,Northern Colorado,77,68,0,9,2014-03-01
Florida Gulf Coast,Northern Kentucky,92,72,0,20,2014-03-01
Pitt,Notre Dame,85,81,0,4,2014-03-01
Kent State,Ohio,75,61,0,14,2014-03-01
Texas,Oklahoma,65,77,1,-12,2014-03-01
Kansas,Oklahoma State,65,72,1,-7,2014-03-01
Sam Houston State,Oral Roberts,73,80,1,-7,2014-03-01
Portland,Pacific,65,68,1,-3,2014-03-01
Yale,Penn,70,63,0,7,2014-03-01
Santa Clara,Pepperdine,86,78,0,8,2014-03-01
Alabama A&M,Prairie View,72,65,0,7,2014-03-01
Brown,Princeton,64,69,1,-5,2014-03-01
Richmond,Rhode Island,43,66,1,-23,2014-03-01
South Florida,Rutgers,73,74,1,-1,2014-03-01
Central Connecticut,Sacred Heart,73,70,0,3,2014-03-01
Gonzaga,Saint Mary's,75,47,0,28,2014-03-01
Western Carolina,Samford,86,93,1,-7,2014-03-01
BYU,San Diego,78,70,0,8,2014-03-01
Utah State,San Jose State,75,58,0,17,2014-03-01
Idaho,Seattle,68,76,1,-8,2014-03-01
Kentucky,South Carolina,67,72,1,-5,2014-03-01
South Dakota,South Dakota State,61,75,1,-14,2014-03-01
Murray State,Southeast Missouri State,115,118,1,-3,2014-03-01
Stephen F. Austin,Southeastern Louisiana,75,62,0,13,2014-03-01
Oregon,USC,78,63,0,15,2014-03-01
Illinois State,Southern Illinois,65,66,1,-1,2014-03-01
Eastern Illinois,SIU-Edwardsville,78,74,0,4,2014-03-01
UCF,SMU,55,70,1,-15,2014-03-01
St. Joseph's,St. Bonaventure,83,74,0,9,2014-03-01
Fairleigh Dickinson,St. Francis (NY),56,79,1,-23,2014-03-01
Houston,Temple,89,79,0,10,2014-03-01
Vanderbilt,Tennessee,38,76,1,-38,2014-03-01
Austin Peay,UT-Martin,88,85,0,3,2014-03-01
Ole Miss,Texas A&M,60,71,1,-11,2014-03-01
Houston Baptist,Texas A&M-Corpus Christi,45,65,1,-20,2014-03-01
Western Kentucky,Texas-Arlington,73,80,1,-7,2014-03-01
Alabama State,Texas Southern,66,86,1,-20,2014-03-01
Georgia State,Texas State,66,55,0,11,2014-03-01
Western Michigan,Toledo,85,96,1,-11,2014-03-01
William & Mary,Towson,68,70,1,-2,2014-03-01
Colorado,Utah,64,75,1,-11,2014-03-01
Texas-Rio Grande Valley,Utah Valley,42,45,1,-3,2014-03-01
Cleveland State,Valparaiso,63,52,0,11,2014-03-01
Syracuse,Virginia,56,75,1,-19,2014-03-01
Saint Louis,VCU,56,67,1,-11,2014-03-01
UNC,Virginia Tech,60,56,0,4,2014-03-01
Robert Morris,Wagner,48,59,1,-11,2014-03-01
Boston College,Wake Forest,80,72,0,8,2014-03-01
Northern Arizona,Weber State,73,71,0,2,2014-03-01
TCU,West Virginia,59,81,1,-22,2014-03-01
IUPUI,Western Illinois,70,75,1,-5,2014-03-01
Missouri State,Wichita State,45,68,1,-23,2014-03-01
Presbyterian,Winthrop,60,82,1,-22,2014-03-01
UNC Greensboro,Wofford,73,71,0,2,2014-03-01
Boise State,Wyoming,72,63,0,9,2014-03-01
Creighton,Xavier,69,75,1,-6,2014-03-01
Oakland,Youngstown State,87,81,0,6,2014-03-01
Louisiana Tech,Alabama-Birmingham,67,58,0,9,2014-03-02
Stanford,Arizona,66,79,1,-13,2014-03-02
Vermont,Binghamton,92,82,0,10,2014-03-02
Old Dominion,Charlotte,63,74,1,-11,2014-03-02
Maryland,Clemson,73,77,1,-4,2014-03-02
Southern Miss,Florida Atlantic,60,49,0,11,2014-03-02
Tulane,Florida International,47,73,1,-26,2014-03-02
Georgia Tech,Florida State,71,81,1,-10,2014-03-02
George Mason,George Washington,58,66,1,-8,2014-03-02
UMBC,Hartford,56,67,1,-11,2014-03-02
Ohio State,Indiana,64,72,1,-8,2014-03-02
Rider,Iona,81,97,1,-16,2014-03-02
Purdue,Iowa,76,83,1,-7,2014-03-02
South Alabama,Louisiana,76,102,1,-26,2014-03-02
New Hampshire,Maine,69,73,1,-4,2014-03-02
Canisius,Manhattan,63,68,1,-5,2014-03-02
Quinnipiac,Marist,72,103,1,-31,2014-03-02
East Carolina,Marshall,61,64,1,-3,2014-03-02
New Mexico,Nevada,72,58,0,14,2014-03-02
UTEP,North Texas,74,54,0,20,2014-03-02
Wisconsin,Penn State,71,66,0,5,2014-03-02
Niagara,St. Peter's,67,71,1,-4,2014-03-02
Monmouth,Siena,54,70,1,-16,2014-03-02
DePaul,St. John's (NY),64,72,1,-8,2014-03-02
Albany (NY),Stony Brook,68,73,1,-5,2014-03-02
UTSA,Tulsa,70,72,1,-2,2014-03-02
Oregon State,UCLA,69,74,1,-5,2014-03-02
Marquette,Villanova,56,73,1,-17,2014-03-02
Navy,Colgate,51,57,1,-6,2014-03-03
Howard,Coppin State,69,86,1,-17,2014-03-03
Mississippi Valley State,Grambling,70,72,1,-2,2014-03-03
Arkansas-Pine Bluff,Jackson State,66,59,0,7,2014-03-03
Lafayette,Loyola (MD),84,71,0,13,2014-03-03
Montana State,Montana,50,53,1,-3,2014-03-03
Florida A&M,Morgan State,78,73,0,5,2014-03-03
Maryland-Eastern Shore,Norfolk State,65,77,1,-12,2014-03-03
Notre Dame,UNC,61,63,1,-2,2014-03-03
South Carolina State,North Carolina A&T,60,62,1,-2,2014-03-03
Savannah State,North Carolina Central,57,64,1,-7,2014-03-03
Kansas State,Oklahoma State,61,77,1,-16,2014-03-03
NC State,Pitt,74,67,0,7,2014-03-03
Alabama State,Prairie View,90,87,0,3,2014-03-03
Xavier,Seton Hall,62,71,1,-9,2014-03-03
Alabama A&M,Texas Southern,58,79,1,-21,2014-03-03
Buffalo,Akron,71,83,1,-12,2014-03-04
Georgia State,Arkansas State,79,76,0,3,2014-03-04
Iowa State,Baylor,61,74,1,-13,2014-03-04
Florida State,Boston College,74,70,0,4,2014-03-04
Ohio,Bowling Green State,72,61,0,11,2014-03-04
Toledo,Central Michigan,73,69,0,4,2014-03-04
Miami (FL),Clemson,54,58,1,-4,2014-03-04
Lipscomb,ETSU,88,89,1,-1,2014-03-04
Ball State,Eastern Michigan,58,72,1,-14,2014-03-04
Stetson,Florida Gulf Coast,55,77,1,-22,2014-03-04
Creighton,Georgetown,63,75,1,-12,2014-03-04
South Florida,Houston,69,78,1,-9,2014-03-04
Michigan,Illinois,84,53,0,31,2014-03-04
Miami (OH),Kent State,73,61,0,12,2014-03-04
Alabama,Kentucky,48,55,1,-7,2014-03-04
Virginia Tech,Maryland,47,64,1,-17,2014-03-04
Jacksonville,Mercer,64,85,1,-21,2014-03-04
Detroit,Milwaukee,73,83,1,-10,2014-03-04
Northern Colorado,North Dakota,90,94,1,-4,2014-03-04
Youngstown State,Oakland,92,96,1,-4,2014-03-04
Arizona State,Oregon,78,85,1,-7,2014-03-04
Marquette,Providence,80,81,1,-1,2014-03-04
Florida,South Carolina,72,46,0,26,2014-03-04
North Florida,USC Upstate,74,80,1,-6,2014-03-04
Georgia Tech,Syracuse,67,62,0,5,2014-03-04
UCF,Temple,78,86,1,-8,2014-03-04
UIC,Valparaiso,63,73,1,-10,2014-03-04
Northern Illinois,Western Michigan,56,61,1,-5,2014-03-04
Colgate,American,50,59,1,-9,2014-03-05
Ole Miss,Arkansas,80,110,1,-30,2014-03-05
Tennessee,Auburn,82,54,0,28,2014-03-05
Nevada,Boise State,83,81,0,2,2014-03-05
Lafayette,Boston University,54,91,1,-37,2014-03-05
Saint Francis (PA),Bryant,55,54,0,1,2014-03-05
Army,Bucknell,72,71,0,1,2014-03-05
Utah,California,63,59,0,4,2014-03-05
Charleston Southern,Campbell,81,71,0,10,2014-03-05
San Jose State,Colorado State,66,78,1,-12,2014-03-05
Rutgers,UConn,63,69,1,-6,2014-03-05
UMass,Duquesne,78,74,0,4,2014-03-05
Southeast Missouri State,Eastern Illinois,79,61,0,18,2014-03-05
Longwood,Gardner-Webb,65,81,1,-16,2014-03-05
St. Joseph's,George Washington,71,76,1,-5,2014-03-05
Mississippi State,Georgia,45,66,1,-21,2014-03-05
Lehigh,Holy Cross,48,54,1,-6,2014-03-05
Nebraska,Indiana,70,60,0,10,2014-03-05
Texas Tech,Kansas,57,82,1,-25,2014-03-05
Winthrop,Liberty,77,65,0,12,2014-03-05
Texas A&M,Missouri,56,57,1,-1,2014-03-05
St. Francis (NY),Mount St. Mary's,71,72,1,-1,2014-03-05
San Diego State,UNLV,73,64,0,9,2014-03-05
Air Force,New Mexico,52,80,1,-28,2014-03-05
West Virginia,Oklahoma,62,72,1,-10,2014-03-05
Arizona,Oregon State,74,69,0,5,2014-03-05
Radford,Presbyterian,78,73,0,5,2014-03-05
Fordham,Rhode Island,65,77,1,-12,2014-03-05
Fairleigh Dickinson,Robert Morris,53,60,1,-7,2014-03-05
Dayton,Saint Louis,72,67,0,5,2014-03-05
Tennessee Tech,SIU-Edwardsville,74,67,0,7,2014-03-05
Louisville,SMU,84,71,0,13,2014-03-05
Colorado,Stanford,59,56,0,3,2014-03-05
TCU,Texas,54,66,1,-12,2014-03-05
Wyoming,Utah State,54,65,1,-11,2014-03-05
Central Connecticut,Wagner,59,83,1,-24,2014-03-05
Duke,Wake Forest,72,82,1,-10,2014-03-05
Purdue,Wisconsin,70,76,1,-6,2014-03-05
Jackson State,Alabama A&M,59,72,1,-13,2014-03-06
Middle Tennessee,Alabama-Birmingham,55,53,0,2,2014-03-06
Grambling,Alabama State,66,68,1,-2,2014-03-06
Texas Southern,Alcorn State,77,69,0,8,2014-03-06
Louisiana-Monroe,Arkansas State,58,64,1,-6,2014-03-06
Loyola (IL),Bradley,74,72,0,2,2014-03-06
UC-Irvine,Cal State Fullerton,62,44,0,18,2014-03-06
Long Beach State,Cal State Northridge,83,91,1,-8,2014-03-06
UC-Davis,UC-Riverside,65,78,1,-13,2014-03-06
Hawaii,UCSB,77,86,1,-9,2014-03-06
Idaho,Chicago State,79,76,0,3,2014-03-06
Memphis,Cincinnati,84,97,1,-13,2014-03-06
Butler,DePaul,79,46,0,33,2014-03-06
Evansville,Drake,69,61,0,8,2014-03-06
Southeast Missouri State,Eastern Kentucky,76,84,1,-8,2014-03-06
Idaho State,Eastern Washington,69,77,1,-8,2014-03-06
St. Peter's,Fairfield,65,62,0,3,2014-03-06
Bethune-Cookman,Florida A&M,70,68,0,2,2014-03-06
Florida International,Florida Atlantic,74,70,0,4,2014-03-06
ETSU,Florida Gulf Coast,64,69,1,-5,2014-03-06
North Carolina A&T,Hampton,71,89,1,-18,2014-03-06
Nicholls State,Houston Baptist,75,62,0,13,2014-03-06
Morgan State,Howard,68,66,0,2,2014-03-06
George Mason,La Salle,59,57,0,2,2014-03-06
New Orleans,Lamar,72,89,1,-17,2014-03-06
Portland,Loyola Marymount,64,67,1,-3,2014-03-06
Niagara,Marist,78,76,0,2,2014-03-06
Charlotte,Marshall,74,70,0,4,2014-03-06
Delaware State,Maryland-Eastern Shore,70,84,1,-14,2014-03-06
USC Upstate,Mercer,75,78,1,-3,2014-03-06
Iowa,Michigan State,76,86,1,-10,2014-03-06
Seattle,UMKC,73,82,1,-9,2014-03-06
Rider,Monmouth,71,60,0,11,2014-03-06
Tennessee Tech,Morehead State,61,76,1,-15,2014-03-06
Grand Canyon,New Mexico State,57,81,1,-24,2014-03-06
North Carolina Central,Norfolk State,76,70,0,6,2014-03-06
Tulsa,North Texas,79,68,0,11,2014-03-06
Montana State,Northern Arizona,48,61,1,-13,2014-03-06
Penn State,Northwestern,59,32,0,27,2014-03-06
Central Arkansas,Northwestern State,102,119,1,-17,2014-03-06
East Carolina,Old Dominion,47,68,1,-21,2014-03-06
Santa Clara,Pacific,81,64,0,17,2014-03-06
Weber State,Portland State,59,66,1,-7,2014-03-06
Louisiana Tech,Rice,70,48,0,22,2014-03-06
VCU,Richmond,56,50,0,6,2014-03-06
Montana,Sacramento State,70,55,0,15,2014-03-06
Southeastern Louisiana,Sam Houston State,54,71,1,-17,2014-03-06
South Carolina State,Savannah State,50,69,1,-19,2014-03-06
Texas State,South Alabama,53,63,1,-10,2014-03-06
Prairie View,Southern,59,91,1,-32,2014-03-06
North Dakota,Southern Utah,71,77,1,-6,2014-03-06
Oral Roberts,Stephen F. Austin,72,83,1,-11,2014-03-06
McNeese State,Texas A&M-Corpus Christi,51,67,1,-16,2014-03-06
UTEP,UTSA,61,51,0,10,2014-03-06
Texas-Arlington,Troy,87,86,0,1,2014-03-06
Southern Miss,Tulane,68,51,0,17,2014-03-06
LSU,Vanderbilt,57,51,0,6,2014-03-06
UCLA,Washington,91,82,0,9,2014-03-06
USC,Washington State,79,68,0,11,2014-03-06
Louisiana,Western Kentucky,72,75,1,-3,2014-03-06
Villanova,Xavier,77,70,0,7,2014-03-06
Kent State,Akron,54,58,1,-4,2014-03-07
Samford,Appalachian State,70,56,0,14,2014-03-07
Morehead State,Belmont,63,86,1,-23,2014-03-07
Dartmouth,Brown,75,68,0,7,2014-03-07
Houston,UCF,83,104,1,-21,2014-03-07
Western Michigan,Central Michigan,78,64,0,14,2014-03-07
UNC Greensboro,Citadel,76,86,1,-10,2014-03-07
Charleston Southern,Coastal Carolina,68,73,1,-5,2014-03-07
Penn,Columbia,55,74,1,-19,2014-03-07
Princeton,Cornell,91,51,0,40,2014-03-07
Murray State,Eastern Kentucky,83,86,1,-3,2014-03-07
Wichita State,Evansville,80,58,0,22,2014-03-07
Georgia Southern,Furman,65,50,0,15,2014-03-07
VMI,Gardner-Webb,90,77,0,13,2014-03-07
Winthrop,High Point,62,60,0,2,2014-03-07
UNC Wilmington,Hofstra,70,78,1,-8,2014-03-07
Missouri State,Illinois State,53,48,0,5,2014-03-07
Loyola (IL),Indiana State,62,75,1,-13,2014-03-07
Valparaiso,Milwaukee,57,74,1,-17,2014-03-07
Radford,UNC Asheville,87,96,1,-9,2014-03-07
Southern Illinois,Northern Iowa,63,58,0,5,2014-03-07
Wright State,Oakland,73,57,0,16,2014-03-07
Cal State Bakersfield,Utah Valley,55,64,1,-9,2014-03-07
Harvard,Yale,70,58,0,12,2014-03-07
Incarnate Word,Abilene Christian,59,56,0,3,2014-03-08
Boise State,Air Force,61,64,1,-3,2014-03-08
Arkansas,Alabama,58,83,1,-25,2014-03-08
Grambling,Alabama A&M,63,80,1,-17,2014-03-08
Jackson State,Alabama State,63,67,1,-4,2014-03-08
UMBC,Albany (NY),56,86,1,-30,2014-03-08
Prairie View,Alcorn State,62,64,1,-2,2014-03-08
Holy Cross,American,46,57,1,-11,2014-03-08
Louisiana-Monroe,Little Rock,66,65,0,1,2014-03-08
Mississippi Valley State,Arkansas-Pine Bluff,68,83,1,-15,2014-03-08
Louisiana,Arkansas State,77,76,0,1,2014-03-08
Eastern Kentucky,Belmont,79,73,0,6,2014-03-08
Hartford,Binghamton,69,42,0,27,2014-03-08
Army,Boston University,70,91,1,-21,2014-03-08
Loyola Marymount,BYU,74,85,1,-11,2014-03-08
Harvard,Brown,98,93,0,5,2014-03-08
Bowling Green State,Buffalo,65,88,1,-23,2014-03-08
Seton Hall,Butler,54,71,1,-17,2014-03-08
UCSB,Cal Poly,71,55,0,16,2014-03-08
Colorado,California,65,66,1,-1,2014-03-08
UC-Davis,UC-Irvine,46,74,1,-28,2014-03-08
Siena,Canisius,65,71,1,-6,2014-03-08
Georgia Southern,Chattanooga,62,55,0,7,2014-03-08
Seattle,Chicago State,53,67,1,-14,2014-03-08
Wofford,Citadel,68,51,0,17,2014-03-08
Pitt,Clemson,83,78,0,5,2014-03-08
Wright State,Cleveland State,68,63,0,5,2014-03-08
VMI,Coastal Carolina,62,66,1,-4,2014-03-08
William & Mary,College of Charleston,70,59,0,11,2014-03-08
Princeton,Columbia,74,64,0,10,2014-03-08
Penn,Cornell,69,65,0,4,2014-03-08
Providence,Creighton,73,88,1,-15,2014-03-08
Samford,Davidson,54,77,1,-23,2014-03-08
Richmond,Dayton,48,60,1,-12,2014-03-08
Hofstra,Delaware,76,87,1,-11,2014-03-08
Northeastern,Drexel,90,81,0,9,2014-03-08
UNC,Duke,81,93,1,-12,2014-03-08
Weber State,Eastern Washington,82,78,0,4,2014-03-08
Western Carolina,Elon,66,64,0,2,2014-03-08
Kentucky,Florida,65,84,1,-19,2014-03-08
George Washington,Fordham,70,67,0,3,2014-03-08
Duquesne,George Mason,81,69,0,12,2014-03-08
Western Kentucky,Georgia State,55,73,1,-18,2014-03-08
Virginia Tech,Georgia Tech,51,62,1,-11,2014-03-08
Santa Clara,Gonzaga,75,77,1,-2,2014-03-08
Milwaukee,Green Bay,73,66,0,7,2014-03-08
Cal State Fullerton,Hawaii,77,81,1,-4,2014-03-08
McNeese State,Houston Baptist,79,77,0,2,2014-03-08
Southern Illinois,Indiana State,59,62,1,-3,2014-03-08
Rider,Iona,71,94,1,-23,2014-03-08
Illinois,Iowa,66,63,0,3,2014-03-08
Oklahoma State,Iowa State,81,85,1,-4,2014-03-08
IUPUI,Purdue-Fort Wayne,47,85,1,-38,2014-03-08
Towson,James Madison,80,71,0,9,2014-03-08
Baylor,Kansas State,76,74,0,2,2014-03-08
Southeastern Louisiana,Lamar,71,62,0,9,2014-03-08
UC-Riverside,Long Beach State,67,74,1,-7,2014-03-08
Georgia,LSU,69,61,0,8,2014-03-08
UConn,Louisville,48,81,1,-33,2014-03-08
Stony Brook,Maine,80,54,0,26,2014-03-08
St. Peter's,Manhattan,58,72,1,-14,2014-03-08
St. John's (NY),Marquette,91,90,0,1,2014-03-08
SMU,Memphis,58,67,1,-9,2014-03-08
Wake Forest,Miami (FL),56,69,1,-13,2014-03-08
Ohio,Miami (OH),82,76,0,6,2014-03-08
Indiana,Michigan,80,84,1,-4,2014-03-08
Vanderbilt,Ole Miss,62,65,1,-3,2014-03-08
South Carolina,Mississippi State,74,62,0,12,2014-03-08
Idaho,UMKC,87,80,0,7,2014-03-08
Wichita State,Missouri State,67,42,0,25,2014-03-08
UNLV,Nevada,72,76,1,-4,2014-03-08
Vermont,New Hampshire,77,60,0,17,2014-03-08
Quinnipiac,Niagara,89,80,0,9,2014-03-08
Winthrop,UNC Asheville,80,79,0,1,2014-03-08
Montana,Northern Arizona,47,67,1,-20,2014-03-08
Ball State,Northern Illinois,56,70,1,-14,2014-03-08
Oral Roberts,Northwestern State,82,88,1,-6,2014-03-08
Arizona,Oregon,57,64,1,-7,2014-03-08
Arizona State,Oregon State,76,78,1,-2,2014-03-08
Saint Mary's,Pepperdine,80,69,0,11,2014-03-08
Idaho State,Portland State,74,78,1,-4,2014-03-08
Saint Francis (PA),Robert Morris,57,60,1,-3,2014-03-08
Cincinnati,Rutgers,70,66,0,4,2014-03-08
Montana State,Sacramento State,59,84,1,-25,2014-03-08
New Orleans,Sam Houston State,61,80,1,-19,2014-03-08
San Francisco,San Diego,69,60,0,9,2014-03-08
New Mexico,San Diego State,48,51,1,-3,2014-03-08
Fresno State,San Jose State,69,56,0,13,2014-03-08
Texas-Arlington,South Alabama,73,78,1,-5,2014-03-08
Temple,South Florida,66,65,0,1,2014-03-08
Texas Southern,Southern,67,64,0,3,2014-03-08
Northern Colorado,Southern Utah,77,52,0,25,2014-03-08
Utah,Stanford,60,61,1,-1,2014-03-08
Central Arkansas,Stephen F. Austin,61,85,1,-24,2014-03-08
Missouri,Tennessee,45,72,1,-27,2014-03-08
Auburn,Texas A&M,69,64,0,5,2014-03-08
Nicholls State,Texas A&M-Corpus Christi,44,58,1,-14,2014-03-08
Oklahoma,TCU,97,67,0,30,2014-03-08
Grand Canyon,Texas-Rio Grande Valley,79,78,0,1,2014-03-08
Texas,Texas Tech,53,59,1,-6,2014-03-08
Eastern Michigan,Toledo,66,77,1,-11,2014-03-08
Texas State,Troy,50,72,1,-22,2014-03-08
Georgetown,Villanova,59,77,1,-18,2014-03-08
St. Bonaventure,VCU,67,86,1,-19,2014-03-08
Mount St. Mary's,Wagner,77,72,0,5,2014-03-08
USC,Washington,75,82,1,-7,2014-03-08
UCLA,Washington State,55,73,1,-18,2014-03-08
Kansas,West Virginia,86,92,1,-6,2014-03-08
Colorado State,Wyoming,75,83,1,-8,2014-03-08
Dartmouth,Yale,69,61,0,8,2014-03-08
Vermont,Albany (NY),58,67,1,-9,2014-03-09
Iona,Canisius,75,72,0,3,2014-03-09
Winthrop,Coastal Carolina,61,76,1,-15,2014-03-09
Western Carolina,Davidson,99,97,0,2,2014-03-09
Northeastern,Delaware,74,87,1,-13,2014-03-09
South Dakota,Denver,55,71,1,-16,2014-03-09
Mercer,Florida Gulf Coast,68,60,0,8,2014-03-09
Syracuse,Florida State,74,58,0,16,2014-03-09
Wofford,Georgia Southern,71,57,0,14,2014-03-09
Stony Brook,Hartford,69,64,0,5,2014-03-09
Wichita State,Indiana State,83,69,0,14,2014-03-09
Quinnipiac,Manhattan,68,87,1,-19,2014-03-09
Virginia,Maryland,69,75,1,-6,2014-03-09
Saint Louis,UMass,64,62,0,2,2014-03-09
Penn State,Minnesota,63,81,1,-18,2014-03-09
Wisconsin,Nebraska,68,77,1,-9,2014-03-09
Boston College,NC State,68,78,1,-10,2014-03-09
Michigan State,Ohio State,67,69,1,-2,2014-03-09
Northwestern,Purdue,74,65,0,9,2014-03-09
La Salle,St. Joseph's,71,63,0,8,2014-03-09
Western Illinois,South Dakota State,50,71,1,-21,2014-03-09
William & Mary,Towson,75,71,0,4,2014-03-09
San Francisco,BYU,77,79,1,-2,2014-03-10
William & Mary,Delaware,74,75,1,-1,2014-03-10
North Dakota State,Denver,83,48,0,35,2014-03-10
Central Michigan,Eastern Michigan,60,72,1,-12,2014-03-10
Saint Mary's,Gonzaga,54,70,1,-16,2014-03-10
Manhattan,Iona,71,68,0,3,2014-03-10
South Dakota State,Purdue-Fort Wayne,60,64,1,-4,2014-03-10
Norfolk State,Maryland-Eastern Shore,78,74,0,4,2014-03-10
Kent State,Miami (OH),64,71,1,-7,2014-03-10
Bowling Green State,Northern Illinois,51,54,1,-3,2014-03-10
Ball State,Ohio,64,76,1,-12,2014-03-10
South Carolina State,Savannah State,47,61,1,-14,2014-03-10
Wofford,Western Carolina,56,53,0,3,2014-03-10
Coppin State,Bethune-Cookman,75,68,0,7,2014-03-11
Gonzaga,BYU,75,64,0,11,2014-03-11
Florida A&M,Delaware State,65,61,0,4,2014-03-11
UTSA,East Carolina,76,79,1,-3,2014-03-11
Marshall,Florida Atlantic,63,59,0,4,2014-03-11
Jackson State,Grambling,75,84,1,-9,2014-03-11
North Carolina A&T,Howard,47,53,1,-6,2014-03-11
North Dakota State,Purdue-Fort Wayne,60,57,0,3,2014-03-11
Prairie View,Mississippi Valley State,79,63,0,16,2014-03-11
Rice,North Texas,62,63,1,-1,2014-03-11
Penn,Princeton,65,70,1,-5,2014-03-11
Mount St. Mary's,Robert Morris,88,71,0,17,2014-03-11
Milwaukee,Wright State,69,63,0,6,2014-03-11
Fresno State,Air Force,61,59,0,2,2014-03-12
Charlotte,Alabama-Birmingham,80,70,0,10,2014-03-12
South Carolina,Auburn,74,56,0,18,2014-03-12
TCU,Baylor,68,76,1,-8,2014-03-12
San Jose State,Boise State,52,83,1,-31,2014-03-12
Georgia Tech,Boston College,73,70,0,3,2014-03-12
American,Boston University,55,36,0,19,2014-03-12
Seton Hall,Butler,51,50,0,1,2014-03-12
Temple,UCF,90,94,1,-4,2014-03-12
USC,Colorado,56,59,1,-3,2014-03-12
Utah State,Colorado State,73,69,0,4,2014-03-12
Hampton,Coppin State,77,83,1,-6,2014-03-12
Georgetown,DePaul,56,60,1,-4,2014-03-12
Northern Illinois,Eastern Michigan,48,53,1,-5,2014-03-12
George Mason,Fordham,67,70,1,-3,2014-03-12
Texas Southern,Grambling,79,54,0,25,2014-03-12
North Carolina Central,Howard,92,46,0,46,2014-03-12
Old Dominion,Marshall,73,58,0,15,2014-03-12
Oral Roberts,McNeese State,66,62,0,4,2014-03-12
Virginia Tech,Miami (FL),53,57,1,-4,2014-03-12
Ohio,Miami (OH),63,55,0,8,2014-03-12
Vanderbilt,Mississippi State,68,82,1,-14,2014-03-12
Southeastern Louisiana,Nicholls State,64,71,1,-7,2014-03-12
Tulane,North Texas,66,61,0,5,2014-03-12
Wake Forest,Notre Dame,81,69,0,12,2014-03-12
Texas Tech,Oklahoma State,62,80,1,-18,2014-03-12
Oregon State,Oregon,74,88,1,-14,2014-03-12
Southern,Prairie View,46,64,1,-18,2014-03-12
South Florida,Rutgers,68,72,1,-4,2014-03-12
Washington State,Stanford,63,74,1,-11,2014-03-12
East Carolina,UTEP,68,77,1,-9,2014-03-12
Washington,Utah,61,67,1,-6,2014-03-12
Ohio,Akron,77,83,1,-6,2014-03-13
LSU,Alabama,68,56,0,12,2014-03-13
Arkansas-Pine Bluff,Alabama A&M,50,69,1,-19,2014-03-13
Alcorn State,Alabama State,51,64,1,-13,2014-03-13
Utah,Arizona,39,71,1,-32,2014-03-13
Stanford,Arizona State,79,58,0,21,2014-03-13
South Carolina,Arkansas,71,69,0,2,2014-03-13
Troy,Little Rock,61,74,1,-13,2014-03-13
Oklahoma,Baylor,73,78,1,-5,2014-03-13
Nevada,Boise State,62,75,1,-13,2014-03-13
Eastern Michigan,Buffalo,69,64,0,5,2014-03-13
UCSB,Cal Poly,38,69,1,-31,2014-03-13
Chicago State,Cal State Bakersfield,62,68,1,-6,2014-03-13
Long Beach State,Cal State Fullerton,66,56,0,10,2014-03-13
Hawaii,Cal State Northridge,84,87,1,-3,2014-03-13
Colorado,California,59,56,0,3,2014-03-13
UC-Riverside,UC-Irvine,43,63,1,-20,2014-03-13
Cincinnati,UCF,61,58,0,3,2014-03-13
Louisiana Tech,Charlotte,86,65,0,21,2014-03-13
Georgia Tech,Clemson,65,69,1,-4,2014-03-13
Memphis,UConn,53,72,1,-19,2014-03-13
DePaul,Creighton,62,84,1,-22,2014-03-13
Fordham,Dayton,74,87,1,-13,2014-03-13
Richmond,Duquesne,76,64,0,12,2014-03-13
Morgan State,Florida A&M,81,68,0,13,2014-03-13
Maryland,Florida State,65,67,1,-2,2014-03-13
New Mexico,Fresno State,93,77,0,16,2014-03-13
SMU,Houston,64,68,1,-4,2014-03-13
UMKC,Idaho,70,73,1,-3,2014-03-13
Indiana,Illinois,54,64,1,-10,2014-03-13
Northwestern,Iowa,67,62,0,5,2014-03-13
Kansas State,Iowa State,85,91,1,-6,2014-03-13
Oklahoma State,Kansas,70,77,1,-7,2014-03-13
St. Bonaventure,La Salle,82,72,0,10,2014-03-13
Texas-Arlington,Louisiana-Monroe,68,65,0,3,2014-03-13
Rutgers,Louisville,31,92,1,-61,2014-03-13
Xavier,Marquette,68,65,0,3,2014-03-13
Rhode Island,UMass,61,65,1,-4,2014-03-13
NC State,Miami (FL),67,58,0,9,2014-03-13
Old Dominion,Middle Tennessee,48,62,1,-14,2014-03-13
Penn State,Minnesota,56,63,1,-7,2014-03-13
Mississippi State,Ole Miss,66,78,1,-12,2014-03-13
Texas A&M,Missouri,83,91,1,-8,2014-03-13
Portland State,Montana,70,63,0,7,2014-03-13
Wyoming,UNLV,67,71,1,-4,2014-03-13
Seattle,New Mexico State,68,70,1,-2,2014-03-13
Northwestern State,Nicholls State,88,72,0,16,2014-03-13
Savannah State,Norfolk State,47,57,1,-10,2014-03-13
Sacramento State,North Dakota,76,79,1,-3,2014-03-13
Northern Colorado,Northern Arizona,62,60,0,2,2014-03-13
Purdue,Ohio State,61,63,1,-2,2014-03-13
Sam Houston State,Oral Roberts,70,61,0,9,2014-03-13
UCLA,Oregon,82,63,0,19,2014-03-13
Wake Forest,Pitt,55,84,1,-29,2014-03-13
St. John's (NY),Providence,74,79,1,-5,2014-03-13
Utah State,San Diego State,39,73,1,-34,2014-03-13
Villanova,Seton Hall,63,64,1,-1,2014-03-13
UTEP,Southern Miss,56,64,1,-8,2014-03-13
West Virginia,Texas,49,66,1,-17,2014-03-13
Utah Valley,Texas-Rio Grande Valley,83,63,0,20,2014-03-13
Tulsa,Tulane,70,49,0,21,2014-03-13
Western Michigan,Akron,64,60,0,4,2014-03-14
Prairie View,Alabama A&M,55,49,0,6,2014-03-14
Texas Southern,Alabama State,73,61,0,12,2014-03-14
Colorado,Arizona,43,63,1,-20,2014-03-14
Arkansas State,Little Rock,116,114,0,2,2014-03-14
Texas,Baylor,69,86,1,-17,2014-03-14
New Mexico,Boise State,70,67,0,3,2014-03-14
UC-Irvine,Cal Poly,58,61,1,-3,2014-03-14
New Mexico State,Cal State Bakersfield,69,63,0,6,2014-03-14
Long Beach State,Cal State Northridge,77,82,1,-5,2014-03-14
UConn,Cincinnati,58,56,0,2,2014-03-14
Duke,Clemson,63,62,0,1,2014-03-14
Morgan State,Coppin State,79,64,0,15,2014-03-14
Xavier,Creighton,78,86,1,-8,2014-03-14
St. Joseph's,Dayton,70,67,0,3,2014-03-14
Toledo,Eastern Michigan,59,44,0,15,2014-03-14
Missouri,Florida,49,72,1,-23,2014-03-14
Virginia,Florida State,64,51,0,13,2014-03-14
UMass,George Washington,77,85,1,-8,2014-03-14
Ole Miss,Georgia,73,75,1,-2,2014-03-14
Louisville,Houston,94,65,0,29,2014-03-14
Utah Valley,Idaho,69,74,1,-5,2014-03-14
Michigan,Illinois,64,63,0,1,2014-03-14
Kansas,Iowa State,83,94,1,-11,2014-03-14
LSU,Kentucky,67,85,1,-18,2014-03-14
Texas-Arlington,Louisiana,85,91,1,-6,2014-03-14
Southern Miss,Louisiana Tech,70,88,1,-18,2014-03-14
Northwestern,Michigan State,51,67,1,-16,2014-03-14
Tulsa,Middle Tennessee,76,69,0,7,2014-03-14
Wisconsin,Minnesota,83,57,0,26,2014-03-14
Ohio State,Nebraska,71,67,0,4,2014-03-14
San Diego State,UNLV,59,51,0,8,2014-03-14
North Carolina Central,Norfolk State,68,45,0,23,2014-03-14
Pitt,UNC,80,75,0,5,2014-03-14
Syracuse,NC State,63,66,1,-3,2014-03-14
Portland State,North Dakota,63,79,1,-16,2014-03-14
Stephen F. Austin,Northwestern State,85,78,0,7,2014-03-14
Seton Hall,Providence,74,80,1,-6,2014-03-14
VCU,Richmond,71,53,0,18,2014-03-14
St. Bonaventure,Saint Louis,71,68,0,3,2014-03-14
Texas A&M-Corpus Christi,Sam Houston State,63,69,1,-6,2014-03-14
Tennessee,South Carolina,59,44,0,15,2014-03-14
UCLA,Stanford,84,59,0,25,2014-03-14
Northern Colorado,Weber State,63,66,1,-3,2014-03-14
UCLA,Arizona,75,71,0,4,2014-03-15
Georgia State,Arkansas State,72,45,0,27,2014-03-15
Iowa State,Baylor,74,65,0,9,2014-03-15
Cal State Northridge,Cal Poly,59,61,1,-2,2014-03-15
Louisville,UConn,71,61,0,10,2014-03-15
Providence,Creighton,65,58,0,7,2014-03-15
NC State,Duke,67,75,1,-8,2014-03-15
Tennessee,Florida,49,56,1,-7,2014-03-15
VCU,George Washington,74,55,0,19,2014-03-15
Kentucky,Georgia,70,58,0,12,2014-03-15
New Mexico State,Idaho,77,55,0,22,2014-03-15
Western Kentucky,Louisiana,72,73,1,-1,2014-03-15
Tulsa,Louisiana Tech,69,60,0,9,2014-03-15
Ohio State,Michigan,69,72,1,-3,2014-03-15
Wisconsin,Michigan State,75,83,1,-8,2014-03-15
North Carolina Central,Morgan State,71,62,0,9,2014-03-15
San Diego State,New Mexico,58,64,1,-6,2014-03-15
Weber State,North Dakota,88,67,0,21,2014-03-15
Virginia,Pitt,51,48,0,3,2014-03-15
Texas Southern,Prairie View,78,73,0,5,2014-03-15
St. Bonaventure,St. Joseph's,48,67,1,-19,2014-03-15
Stephen F. Austin,Sam Houston State,68,49,0,19,2014-03-15
Albany (NY),Stony Brook,69,60,0,9,2014-03-15
Western Michigan,Toledo,98,77,0,21,2014-03-15
Virginia,Duke,72,63,0,9,2014-03-16
Kentucky,Florida,60,61,1,-1,2014-03-16
Louisiana,Georgia State,82,81,0,1,2014-03-16
Michigan State,Michigan,69,55,0,14,2014-03-16
VCU,St. Joseph's,61,65,1,-4,2014-03-16
Holy Cross,Brown,68,65,0,3,2014-03-17
Mount St. Mary's,Albany (NY),64,71,1,-7,2014-03-18
Indiana State,Arkansas,71,91,1,-20,2014-03-18
VMI,Canisius,111,100,0,11,2014-03-18
Georgia State,Clemson,66,78,1,-12,2014-03-18
Wright State,East Carolina,73,59,0,14,2014-03-18
Chattanooga,ETSU,66,79,1,-13,2014-03-18
Norfolk State,Eastern Michigan,54,58,1,-4,2014-03-18
Florida Gulf Coast,Florida State,53,58,1,-5,2014-03-18
West Virginia,Georgetown,65,77,1,-12,2014-03-18
Belmont,Green Bay,80,65,0,15,2014-03-18
High Point,Minnesota,81,88,1,-7,2014-03-18
Davidson,Missouri,77,85,1,-8,2014-03-18
Xavier,NC State,59,74,1,-15,2014-03-18
Utah,Saint Mary's,58,70,1,-12,2014-03-18
Alabama State,Sam Houston State,49,71,1,-22,2014-03-18
Portland State,San Diego,65,87,1,-22,2014-03-18
Stony Brook,Siena,55,66,1,-11,2014-03-18
Robert Morris,St. John's (NY),89,78,0,11,2014-03-18
Columbia,Valparaiso,58,56,0,2,2014-03-18
Illinois,Boston University,66,62,0,4,2014-03-19
Texas Southern,Cal Poly,69,81,1,-12,2014-03-19
Utah Valley,California,64,77,1,-13,2014-03-19
Vermont,Georgia,56,63,1,-7,2014-03-19
Pacific,Grand Canyon,69,67,0,2,2014-03-19
Morehead State,Illinois State,67,77,1,-10,2014-03-19
Tennessee,Iowa,78,65,0,13,2014-03-19
Akron,Purdue-Fort Wayne,91,97,1,-6,2014-03-19
Iona,Louisiana Tech,88,89,1,-1,2014-03-19
Murray State,Missouri State,66,63,0,3,2014-03-19
North Dakota,Omaha,75,91,1,-16,2014-03-19
Texas A&M-Corpus Christi,Northern Colorado,82,71,0,11,2014-03-19
Cleveland State,Ohio,62,64,1,-2,2014-03-19
South Dakota State,Old Dominion,65,72,1,-7,2014-03-19
Radford,Oregon State,96,92,0,4,2014-03-19
Hampton,Penn State,65,69,1,-4,2014-03-19
LSU,San Francisco,71,63,0,8,2014-03-19
Towson,USC Upstate,63,60,0,3,2014-03-19
UC-Irvine,SMU,54,68,1,-14,2014-03-19
Toledo,Southern Miss,59,66,1,-7,2014-03-19
Wyoming,Texas A&M,43,59,1,-16,2014-03-19
Fresno State,UTEP,61,56,0,5,2014-03-19
Princeton,Tulane,56,55,0,1,2014-03-19
Quinnipiac,Yale,68,69,1,-1,2014-03-19
Florida,Albany (NY),67,55,0,12,2014-03-20
Wisconsin,American,75,35,0,40,2014-03-20
Texas,Arizona State,87,85,0,2,2014-03-20
Oregon,BYU,87,68,0,19,2014-03-20
Harvard,Cincinnati,61,57,0,4,2014-03-20
Pitt,Colorado,77,48,0,29,2014-03-20
St. Joseph's,UConn,81,89,1,-8,2014-03-20
Ohio State,Dayton,59,60,1,-1,2014-03-20
Michigan State,Delaware,93,78,0,15,2014-03-20
Manhattan,Louisville,64,71,1,-7,2014-03-20
Wofford,Michigan,40,57,1,-17,2014-03-20
Villanova,Milwaukee,73,53,0,20,2014-03-20
San Diego State,New Mexico State,73,69,0,4,2014-03-20
Saint Louis,NC State,83,80,0,3,2014-03-20
Oklahoma,North Dakota State,75,80,1,-5,2014-03-20
Western Michigan,Syracuse,53,77,1,-24,2014-03-20
Weber State,Arizona,59,68,1,-9,2014-03-21
Nebraska,Baylor,60,74,1,-14,2014-03-21
Robert Morris,Belmont,71,82,1,-11,2014-03-21
Wichita State,Cal Poly,64,37,0,27,2014-03-21
Virginia,Coastal Carolina,70,59,0,11,2014-03-21
Louisiana,Creighton,66,76,1,-10,2014-03-21
Mercer,Duke,78,71,0,7,2014-03-21
Towson,ETSU,83,77,0,6,2014-03-21
Kansas,Eastern Kentucky,80,69,0,11,2014-03-21
Memphis,George Washington,71,66,0,5,2014-03-21
Oklahoma State,Gonzaga,77,85,1,-8,2014-03-21
North Carolina Central,Iowa State,75,93,1,-18,2014-03-21
Kentucky,Kansas State,56,49,0,7,2014-03-21
Tennessee,UMass,86,67,0,19,2014-03-21
Stanford,New Mexico,58,53,0,5,2014-03-21
Providence,UNC,77,79,1,-2,2014-03-21
VCU,Stephen F. Austin,75,77,1,-2,2014-03-21
UCLA,Tulsa,76,59,0,17,2014-03-21
Eastern Michigan,Columbia,56,69,1,-13,2014-03-22
Villanova,UConn,65,77,1,-12,2014-03-22
Syracuse,Dayton,53,55,1,-2,2014-03-22
Pitt,Florida,45,61,1,-16,2014-03-22
Louisiana Tech,Georgia,79,71,0,8,2014-03-22
Michigan State,Harvard,80,73,0,7,2014-03-22
Yale,Holy Cross,71,66,0,5,2014-03-22
Saint Louis,Louisville,51,66,1,-15,2014-03-22
Texas,Michigan,65,79,1,-14,2014-03-22
San Diego State,North Dakota State,63,44,0,19,2014-03-22
Wright State,Ohio,54,56,1,-2,2014-03-22
Wisconsin,Oregon,85,77,0,8,2014-03-22
Texas A&M-Corpus Christi,Pacific,60,89,1,-29,2014-03-22
San Diego,Sam Houston State,77,72,0,5,2014-03-22
Purdue-Fort Wayne,VMI,95,106,1,-11,2014-03-22
Gonzaga,Arizona,61,84,1,-23,2014-03-23
Creighton,Baylor,55,85,1,-30,2014-03-23
Illinois,Clemson,49,50,1,-1,2014-03-23
UNC,Iowa State,83,85,1,-2,2014-03-23
Stanford,Kansas,60,57,0,3,2014-03-23
Wichita State,Kentucky,76,78,1,-2,2014-03-23
Virginia,Memphis,78,60,0,18,2014-03-23
Tennessee,Mercer,83,63,0,20,2014-03-23
Saint Mary's,Minnesota,55,63,1,-8,2014-03-23
Southern Miss,Missouri,71,63,0,8,2014-03-23
UCLA,Stephen F. Austin,77,60,0,17,2014-03-23
Arkansas,California,64,75,1,-11,2014-03-24
Georgetown,Florida State,90,101,1,-11,2014-03-24
Princeton,Fresno State,56,72,1,-16,2014-03-24
Texas A&M,Illinois State,55,62,1,-7,2014-03-24
Omaha,Murray State,62,86,1,-24,2014-03-24
Radford,Old Dominion,59,82,1,-23,2014-03-24
Penn State,Siena,52,54,1,-2,2014-03-24
LSU,SMU,67,80,1,-13,2014-03-24
Belmont,Clemson,68,73,1,-5,2014-03-25
Southern Miss,Minnesota,73,81,1,-8,2014-03-25
Yale,Columbia,72,69,0,3,2014-03-26
Louisiana Tech,Florida State,75,78,1,-3,2014-03-26
Old Dominion,Fresno State,64,71,1,-7,2014-03-26
VMI,Ohio,92,90,0,2,2014-03-26
San Diego,Pacific,60,75,1,-15,2014-03-26
Illinois State,Siena,49,61,1,-12,2014-03-26
California,SMU,65,67,1,-2,2014-03-26
San Diego State,Arizona,64,70,1,-6,2014-03-27
Wisconsin,Baylor,69,52,0,17,2014-03-27
Stanford,Dayton,72,82,1,-10,2014-03-27
UCLA,Florida,68,79,1,-11,2014-03-27
Towson,Murray State,73,85,1,-12,2014-03-27
Iowa State,UConn,76,81,1,-5,2014-03-28
Louisville,Kentucky,69,74,1,-5,2014-03-28
Tennessee,Michigan,71,73,1,-2,2014-03-28
Virginia,Michigan State,59,61,1,-2,2014-03-28
Wisconsin,Arizona,64,63,0,1,2014-03-29
Florida,Dayton,62,52,0,10,2014-03-29
Michigan State,UConn,54,60,1,-6,2014-03-30
Michigan,Kentucky,72,75,1,-3,2014-03-30
Siena,Fresno State,61,57,0,4,2014-03-31
SMU,Clemson,65,59,0,6,2014-04-01
Minnesota,Florida State,67,64,0,3,2014-04-01
Pacific,Murray State,75,98,1,-23,2014-04-01
Yale,VMI,75,62,0,13,2014-04-01
Fresno State,Siena,89,75,0,14,2014-04-02
SMU,Minnesota,63,65,1,-2,2014-04-03
Yale,Murray State,57,65,1,-8,2014-04-03
Florida,UConn,53,63,1,-10,2014-04-05
Wisconsin,Kentucky,73,74,1,-1,2014-04-05
Fresno State,Siena,68,81,1,-13,2014-04-05
Kentucky,UConn,54,60,1,-6,2014-04-07
