Road,Home,Road_score,Home_score,Home_w,margin,Date
University of the Southwest,Abilene Christian,63,94,1,-31,2015-11-13
Kennesaw State,Alabama,64,77,1,-13,2015-11-13
Pacific,Arizona,61,79,1,-18,2015-11-13
Sacramento State,Arizona State,66,63,0,3,2015-11-13
Southern,Arkansas,68,86,1,-18,2015-11-13
Ferrum,Army,54,93,1,-39,2015-11-13
Alabama-Birmingham,Auburn,74,75,1,-1,2015-11-13
Stephen F. Austin,Baylor,55,97,1,-42,2015-11-13
Trinity (FL),Bethune-Cookman,54,108,1,-54,2015-11-13
Northeastern,Boston University,87,84,0,3,2015-11-13
Ball State,Bradley,53,54,1,-1,2015-11-13
Utah Valley,BYU,54,85,1,-31,2015-11-13
Shenandoah,Bucknell,61,107,1,-46,2015-11-13
Pittsburgh-Bradford,Buffalo,49,109,1,-60,2015-11-13
Rice,California,65,97,1,-32,2015-11-13
North Dakota State,UC-Davis,79,71,0,8,2015-11-13
UC-San Diego,UC-Irvine,73,89,1,-16,2015-11-13
Montreat,Campbell,42,87,1,-45,2015-11-13
Hartford,Central Connecticut,92,83,0,9,2015-11-13
Jacksonville State,Central Michigan,83,89,1,-6,2015-11-13
Elon,Charlotte,85,74,0,11,2015-11-13
Illinois Tech,Chicago State,59,137,1,-78,2015-11-13
Western Carolina,Cincinnati,72,97,1,-25,2015-11-13
North Carolina Central,Clemson,40,74,1,-34,2015-11-13
Nevada,Coastal Carolina,73,56,0,17,2015-11-13
South Carolina State,College of Charleston,54,74,1,-20,2015-11-13
Kean,Columbia,62,107,1,-45,2015-11-13
Maine,UConn,56,100,1,-44,2015-11-13
Southeast Missouri State,Dayton,53,84,1,-31,2015-11-13
Delaware,Delaware State,62,56,0,6,2015-11-13
Milwaukee,Denver,71,58,0,13,2015-11-13
Simpson,Drake,52,97,1,-45,2015-11-13
Siena,Duke,74,92,1,-18,2015-11-13
Seton Hill,Duquesne,71,96,1,-25,2015-11-13
Grambling,East Carolina,53,61,1,-8,2015-11-13
Coppin State,Eastern Kentucky,80,107,1,-27,2015-11-13
Vermont,Eastern Michigan,50,70,1,-20,2015-11-13
Johnson University,Florida A&M,71,103,1,-32,2015-11-13
Trinity Baptist,Florida International,39,71,1,-32,2015-11-13
Pepperdine,Fresno State,66,69,1,-3,2015-11-13
Presbyterian,Furman,53,63,1,-10,2015-11-13
Colgate,George Mason,66,53,0,13,2015-11-13
Lafayette,George Washington,76,85,1,-9,2015-11-13
Chattanooga,Georgia,92,90,0,2,2015-11-13
Webber,Georgia Southern,49,116,1,-67,2015-11-13
Middle Georgia State,Georgia State,54,73,1,-19,2015-11-13
Cornell,Georgia Tech,81,116,1,-35,2015-11-13
Portland State,Grand Canyon,72,82,1,-10,2015-11-13
MIT,Harvard,39,59,1,-20,2015-11-13
Montana State,Hawaii,76,87,1,-11,2015-11-13
Canisius,Hofstra,85,96,1,-11,2015-11-13
Great Falls,Idaho State,72,78,1,-6,2015-11-13
North Florida,Illinois,93,81,0,12,2015-11-13
San Francisco,UIC,78,75,0,3,2015-11-13
Texas Lutheran,Incarnate Word,65,86,1,-21,2015-11-13
Eastern Illinois,Indiana,49,88,1,-39,2015-11-13
IUPUI,Indiana State,72,70,0,2,2015-11-13
Gardner-Webb,Iowa,59,76,1,-17,2015-11-13
Colorado,Iowa State,62,68,1,-6,2015-11-13
Northern Colorado,Kansas,72,109,1,-37,2015-11-13
Maryland-Eastern Shore,Kansas State,53,80,1,-27,2015-11-13
Albany (NY),Kentucky,65,78,1,-13,2015-11-13
Austin College,Lamar,58,101,1,-43,2015-11-13
Covenant,Liberty,62,64,1,-2,2015-11-13
Randolph,Longwood,49,69,1,-20,2015-11-13
Louisiana College,Louisiana,68,108,1,-40,2015-11-13
McMurry,Louisiana-Monroe,43,88,1,-45,2015-11-13
McNeese State,LSU,70,81,1,-11,2015-11-13
Millsaps,Louisiana Tech,33,95,1,-62,2015-11-13
Samford,Louisville,45,86,1,-41,2015-11-13
UTSA,Loyola (IL),64,76,1,-12,2015-11-13
Cal State Fullerton,Loyola Marymount,74,79,1,-5,2015-11-13
Tennessee State,Loyola (MD),86,71,0,15,2015-11-13
Holy Cross,Marist,67,64,0,3,2015-11-13
Belmont,Marquette,83,80,0,3,2015-11-13
Mount St. Mary's,Maryland,56,80,1,-24,2015-11-13
Allen,Mercer,70,96,1,-26,2015-11-13
Texas-Rio Grande Valley,Miami (FL),59,86,1,-27,2015-11-13
Northern Michigan,Michigan,44,70,1,-26,2015-11-13
Florida Atlantic,Michigan State,55,82,1,-27,2015-11-13
UMKC,Minnesota,58,76,1,-18,2015-11-13
Northwestern State,Ole Miss,76,90,1,-14,2015-11-13
Eastern Washington,Mississippi State,88,106,1,-18,2015-11-13
Wofford,Missouri,74,83,1,-9,2015-11-13
Boise State,Montana,72,74,1,-2,2015-11-13
Cincinnati Christian,Morehead State,51,87,1,-36,2015-11-13
Harris-Stowe,Murray State,55,105,1,-50,2015-11-13
Florida,Navy,59,41,0,18,2015-11-13
UCSB,Omaha,60,59,0,1,2015-11-13
Cal Poly,UNLV,72,74,1,-2,2015-11-13
Lyndon State,New Hampshire,45,82,1,-37,2015-11-13
Texas Southern,New Mexico,57,86,1,-29,2015-11-13
Houston Baptist,New Mexico State,69,91,1,-22,2015-11-13
William & Mary,NC State,85,68,0,17,2015-11-13
Milligan,UNC Wilmington,62,100,1,-38,2015-11-13
Minnesota-Morris,North Dakota,69,99,1,-30,2015-11-13
Jarvis Christian,North Texas,82,112,1,-30,2015-11-13
Cal State Northridge,Northern Illinois,71,83,1,-12,2015-11-13
UMass-Lowell,Northwestern,57,79,1,-22,2015-11-13
Saint Francis (PA),Notre Dame,56,87,1,-31,2015-11-13
UT-Martin,Oklahoma State,57,91,1,-34,2015-11-13
Niagara,Old Dominion,50,67,1,-17,2015-11-13
Missouri State,Oral Roberts,65,80,1,-15,2015-11-13
Jackson State,Oregon,52,80,1,-28,2015-11-13
Robert Morris,Penn,75,76,1,-1,2015-11-13
Oregon Tech,Portland,81,98,1,-17,2015-11-13
North Carolina A&T,Purdue,40,81,1,-41,2015-11-13
American,Rhode Island,42,65,1,-23,2015-11-13
James Madison,Richmond,87,75,0,12,2015-11-13
Princeton,Rider,64,56,0,8,2015-11-13
Rutgers-Newark,Rutgers,59,72,1,-13,2015-11-13
Quinnipiac,Sacred Heart,64,76,1,-12,2015-11-13
Drexel,St. Joseph's,81,82,1,-1,2015-11-13
San Francisco State,Saint Mary's,56,80,1,-24,2015-11-13
Brown,St. Peter's,65,77,1,-12,2015-11-13
Illinois State,San Diego State,60,71,1,-11,2015-11-13
Lipscomb,Santa Clara,65,63,0,2,2015-11-13
Florida National University,Savannah State,69,87,1,-18,2015-11-13
Arkansas-Pine Bluff,Seattle,58,56,0,2,2015-11-13
Dartmouth,Seton Hall,67,84,1,-17,2015-11-13
Auburn Montgomery,South Alabama,68,88,1,-20,2015-11-13
Chadron State,South Dakota State,52,87,1,-35,2015-11-13
Troy,South Florida,82,77,0,5,2015-11-13
San Diego,USC,45,83,1,-38,2015-11-13
Air Force,Southern Illinois,75,77,1,-2,2015-11-13
Arkansas State,SIU-Edwardsville,70,79,1,-9,2015-11-13
Binghamton,St. Bonaventure,53,63,1,-10,2015-11-13
Wagner,St. John's (NY),57,66,1,-9,2015-11-13
Green Bay,Stanford,89,93,1,-4,2015-11-13
Lehigh,Syracuse,47,57,1,-10,2015-11-13
UNC,Temple,91,67,0,24,2015-11-13
UNC Asheville,Tennessee,78,82,1,-4,2015-11-13
USC Upstate,Texas A&M,64,104,1,-40,2015-11-13
Our Lady of the Lake,Texas A&M-Corpus Christi,72,94,1,-22,2015-11-13
Southeastern Louisiana,TCU,77,90,1,-13,2015-11-13
High Point,Texas Tech,73,77,1,-4,2015-11-13
Alabama A&M,Tulane,68,67,0,1,2015-11-13
Monmouth,UCLA,84,81,0,3,2015-11-13
Southern Utah,Utah,71,82,1,-11,2015-11-13
Purdue-Fort Wayne,Valparaiso,64,78,1,-14,2015-11-13
Austin Peay,Vanderbilt,41,80,1,-39,2015-11-13
Fairleigh Dickinson,Villanova,54,91,1,-37,2015-11-13
Morgan State,Virginia,48,86,1,-38,2015-11-13
Prairie View,VCU,50,75,1,-25,2015-11-13
UMBC,Wake Forest,73,78,1,-5,2015-11-13
Texas,Washington,71,77,1,-6,2015-11-13
Northern Arizona,Washington State,70,82,1,-12,2015-11-13
Utah State,Weber State,73,70,0,3,2015-11-13
Northern Kentucky,West Virginia,61,107,1,-46,2015-11-13
Charleston Southern,Wichita State,63,88,1,-25,2015-11-13
Western Illinois,Wisconsin,69,67,0,2,2015-11-13
South Dakota,Wright State,69,77,1,-8,2015-11-13
Bristol University,Wyoming,62,101,1,-39,2015-11-13
Miami (OH),Xavier,72,81,1,-9,2015-11-13
Fairfield,Yale,57,70,1,-13,2015-11-13
Cleveland State,Akron,53,65,1,-12,2015-11-14
Jacksonville,Appalachian State,68,76,1,-8,2015-11-14
Central Baptist,Little Rock,57,76,1,-19,2015-11-14
St. Francis (NY),Boston College,49,75,1,-26,2015-11-14
New Orleans,Bowling Green State,61,79,1,-18,2015-11-14
Citadel,Butler,71,144,1,-73,2015-11-14
San Diego Christian,Cal State Bakersfield,69,93,1,-24,2015-11-14
William Jessup,UC-Riverside,68,100,1,-32,2015-11-14
Texas Southern,Creighton,70,93,1,-23,2015-11-14
UCF,Davidson,85,90,1,-5,2015-11-14
Western Michigan,DePaul,63,69,1,-6,2015-11-14
Bryant,Duke,75,113,1,-38,2015-11-14
Averett,ETSU,59,107,1,-48,2015-11-14
Radford,Georgetown,82,80,0,2,2015-11-14
Youngstown State,Kent State,70,79,1,-9,2015-11-14
NJIT,Kentucky,57,87,1,-30,2015-11-14
Towson,La Salle,76,78,1,-2,2015-11-14
Summit,Liberty,52,90,1,-38,2015-11-14
Milwaukee,Lipscomb,71,65,0,6,2015-11-14
Brigham Young-Hawaii,Long Beach State,57,91,1,-34,2015-11-14
Eureka,Loyola (IL),51,84,1,-33,2015-11-14
Howard,UMass,79,85,1,-6,2015-11-14
Southern Miss,Memphis,49,67,1,-18,2015-11-14
Grambling,Mid-Atlantic Christian,85,26,0,59,2015-11-14
Hawaii-Hilo,Montana State,85,90,1,-5,2015-11-14
Mississippi Valley State,Nebraska,51,97,1,-46,2015-11-14
Greensboro,UNC Greensboro,69,86,1,-17,2015-11-14
South Dakota,Northern Illinois,65,72,1,-7,2015-11-14
Colorado State,Northern Iowa,84,78,0,6,2015-11-14
Florida Gulf Coast,Ohio,75,85,1,-10,2015-11-14
Northwest Christian,Oregon State,52,74,1,-22,2015-11-14
VMI,Penn State,50,62,1,-12,2015-11-14
Harvard,Providence,64,76,1,-12,2015-11-14
Idaho,San Jose State,74,54,0,20,2015-11-14
Denver,Santa Clara,55,33,0,22,2015-11-14
Norfolk State,South Carolina,69,84,1,-15,2015-11-14
Sam Houston State,SMU,50,85,1,-35,2015-11-14
Merchant Marine Academy,Stony Brook,32,103,1,-71,2015-11-14
Piedmont,Tennessee Tech,72,110,1,-38,2015-11-14
Fordham,Texas-Arlington,72,77,1,-5,2015-11-14
Loyola (LA),UTEP,49,96,1,-47,2015-11-14
West Virginia Tech,Toledo,65,96,1,-31,2015-11-14
Central Arkansas,Tulsa,81,98,1,-17,2015-11-14
Great Falls,Utah Valley,60,89,1,-29,2015-11-14
Alabama State,Virginia Tech,85,82,0,3,2015-11-14
Campbellsville,Western Kentucky,77,97,1,-20,2015-11-14
Hampton,Winthrop,95,102,1,-7,2015-11-14
Cal State Northridge,Wright State,72,67,0,5,2015-11-14
Army,Binghamton,75,60,0,15,2015-11-15
Wake Forest,Bucknell,90,82,0,8,2015-11-15
Portland,UC-Davis,66,79,1,-13,2015-11-15
Loyola Marymount,UC-Irvine,53,77,1,-24,2015-11-15
Robert Morris,Cincinnati,44,106,1,-62,2015-11-15
UTSA,Clemson,45,78,1,-33,2015-11-15
George Fox,Eastern Washington,64,126,1,-62,2015-11-15
Southeast Missouri State,Evansville,65,80,1,-15,2015-11-15
Nicholls State,Florida State,62,109,1,-47,2015-11-15
Coastal Carolina,Hawaii,63,74,1,-11,2015-11-15
North Carolina Wesleyan,High Point,69,93,1,-24,2015-11-15
North Dakota State,Illinois,74,80,1,-6,2015-11-15
Coppin State,Iowa,68,103,1,-35,2015-11-15
Fort Valley State,Jacksonville State,68,81,1,-13,2015-11-15
St. Peter's,Lafayette,86,87,1,-1,2015-11-15
Denver,Lipscomb,82,69,0,13,2015-11-15
Louisiana-Monroe,Minnesota,56,67,1,-11,2015-11-15
Maryland-Eastern Shore,Missouri,55,73,1,-18,2015-11-15
William Jewell,UMKC,59,73,1,-14,2015-11-15
Saint Mary's (MN),Omaha,58,104,1,-46,2015-11-15
Montana State,Nevada,62,83,1,-21,2015-11-15
New Mexico,New Mexico State,83,74,0,9,2015-11-15
Fairfield,UNC,65,92,1,-27,2015-11-15
South Alabama,NC State,70,88,1,-18,2015-11-15
Wright State,Northern Illinois,59,65,1,-6,2015-11-15
Mount St. Mary's,Ohio State,54,76,1,-22,2015-11-15
Central Connecticut,Penn,61,77,1,-16,2015-11-15
Vermont,Purdue,79,107,1,-28,2015-11-15
Stetson,Richmond,85,108,1,-23,2015-11-15
Howard,Rutgers,70,82,1,-12,2015-11-15
Niagara,St. Joseph's,62,73,1,-11,2015-11-15
Hartford,Saint Louis,68,85,1,-17,2015-11-15
Milwaukee,Santa Clara,71,65,0,6,2015-11-15
Sacramento State,Seattle,77,65,0,12,2015-11-15
Wagner,Seton Hall,59,69,1,-10,2015-11-15
Cal State Northridge,South Dakota,72,76,1,-4,2015-11-15
Florida A&M,Southern Illinois,51,81,1,-30,2015-11-15
Charleston Southern,Stanford,59,93,1,-34,2015-11-15
Reinhardt,Troy,82,97,1,-15,2015-11-15
Cal Poly,UCLA,83,88,1,-5,2015-11-15
Iona,Valparaiso,58,83,1,-25,2015-11-15
UNC Asheville,Western Carolina,81,90,1,-9,2015-11-15
Hannibal-LaGrange,Western Illinois,57,94,1,-37,2015-11-15
Siena,Wisconsin,65,92,1,-27,2015-11-15
Tennessee Tech,Air Force,70,80,1,-10,2015-11-16
Hiram,Akron,30,100,1,-70,2015-11-16
Alabama State,Alabama-Birmingham,70,72,1,-2,2015-11-16
Bradley,Arizona,60,90,1,-30,2015-11-16
Belmont,Arizona State,74,83,1,-9,2015-11-16
Lyon,Arkansas State,37,81,1,-44,2015-11-16
Eastern Illinois,Ball State,56,73,1,-17,2015-11-16
Northern Arizona,Boise State,81,101,1,-20,2015-11-16
Albany (NY),Boston University,64,69,1,-5,2015-11-16
Holy Cross,Brown,55,71,1,-16,2015-11-16
UCSB,California,67,85,1,-18,2015-11-16
Lehigh,Canisius,89,98,1,-9,2015-11-16
Hiwassee,Chattanooga,55,94,1,-39,2015-11-16
Cornell,Colgate,101,98,0,3,2015-11-16
Central State (OH),Detroit,65,88,1,-23,2015-11-16
New Orleans,Duquesne,75,95,1,-20,2015-11-16
Charlotte,East Carolina,74,88,1,-14,2015-11-16
Fairleigh Dickinson-Florham,Fairleigh Dickinson,70,111,1,-41,2015-11-16
North Carolina A&T,Florida,54,104,1,-50,2015-11-16
Texas Wesleyan,Florida Gulf Coast,62,85,1,-23,2015-11-16
Florida Memorial,Florida International,51,67,1,-16,2015-11-16
Lamar,Fresno State,72,80,1,-8,2015-11-16
Virginia,George Washington,68,73,1,-5,2015-11-16
Tennessee,Georgia Tech,67,69,1,-2,2015-11-16
Nevada,Hawaii,75,76,1,-1,2015-11-16
Molloy,Hofstra,64,96,1,-32,2015-11-16
Crowley's Ridge,Houston Baptist,62,102,1,-40,2015-11-16
Dickinson State (ND),Idaho State,85,110,1,-25,2015-11-16
Morehead State,Illinois State,66,67,1,-1,2015-11-16
Schreiner,Incarnate Word,49,73,1,-24,2015-11-16
Austin Peay,Indiana,76,102,1,-26,2015-11-16
Wyoming,Indiana State,55,70,1,-15,2015-11-16
Chicago State,Iowa State,64,106,1,-42,2015-11-16
Manchester,Purdue-Fort Wayne,53,85,1,-32,2015-11-16
Oakwood,Jacksonville State,60,96,1,-36,2015-11-16
Columbia,Kansas State,71,81,1,-10,2015-11-16
BYU,Long Beach State,65,66,1,-1,2015-11-16
La Roche,Longwood,65,89,1,-24,2015-11-16
Kennesaw State,LSU,69,91,1,-22,2015-11-16
LIU-Brooklyn,Loyola (MD),71,68,0,3,2015-11-16
IUPUI,Marquette,71,75,1,-4,2015-11-16
George Mason,Mercer,60,69,1,-9,2015-11-16
Louisiana,Miami (FL),77,93,1,-16,2015-11-16
Elon,Michigan,68,88,1,-20,2015-11-16
Georgia Southern,Ole Miss,72,82,1,-10,2015-11-16
Southern,Mississippi State,76,72,0,4,2015-11-16
College of Charleston,Navy,72,58,0,14,2015-11-16
New Mexico Highlands,UNLV,45,107,1,-62,2015-11-16
Allen,North Carolina Central,54,78,1,-24,2015-11-16
Eastern Kentucky,UNC Wilmington,59,78,1,-19,2015-11-16
Texas-Rio Grande Valley,North Florida,84,106,1,-22,2015-11-16
Texas College,North Texas,61,110,1,-49,2015-11-16
Louisiana State-Alexandria,Northwestern State,99,97,0,2,2015-11-16
Tennessee State,Ohio,67,75,1,-8,2015-11-16
Arkansas-Pine Bluff,Oklahoma State,72,86,1,-14,2015-11-16
Buffalo,Old Dominion,58,77,1,-19,2015-11-16
Baylor,Oregon,67,74,1,-7,2015-11-16
San Diego Christian,Pepperdine,49,91,1,-42,2015-11-16
Pacific Lutheran,Portland State,60,105,1,-45,2015-11-16
USC Upstate,Presbyterian,73,74,1,-1,2015-11-16
Manhattan,Saint Mary's,63,89,1,-26,2015-11-16
Auburn Montgomery,Samford,79,94,1,-15,2015-11-16
Rice,San Francisco,54,80,1,-26,2015-11-16
Montana,San Jose State,61,64,1,-3,2015-11-16
Campbell,Savannah State,57,59,1,-2,2015-11-16
Oral Roberts,South Carolina,66,84,1,-18,2015-11-16
Voorhees,South Carolina State,69,113,1,-44,2015-11-16
Weber State,South Dakota State,68,85,1,-17,2015-11-16
NJIT,South Florida,60,57,0,3,2015-11-16
Monmouth,USC,90,101,1,-11,2015-11-16
UMBC,St. John's (NY),53,75,1,-22,2015-11-16
Bethune-Cookman,UT-Martin,86,79,0,7,2015-11-16
Southeastern Louisiana,Texas A&M,58,100,1,-42,2015-11-16
Texas-Tyler,Texas State,49,84,1,-35,2015-11-16
Morgan State,Towson,61,69,1,-8,2015-11-16
Drake,Tulane,74,79,1,-5,2015-11-16
San Diego State,Utah,76,81,1,-5,2015-11-16
Gardner-Webb,Vanderbilt,62,98,1,-36,2015-11-16
Radford,VCU,74,92,1,-18,2015-11-16
James Madison,West Virginia,73,86,1,-13,2015-11-16
Sacred Heart,Yale,77,99,1,-22,2015-11-16
Howard Payne,Abilene Christian,56,70,1,-14,2015-11-17
Hampton,American,61,48,0,13,2015-11-17
Furman,Appalachian State,79,70,0,9,2015-11-17
Colorado,Auburn,91,84,0,7,2015-11-17
Idaho,Cal State Bakersfield,45,68,1,-23,2015-11-17
Alma,Central Michigan,64,79,1,-15,2015-11-17
Stetson,Citadel,93,94,1,-1,2015-11-17
Malone,Cleveland State,46,62,1,-16,2015-11-17
New Hampshire,UConn,66,85,1,-19,2015-11-17
UTSA,Creighton,78,103,1,-25,2015-11-17
Alabama,Dayton,48,80,1,-32,2015-11-17
Penn,Delaware State,60,54,0,6,2015-11-17
Kentucky,Duke,74,63,0,11,2015-11-17
Green Bay,ETSU,90,103,1,-13,2015-11-17
Marian,Evansville,59,84,1,-25,2015-11-17
Warner Southern,Florida Atlantic,75,72,0,3,2015-11-17
Jacksonville,Florida State,79,98,1,-19,2015-11-17
Queens (NY),Fordham,57,76,1,-19,2015-11-17
Black Hills State,Grand Canyon,72,88,1,-16,2015-11-17
UMass,Harvard,69,63,0,6,2015-11-17
Rider,La Salle,60,73,1,-13,2015-11-17
William & Mary,Liberty,70,59,0,11,2015-11-17
Oakland City,Lipscomb,69,96,1,-27,2015-11-17
Texas-Arlington,Louisiana Tech,68,80,1,-12,2015-11-17
Hartford,Louisville,52,87,1,-35,2015-11-17
Dartmouth,Marist,63,73,1,-10,2015-11-17
Georgetown,Maryland,71,75,1,-4,2015-11-17
Louisiana College,McNeese State,73,70,0,3,2015-11-17
Oklahoma,Memphis,84,78,0,6,2015-11-17
Kenyon,Miami (OH),47,68,1,-21,2015-11-17
Kansas,Michigan State,73,79,1,-6,2015-11-17
Middle Tennessee,Murray State,65,76,1,-11,2015-11-17
UMKC,Omaha,89,95,1,-6,2015-11-17
Washington Adventist,Norfolk State,58,78,1,-20,2015-11-17
Chowan,UNC Greensboro,60,81,1,-21,2015-11-17
Wentworth,Northeastern,62,91,1,-29,2015-11-17
Colorado Christian,Northern Colorado,70,85,1,-15,2015-11-17
Stephen F. Austin,Northern Iowa,60,70,1,-10,2015-11-17
Tiffin,Northern Kentucky,71,83,1,-12,2015-11-17
Milwaukee,Notre Dame,78,86,1,-8,2015-11-17
Grambling,Ohio State,55,82,1,-27,2015-11-17
Iona,Oregon State,73,93,1,-20,2015-11-17
Cal State Fullerton,Pacific,77,76,0,1,2015-11-17
DePaul,Penn State,62,68,1,-6,2015-11-17
Saint Joseph's (IN),Pitt,43,84,1,-41,2015-11-17
Valparaiso,Rhode Island,58,55,0,3,2015-11-17
Westminster,Saint Francis (PA),72,103,1,-31,2015-11-17
St. Thomas (TX),Sam Houston State,92,114,1,-22,2015-11-17
Jackson State,Southern Miss,78,60,0,18,2015-11-17
Mount Saint Vincent,St. Francis (NY),67,93,1,-26,2015-11-17
St. Bonaventure,Syracuse,66,79,1,-13,2015-11-17
Wichita State,Tulsa,67,77,1,-10,2015-11-17
Adams State,Utah State,68,83,1,-15,2015-11-17
Nebraska,Villanova,63,87,1,-24,2015-11-17
Tusculum,VMI,76,88,1,-12,2015-11-17
UIC,Western Illinois,57,84,1,-27,2015-11-17
San Diego,Western Michigan,62,74,1,-12,2015-11-17
Truett-McConnell,Winthrop,78,106,1,-28,2015-11-17
North Dakota,Wisconsin,64,78,1,-14,2015-11-17
Missouri,Xavier,66,78,1,-12,2015-11-17
Kennesaw State,Arizona State,53,91,1,-38,2015-11-18
Akron,Arkansas,88,80,0,8,2015-11-18
Centenary (LA),Little Rock,49,95,1,-46,2015-11-18
Purdue-Fort Wayne,Austin Peay,80,77,0,3,2015-11-18
Western Kentucky,Belmont,85,90,1,-5,2015-11-18
Cincinnati,Bowling Green State,83,50,0,33,2015-11-18
Emerson,Bryant,69,82,1,-13,2015-11-18
Cal State Monterey Bay,Cal Poly,62,71,1,-9,2015-11-18
Vanguard,Cal State Northridge,52,72,1,-20,2015-11-18
Fresno Pacific,UC-Davis,46,76,1,-30,2015-11-18
UC-Irvine,UCF,61,60,0,1,2015-11-18
Johnson & Wales (NC),Charleston Southern,65,97,1,-32,2015-11-18
Indiana-Northwest,Chicago State,64,105,1,-41,2015-11-18
Grace Bible,Coastal Carolina,67,104,1,-37,2015-11-18
Goldey-Beacom,Coppin State,73,80,1,-7,2015-11-18
Binghamton,Cornell,59,76,1,-17,2015-11-18
Utah Valley,Denver,62,75,1,-13,2015-11-18
High Point,Drexel,75,66,0,9,2015-11-18
Seattle,Eastern Washington,70,76,1,-6,2015-11-18
Belmont Abbey,Elon,57,84,1,-27,2015-11-18
Army,Fairleigh Dickinson,96,85,0,11,2015-11-18
Thomas University,Florida A&M,68,70,1,-2,2015-11-18
Northern Arizona,Gonzaga,52,91,1,-39,2015-11-18
Prairie View,Houston,69,110,1,-41,2015-11-18
Loyola (MD),UMBC,76,57,0,19,2015-11-18
Sacred Heart,UMass-Lowell,84,87,1,-3,2015-11-18
Southern Utah,UNLV,64,84,1,-20,2015-11-18
Loyola (IL),New Mexico,51,75,1,-24,2015-11-18
Tennessee Tech,New Mexico State,63,76,1,-13,2015-11-18
Brown,Niagara,66,75,1,-9,2015-11-18
Wofford,UNC,58,78,1,-20,2015-11-18
Mars Hill,UNC Asheville,51,84,1,-33,2015-11-18
Roanoke,North Carolina A&T,94,87,0,7,2015-11-18
IUPUI,NC State,56,79,1,-23,2015-11-18
Valley City State,North Dakota State,49,69,1,-20,2015-11-18
Edward Waters,North Florida,69,98,1,-29,2015-11-18
Fairfield,Northwestern,72,79,1,-7,2015-11-18
Eastern Michigan,Oakland,81,91,1,-10,2015-11-18
Morgan State,Old Dominion,48,79,1,-31,2015-11-18
Toccoa Falls,Presbyterian,75,116,1,-41,2015-11-18
Illinois,Providence,59,60,1,-1,2015-11-18
Incarnate Word,Purdue,61,96,1,-35,2015-11-18
Catawba,Radford,60,68,1,-8,2015-11-18
Bucknell,Robert Morris,81,76,0,5,2015-11-18
Buffalo,St. Joseph's,67,89,1,-22,2015-11-18
San Diego Christian,San Diego State,61,71,1,-10,2015-11-18
Arkansas State,Savannah State,75,76,1,-1,2015-11-18
Mississippi College,Southeastern Louisiana,69,76,1,-7,2015-11-18
Kent State,Southern Illinois,69,72,1,-3,2015-11-18
Saint Louis,SIU-Edwardsville,70,60,0,10,2015-11-18
Fisk,Tennessee State,50,72,1,-22,2015-11-18
Indiana-Kokomo,Valparaiso,40,78,1,-38,2015-11-18
Quinnipiac,Vermont,70,83,1,-13,2015-11-18
Jacksonville State,Virginia Tech,62,71,1,-9,2015-11-18
Richmond,Wake Forest,91,82,0,9,2015-11-18
Toledo,Youngstown State,100,78,0,22,2015-11-18
Mississippi Valley State,Air Force,64,65,1,-1,2015-11-19
Southeast Missouri State,Alabama A&M,56,74,1,-18,2015-11-19
Colgate,Albany (NY),67,88,1,-21,2015-11-19
Boise State,Arizona,76,88,1,-12,2015-11-19
Central Connecticut,Boston College,57,82,1,-25,2015-11-19
Virginia,Bradley,82,57,0,25,2015-11-19
Santa Clara,UC-Riverside,63,77,1,-14,2015-11-19
Furman,Charlotte,68,77,1,-9,2015-11-19
Mid-Atlantic Christian,Citadel,60,132,1,-72,2015-11-19
Texas Southern,Clemson,56,76,1,-20,2015-11-19
Loyola Marymount,Colorado State,75,83,1,-8,2015-11-19
San Francisco,Fresno State,71,78,1,-7,2015-11-19
Toccoa Falls,Gardner-Webb,79,125,1,-46,2015-11-19
Ole Miss,George Mason,62,68,1,-6,2015-11-19
Emmanuel,Georgia State,58,77,1,-19,2015-11-19
Green Bay,Georgia Tech,77,107,1,-30,2015-11-19
Alcorn State,Grand Canyon,46,79,1,-33,2015-11-19
New Hampshire,Holy Cross,73,69,0,4,2015-11-19
South Dakota State,Illinois State,83,67,0,16,2015-11-19
Creighton,Indiana,65,86,1,-21,2015-11-19
Yale,Lehigh,79,67,0,12,2015-11-19
Maine,LIU-Brooklyn,79,84,1,-5,2015-11-19
South Alabama,LSU,66,78,1,-12,2015-11-19
Iowa,Marquette,89,61,0,28,2015-11-19
Central Arkansas,UMass,62,89,1,-27,2015-11-19
Grambling,Memphis,65,83,1,-18,2015-11-19
Alabama State,Mercer,49,70,1,-21,2015-11-19
Temple,Minnesota,75,70,0,5,2015-11-19
Miami (FL),Mississippi State,105,79,0,26,2015-11-19
Butler,Missouri State,93,59,0,34,2015-11-19
Delaware State,Nebraska,60,75,1,-15,2015-11-19
Pensacola Christian,New Orleans,57,94,1,-37,2015-11-19
Mobile,Nicholls State,58,80,1,-22,2015-11-19
Boston University,NJIT,76,90,1,-14,2015-11-19
Louisiana-Monroe,Northwestern State,80,64,0,16,2015-11-19
Oregon State,Rice,77,69,0,8,2015-11-19
Hartford,St. Peter's,67,66,0,1,2015-11-19
Long Beach State,Seton Hall,80,77,0,3,2015-11-19
Navy,USC Upstate,67,55,0,12,2015-11-19
George Washington,South Florida,73,67,0,6,2015-11-19
Tulane,Southern,82,90,1,-8,2015-11-19
Rutgers,St. John's (NY),59,61,1,-2,2015-11-19
SMU,Stanford,85,70,0,15,2015-11-19
Marshall,Tennessee,74,84,1,-10,2015-11-19
Texas A&M-Corpus Christi,Texas A&M,70,95,1,-25,2015-11-19
Houston Baptist,TCU,63,90,1,-27,2015-11-19
Utah,Texas Tech,73,63,0,10,2015-11-19
Oklahoma State,Towson,69,52,0,17,2015-11-19
Alabama-Birmingham,Troy,79,63,0,16,2015-11-19
Pepperdine,UCLA,67,81,1,-14,2015-11-19
Trinity Christian,Valparaiso,42,89,1,-47,2015-11-19
Stony Brook,Vanderbilt,72,79,1,-7,2015-11-19
Mount St. Mary's,Washington,67,100,1,-33,2015-11-19
Antelope Valley,Weber State,47,90,1,-43,2015-11-19
Washington Adventist,William & Mary,60,85,1,-25,2015-11-19
New Mexico Highlands,Wyoming,67,83,1,-16,2015-11-19
Louisiana,Alabama,93,105,1,-12,2015-11-20
Charleston Southern,Arkansas,75,93,1,-18,2015-11-20
Georgia Southern,Auburn,62,92,1,-30,2015-11-20
Jackson State,Baylor,60,77,1,-17,2015-11-20
Seton Hall,Bradley,67,59,0,8,2015-11-20
Adams State,BYU,56,97,1,-41,2015-11-20
Prairie View,Bryant,58,71,1,-13,2015-11-20
Temple,Butler,69,74,1,-5,2015-11-20
Fresno Pacific,Cal State Bakersfield,68,81,1,-13,2015-11-20
East Carolina,California,62,70,1,-8,2015-11-20
Portland,Colorado,63,85,1,-22,2015-11-20
Penn State,Duquesne,52,78,1,-26,2015-11-20
Ball State,Eastern Kentucky,81,89,1,-8,2015-11-20
Siena Heights,Eastern Michigan,34,79,1,-45,2015-11-20
Northeastern,Florida Atlantic,60,58,0,2,2015-11-20
Hofstra,Florida State,82,77,0,5,2015-11-20
Wisconsin,Georgetown,61,71,1,-10,2015-11-20
Murray State,Georgia,52,63,1,-11,2015-11-20
Appalachian State,Hampton,61,82,1,-21,2015-11-20
Medgar Evers,Howard,64,106,1,-42,2015-11-20
Delaware,Iona,77,92,1,-15,2015-11-20
Florida College,Jacksonville,63,81,1,-18,2015-11-20
Florida International,James Madison,61,64,1,-3,2015-11-20
South Dakota,Kansas State,72,93,1,-21,2015-11-20
Wright State,Kentucky,63,78,1,-15,2015-11-20
South Carolina State,Longwood,83,77,0,6,2015-11-20
Rider,Maryland,58,65,1,-7,2015-11-20
Lipscomb,Miami (OH),68,70,1,-2,2015-11-20
Xavier,Michigan,86,70,0,16,2015-11-20
Arkansas-Pine Bluff,Michigan State,46,92,1,-46,2015-11-20
Trinity International (IL),Milwaukee,61,85,1,-24,2015-11-20
Minnesota,Missouri State,74,69,0,5,2015-11-20
San Jose State,Montana State,69,81,1,-12,2015-11-20
Indiana State,Norfolk State,70,61,0,9,2015-11-20
Embry-Riddle Aeronautical University,Northern Arizona,57,90,1,-33,2015-11-20
Columbia,Northwestern,80,83,1,-3,2015-11-20
Texas-Arlington,Ohio State,73,68,0,5,2015-11-20
McNeese State,Oklahoma,56,85,1,-29,2015-11-20
George Mason,Oklahoma State,71,68,0,3,2015-11-20
Savannah State,Oregon,59,77,1,-18,2015-11-20
Detroit,Pitt,79,95,1,-16,2015-11-20
Siena,Radford,76,62,0,14,2015-11-20
Holy Names,Sacramento State,56,96,1,-40,2015-11-20
DePaul,South Carolina,61,76,1,-15,2015-11-20
Oral Roberts,UT-Martin,70,66,0,4,2015-11-20
Texas A&M-Kingsville,Texas-Rio Grande Valley,56,78,1,-22,2015-11-20
Mississippi State,Texas Tech,72,74,1,-2,2015-11-20
Ole Miss,Towson,76,60,0,16,2015-11-20
Ohio,Tulsa,88,90,1,-2,2015-11-20
Miami (FL),Utah,90,66,0,24,2015-11-20
Union (TN),Utah State,49,73,1,-24,2015-11-20
Antelope Valley,Utah Valley,60,104,1,-44,2015-11-20
ETSU,Villanova,51,86,1,-35,2015-11-20
Long Beach State,Virginia,52,87,1,-35,2015-11-20
Duke,VCU,79,71,0,8,2015-11-20
Idaho State,Washington State,67,85,1,-18,2015-11-20
Stetson,West Virginia,62,103,1,-41,2015-11-20
Jacksonville State,Winthrop,69,80,1,-11,2015-11-20
Oakwood,Alabama A&M,89,97,1,-8,2015-11-21
SUNY-Oneonta,Albany (NY),49,92,1,-43,2015-11-21
Longwood,Ball State,67,78,1,-11,2015-11-21
Siena,Bryant,78,59,0,19,2015-11-21
Austin Peay,Cal Poly,64,73,1,-9,2015-11-21
San Diego,Cal State Fullerton,55,67,1,-12,2015-11-21
Oregon State,UCSB,71,59,0,12,2015-11-21
Morgan State,Campbell,59,54,0,5,2015-11-21
Cornell,Canisius,62,87,1,-25,2015-11-21
UNC Greensboro,UCF,54,65,1,-11,2015-11-21
Trinity International (IL),Chicago State,70,81,1,-11,2015-11-21
Piedmont,Coastal Carolina,35,116,1,-81,2015-11-21
Furman,UConn,58,83,1,-25,2015-11-21
College of Charleston,Davidson,81,82,1,-1,2015-11-21
William & Mary,Dayton,66,69,1,-3,2015-11-21
Lamar,Delaware State,77,66,0,11,2015-11-21
Florida State,DePaul,83,67,0,16,2015-11-21
UMKC,Drake,79,73,0,6,2015-11-21
Monmouth,Drexel,82,74,0,8,2015-11-21
Western Illinois,Eastern Illinois,83,63,0,20,2015-11-21
South Carolina State,Eastern Kentucky,82,92,1,-10,2015-11-21
Belmont,Evansville,88,93,1,-5,2015-11-21
Sacred Heart,Fairfield,79,83,1,-4,2015-11-21
Youngstown State,Florida Gulf Coast,101,104,1,-3,2015-11-21
UT-Martin,Florida International,62,69,1,-7,2015-11-21
Fairleigh Dickinson,Fordham,62,85,1,-23,2015-11-21
Mount St. Mary's,Gonzaga,56,101,1,-45,2015-11-21
Louisiana Tech,Grambling,86,67,0,19,2015-11-21
Western Carolina,High Point,69,75,1,-6,2015-11-21
Florida A&M,Houston,52,97,1,-45,2015-11-21
Linfield,Idaho,59,85,1,-26,2015-11-21
Chattanooga,Illinois,81,77,0,4,2015-11-21
Houston Baptist,Illinois State,56,72,1,-16,2015-11-21
SIU-Edwardsville,Purdue-Fort Wayne,67,87,1,-20,2015-11-21
Kentucky State,IUPUI,82,86,1,-4,2015-11-21
Oral Roberts,James Madison,74,64,0,10,2015-11-21
Marist,Kent State,72,79,1,-7,2015-11-21
Central Pennsylvania College,Liberty,50,86,1,-36,2015-11-21
Northeastern,Lipscomb,79,67,0,12,2015-11-21
North Florida,Louisville,61,89,1,-28,2015-11-21
Toledo,Loyola (IL),62,69,1,-7,2015-11-21
Bucknell,Manhattan,80,67,0,13,2015-11-21
Florida Atlantic,Miami (OH),75,69,0,6,2015-11-21
Carroll,Montana,61,70,1,-9,2015-11-21
Mississippi Valley State,New Mexico State,46,85,1,-39,2015-11-21
Lafayette,NJIT,66,80,1,-14,2015-11-21
Ohio,Norfolk State,93,71,0,22,2015-11-21
Buffalo,North Carolina A&T,86,68,0,18,2015-11-21
Western Michigan,UNC Wilmington,76,80,1,-4,2015-11-21
Bowling Green State,North Dakota,59,77,1,-18,2015-11-21
UMBC,Northern Colorado,81,72,0,9,2015-11-21
Eureka,Northern Illinois,52,100,1,-48,2015-11-21
UNC,Northern Iowa,67,71,1,-4,2015-11-21
Morehead State,Northern Kentucky,64,56,0,8,2015-11-21
UMass-Lowell,Notre Dame,57,83,1,-26,2015-11-21
Nevada,Pacific,85,82,0,3,2015-11-21
Citadel,Presbyterian,79,95,1,-16,2015-11-21
St. Peter's,Princeton,72,75,1,-3,2015-11-21
Brown,Providence,73,94,1,-21,2015-11-21
Old Dominion,Purdue,39,61,1,-22,2015-11-21
Prairie View,Radford,56,64,1,-8,2015-11-21
Cleveland State,Rhode Island,45,73,1,-28,2015-11-21
Bethune-Cookman,Richmond,64,89,1,-25,2015-11-21
Central Arkansas,Rutgers,84,87,1,-3,2015-11-21
American,Saint Francis (PA),48,68,1,-20,2015-11-21
Florida,St. Joseph's,74,63,0,11,2015-11-21
St. Francis (NY),Saint Louis,60,76,1,-16,2015-11-21
Southern Illinois,Sam Houston State,86,81,0,5,2015-11-21
Kennesaw State,Samford,65,77,1,-12,2015-11-21
Little Rock,San Diego State,49,43,0,6,2015-11-21
UC-Riverside,San Francisco,57,58,1,-1,2015-11-21
Bob Jones University,USC Upstate,83,79,0,4,2015-11-21
Boston University,South Florida,78,66,0,12,2015-11-21
New Mexico,USC,82,90,1,-8,2015-11-21
UTSA,Southern Utah,82,79,0,3,2015-11-21
Loyola (MD),St. Bonaventure,82,94,1,-12,2015-11-21
Elon,Syracuse,55,66,1,-11,2015-11-21
Middle Tennessee,Tennessee State,69,66,0,3,2015-11-21
Texas A&M-Corpus Christi,Texas,56,67,1,-11,2015-11-21
UNC Asheville,Texas A&M,47,75,1,-28,2015-11-21
South Dakota State,TCU,76,67,0,9,2015-11-21
Texas State,UTEP,62,77,1,-15,2015-11-21
Niagara,Vermont,67,85,1,-18,2015-11-21
VMI,Virginia Tech,52,76,1,-24,2015-11-21
Maine,Wagner,73,87,1,-14,2015-11-21
Penn,Washington,67,104,1,-37,2015-11-21
Stony Brook,Western Kentucky,66,67,1,-1,2015-11-21
Emporia State,Wichita State,54,76,1,-22,2015-11-21
Maryland-Eastern Shore,Wofford,63,73,1,-10,2015-11-21
Robert Morris,Air Force,52,64,1,-12,2015-11-22
Jacksonville State,Alabama-Birmingham,55,61,1,-6,2015-11-22
Northwestern State,Arizona,42,61,1,-19,2015-11-22
Jackson State,Arkansas State,69,78,1,-9,2015-11-22
South Carolina State,Ball State,60,72,1,-12,2015-11-22
Harvard,Boston College,56,69,1,-13,2015-11-22
Towson,Bradley,62,60,0,2,2015-11-22
Arkansas-Pine Bluff,Cincinnati,50,99,1,-49,2015-11-22
Omaha,Colorado,82,87,1,-5,2015-11-22
Oakland,Colorado State,89,95,1,-6,2015-11-22
Lehigh,Columbia,61,88,1,-27,2015-11-22
Georgetown,Duke,84,86,1,-2,2015-11-22
Longwood,Eastern Kentucky,97,110,1,-13,2015-11-22
North Dakota,Florida Gulf Coast,60,73,1,-13,2015-11-22
Oral Roberts,Florida International,76,70,0,6,2015-11-22
Army,George Washington,81,92,1,-11,2015-11-22
ETSU,Georgia Tech,69,68,0,1,2015-11-22
Minnesota-Duluth,Green Bay,74,94,1,-20,2015-11-22
Nicholls State,Hawaii,74,99,1,-25,2015-11-22
Tulsa,Indiana State,67,59,0,8,2015-11-22
UT-Martin,James Madison,78,75,0,3,2015-11-22
Florida Atlantic,Lipscomb,65,79,1,-14,2015-11-22
Oklahoma State,Long Beach State,82,77,0,5,2015-11-22
North Carolina Central,LIU-Brooklyn,77,78,1,-1,2015-11-22
Antelope Valley,Loyola Marymount,62,86,1,-24,2015-11-22
Cal Poly,UMBC,78,65,0,13,2015-11-22
Butler,Miami (FL),75,85,1,-10,2015-11-22
Northeastern,Miami (OH),61,67,1,-6,2015-11-22
Missouri State,Mississippi State,70,84,1,-14,2015-11-22
Wyoming,Montana State,82,83,1,-1,2015-11-22
Goucher,Navy,47,76,1,-29,2015-11-22
Southeastern Louisiana,Nebraska,65,92,1,-27,2015-11-22
Niagara,North Carolina A&T,73,72,0,1,2015-11-22
Austin Peay,Northern Colorado,91,76,0,15,2015-11-22
Valparaiso,Oregon,67,73,1,-6,2015-11-22
Abilene Christian,Portland,57,87,1,-30,2015-11-22
Florida,Purdue,70,85,1,-15,2015-11-22
Holy Cross,Quinnipiac,56,62,1,-6,2015-11-22
Fresno State,Rice,82,65,0,17,2015-11-22
Old Dominion,St. Joseph's,64,66,1,-2,2015-11-22
Stanford,Saint Mary's,61,78,1,-17,2015-11-22
Ole Miss,Seton Hall,63,75,1,-12,2015-11-22
Hofstra,South Carolina,84,94,1,-10,2015-11-22
Yale,SMU,69,71,1,-2,2015-11-22
Louisiana State-Shreveport,Stephen F. Austin,64,88,1,-24,2015-11-22
Gardner-Webb,Tennessee,64,89,1,-25,2015-11-22
Alcorn State,UTEP,66,88,1,-22,2015-11-22
Portland State,Texas-Rio Grande Valley,79,61,0,18,2015-11-22
Minnesota,Texas Tech,68,81,1,-13,2015-11-22
Appalachian State,Tulane,48,76,1,-28,2015-11-22
Temple,Utah,68,74,1,-6,2015-11-22
Buffalo,Vermont,77,71,0,6,2015-11-22
Akron,Villanova,56,75,1,-19,2015-11-22
George Mason,Virginia,66,83,1,-17,2015-11-22
Wisconsin,VCU,74,73,0,1,2015-11-22
Bowling Green State,Youngstown State,79,72,0,7,2015-11-22
NC State,Arizona State,76,79,1,-3,2015-11-23
Savannah State,Baylor,61,100,1,-39,2015-11-23
Concordia (OR),Boise State,53,100,1,-47,2015-11-23
Sam Houston State,California,63,89,1,-26,2015-11-23
Santa Clara,UC-Irvine,61,79,1,-18,2015-11-23
UTSA,Central Arkansas,84,98,1,-14,2015-11-23
Weber State,Central Michigan,63,60,0,3,2015-11-23
Kansas,Chaminade,123,72,0,51,2015-11-23
UMass,Clemson,82,65,0,17,2015-11-23
Chestnut Hill,Coppin State,75,92,1,-17,2015-11-23
Penn State-Harrisburg,Cornell,47,76,1,-29,2015-11-23
Mercer,Davidson,71,77,1,-6,2015-11-23
Norfolk State,DePaul,78,82,1,-4,2015-11-23
Michigan-Dearborn,Detroit,70,122,1,-52,2015-11-23
Bowling Green State,Florida Gulf Coast,82,77,0,5,2015-11-23
Ohio,Florida State,81,90,1,-9,2015-11-23
Mississippi Valley State,Grand Canyon,60,94,1,-34,2015-11-23
Indiana State,Hofstra,67,66,0,1,2015-11-23
Texas Southern,Howard,81,87,1,-6,2015-11-23
Chicago State,Illinois,79,82,1,-3,2015-11-23
Wake Forest,Indiana,82,78,0,4,2015-11-23
Chattanooga,Iowa State,63,83,1,-20,2015-11-23
Thomas University,Jacksonville,64,92,1,-28,2015-11-23
Missouri,Kansas State,42,66,1,-24,2015-11-23
IUPUI,Kennesaw State,63,71,1,-8,2015-11-23
Lafayette,La Salle,75,83,1,-8,2015-11-23
LSU,Marquette,80,81,1,-1,2015-11-23
Texas-Arlington,Memphis,68,64,0,4,2015-11-23
Eastern Michigan,Michigan State,65,89,1,-24,2015-11-23
Goldey-Beacom,Morgan State,62,66,1,-4,2015-11-23
Milwaukee,Murray State,63,66,1,-3,2015-11-23
Northwestern,UNC,69,80,1,-11,2015-11-23
Idaho,North Texas,65,63,0,2,2015-11-23
San Diego Christian,Northern Arizona,65,81,1,-16,2015-11-23
Notre Dame (CA),Pacific,44,79,1,-35,2015-11-23
Duquesne,Pepperdine,70,84,1,-14,2015-11-23
NJIT,Providence,76,83,1,-7,2015-11-23
Creighton,Rutgers,85,75,0,10,2015-11-23
Troy,Samford,79,83,1,-4,2015-11-23
East Carolina,San Diego State,54,79,1,-25,2015-11-23
Eastern Washington,Seattle,52,58,1,-6,2015-11-23
Belmont,South Alabama,98,85,0,13,2015-11-23
Tulsa,South Carolina,75,83,1,-8,2015-11-23
Cal State Northridge,USC,61,96,1,-35,2015-11-23
William Carey,Southern Miss,84,78,0,6,2015-11-23
Fort Valley State,Stetson,72,101,1,-29,2015-11-23
St. Edward's,Texas A&M-Corpus Christi,50,78,1,-28,2015-11-23
UNLV,UCLA,75,77,1,-2,2015-11-23
St. John's (NY),Vanderbilt,55,92,1,-37,2015-11-23
Bethune-Cookman,West Virginia,44,97,1,-53,2015-11-23
Drake,Western Kentucky,81,79,0,2,2015-11-23
Rochester (MI),Western Michigan,73,85,1,-12,2015-11-23
Northern Kentucky,Xavier,66,78,1,-12,2015-11-23
North Dakota,Youngstown State,69,79,1,-10,2015-11-23
Marquette,Arizona State,78,73,0,5,2015-11-24
New Hampshire,Brown,88,77,0,11,2015-11-24
Siena,Bucknell,83,81,0,2,2015-11-24
Delaware State,UC-Riverside,55,81,1,-26,2015-11-24
St. Bonaventure,Canisius,77,73,0,4,2015-11-24
Binghamton,Central Connecticut,81,75,0,6,2015-11-24
UNLV,Chaminade,93,73,0,20,2015-11-24
ETSU,Charleston Southern,76,77,1,-1,2015-11-24
Southeastern Louisiana,Cincinnati,49,64,1,-15,2015-11-24
Rider,Cleveland State,52,57,1,-5,2015-11-24
Coastal Carolina,College of Charleston,67,61,0,6,2015-11-24
Abilene Christian,Colorado State,100,108,1,-8,2015-11-24
Wofford,Columbia,59,70,1,-11,2015-11-24
Fairleigh Dickinson,Delaware,72,73,1,-1,2015-11-24
Weber State,Drake,74,58,0,16,2015-11-24
Colgate,Fordham,58,84,1,-26,2015-11-24
Gardner-Webb,George Washington,65,94,1,-29,2015-11-24
Akron,Green Bay,63,66,1,-3,2015-11-24
Niagara,Hartford,73,77,1,-4,2015-11-24
South Dakota State,Houston Baptist,92,68,0,24,2015-11-24
Troy,Idaho,63,69,1,-6,2015-11-24
Roosevelt,UIC,58,96,1,-38,2015-11-24
St. John's (NY),Indiana,73,83,1,-10,2015-11-24
South Alabama,IUPUI,78,68,0,10,2015-11-24
Alabama A&M,Jacksonville State,73,69,0,4,2015-11-24
East Mennonite,James Madison,74,106,1,-32,2015-11-24
Belmont,Kennesaw State,80,55,0,25,2015-11-24
Saint Francis (PA),Kent State,60,79,1,-19,2015-11-24
Boston University,Kentucky,62,82,1,-20,2015-11-24
St. Francis (NY),Louisville,41,85,1,-44,2015-11-24
Stony Brook,Loyola (MD),76,63,0,13,2015-11-24
Illinois State,Maryland,66,77,1,-11,2015-11-24
Fairfield,Maryland-Eastern Shore,113,74,0,39,2015-11-24
Wheelock,UMass-Lowell,76,104,1,-28,2015-11-24
Purdue-Fort Wayne,Miami (OH),57,53,0,4,2015-11-24
Duquesne,Milwaukee,96,92,0,4,2015-11-24
Marshall,Morehead State,61,85,1,-24,2015-11-24
Pepperdine,Murray State,55,59,1,-4,2015-11-24
Arkansas-Pine Bluff,Nebraska,44,67,1,-23,2015-11-24
Robert Morris,New Mexico State,71,81,1,-10,2015-11-24
Kansas State,UNC,70,80,1,-10,2015-11-24
LSU,NC State,72,83,1,-11,2015-11-24
Samford,North Texas,74,72,0,2,2015-11-24
Missouri,Northwestern,62,67,1,-5,2015-11-24
Louisiana Tech,Ohio State,82,74,0,8,2015-11-24
Incarnate Word,Oklahoma,63,96,1,-33,2015-11-24
Valparaiso,Oregon State,63,57,0,6,2015-11-24
Radford,Penn State,86,74,0,12,2015-11-24
Alcorn State,Portland,65,97,1,-32,2015-11-24
North Carolina Central,Quinnipiac,59,69,1,-10,2015-11-24
TCU,Rhode Island,60,66,1,-6,2015-11-24
UC-Davis,Sacramento State,79,84,1,-5,2015-11-24
North Florida,Saint Louis,57,70,1,-13,2015-11-24
Winthrop,USC Upstate,79,78,0,1,2015-11-24
South Dakota School of Mines,South Dakota,63,83,1,-20,2015-11-24
Albany (NY),South Florida,61,63,1,-2,2015-11-24
Dillard,Southern,65,79,1,-14,2015-11-24
Oakland,Southern Illinois,88,97,1,-9,2015-11-24
Campbell,SIU-Edwardsville,77,74,0,3,2015-11-24
Cal State Fullerton,Southern Utah,80,66,0,14,2015-11-24
Army,Tennessee,80,95,1,-15,2015-11-24
Reinhardt,Tennessee State,61,77,1,-16,2015-11-24
Jackson State,Tennessee Tech,82,86,1,-4,2015-11-24
Florida A&M,UTEP,54,72,1,-18,2015-11-24
Southeast Missouri State,Texas-Rio Grande Valley,74,83,1,-9,2015-11-24
Kansas,UCLA,92,73,0,19,2015-11-24
Utah Valley,Utah State,55,81,1,-26,2015-11-24
Presbyterian,VMI,61,76,1,-15,2015-11-24
North Carolina A&T,Virginia Tech,60,90,1,-30,2015-11-24
Vanderbilt,Wake Forest,86,64,0,22,2015-11-24
Cal State Los Angeles,Washington State,57,74,1,-17,2015-11-24
Hiwassee,Western Carolina,63,88,1,-25,2015-11-24
Central Michigan,Western Kentucky,60,88,1,-28,2015-11-24
Mt. St. Joseph,Wright State,52,66,1,-14,2015-11-24
Oakland City,Austin Peay,55,83,1,-28,2015-11-25
Indiana-Kokomo,Ball State,54,90,1,-36,2015-11-25
New Orleans,Bradley,64,51,0,13,2015-11-25
Mississippi Valley State,BYU,68,75,1,-7,2015-11-25
Milwaukee,Central Michigan,84,78,0,6,2015-11-25
St. John's (NY),Chaminade,100,93,0,7,2015-11-25
Georgia Southern,Citadel,90,95,1,-5,2015-11-25
Air Force,Colorado,70,81,1,-11,2015-11-25
UMass,Creighton,76,97,1,-21,2015-11-25
Idaho State,Denver,69,79,1,-10,2015-11-25
Yale,Duke,61,80,1,-19,2015-11-25
Thomas More,Eastern Kentucky,67,101,1,-34,2015-11-25
Marygrove,Eastern Michigan,64,108,1,-44,2015-11-25
Vermont,Florida,62,86,1,-24,2015-11-25
LIU-Brooklyn,Florida International,72,80,1,-8,2015-11-25
High Point,Georgia,46,49,1,-3,2015-11-25
Bryant,Harvard,45,80,1,-35,2015-11-25
Sacred Heart,Holy Cross,60,69,1,-9,2015-11-25
Central Arkansas,Howard,54,73,1,-19,2015-11-25
Samford,Idaho,75,58,0,17,2015-11-25
UNLV,Indiana,72,69,0,3,2015-11-25
Vanderbilt,Kansas,63,70,1,-7,2015-11-25
Loyola (LA),Louisiana,62,106,1,-44,2015-11-25
San Diego,Loyola (IL),57,67,1,-10,2015-11-25
Cal State Northridge,Loyola Marymount,80,82,1,-2,2015-11-25
Longwood,Maine,82,92,1,-10,2015-11-25
George Mason,Manhattan,67,69,1,-2,2015-11-25
Navy,UMBC,75,54,0,21,2015-11-25
Dillard,McNeese State,79,80,1,-1,2015-11-25
UConn,Michigan,74,60,0,14,2015-11-25
Georgia State,Ole Miss,59,68,1,-9,2015-11-25
Lincoln,UMKC,72,73,1,-1,2015-11-25
Weber State,Murray State,75,59,0,16,2015-11-25
Portland State,Nevada,73,76,1,-3,2015-11-25
Nicholls State,New Mexico,63,75,1,-12,2015-11-25
Montana,North Dakota State,53,73,1,-20,2015-11-25
Troy,North Texas,86,74,0,12,2015-11-25
Omaha,Northern Colorado,105,85,0,20,2015-11-25
Indiana-Northwest,Northern Illinois,55,87,1,-32,2015-11-25
Dubuque,Northern Iowa,63,83,1,-20,2015-11-25
Louisiana College,Northwestern State,80,86,1,-6,2015-11-25
Tabor College,Oral Roberts,80,112,1,-32,2015-11-25
Arkansas State,Oregon,68,91,1,-23,2015-11-25
La Salle,Penn,64,80,1,-16,2015-11-25
Drake,Pepperdine,69,53,0,16,2015-11-25
Cornell,Pitt,49,93,1,-44,2015-11-25
Lafayette,Princeton,52,104,1,-52,2015-11-25
Maryland,Rhode Island,86,63,0,23,2015-11-25
Lamar,Rice,84,92,1,-8,2015-11-25
Houston Baptist,Rider,56,67,1,-11,2015-11-25
Clemson,Rutgers,76,58,0,18,2015-11-25
UCSB,San Francisco,68,61,0,7,2015-11-25
Toledo,San Jose State,89,74,0,15,2015-11-25
Great Falls,Seattle,48,58,1,-10,2015-11-25
Allen,South Carolina State,74,86,1,-12,2015-11-25
Cleveland State,South Dakota State,66,77,1,-11,2015-11-25
Charlotte,Syracuse,70,83,1,-13,2015-11-25
Harris-Stowe,UT-Martin,57,83,1,-26,2015-11-25
Texas,Texas A&M,73,84,1,-11,2015-11-25
Grambling,Texas-Arlington,40,73,1,-33,2015-11-25
Illinois State,TCU,60,71,1,-11,2015-11-25
UTSA,Texas Southern,80,91,1,-11,2015-11-25
Gallaudet,Towson,45,88,1,-43,2015-11-25
Wake Forest,UCLA,80,77,0,3,2015-11-25
Lehigh,Virginia,54,80,1,-26,2015-11-25
American,VCU,44,72,1,-28,2015-11-25
Gonzaga,Washington,80,64,0,16,2015-11-25
Trinity Christian,Western Illinois,44,79,1,-35,2015-11-25
Duquesne,Western Kentucky,81,73,0,8,2015-11-25
Hampton,William & Mary,67,86,1,-19,2015-11-25
Prairie View,Wisconsin,67,85,1,-18,2015-11-25
Cal State Bakersfield,Wyoming,64,68,1,-4,2015-11-25
Thiel,Youngstown State,55,69,1,-14,2015-11-25
Middle Tennessee,Alaska-Anchorage,75,72,0,3,2015-11-26
Santa Clara,Arizona,73,75,1,-2,2015-11-26
UC-Irvine,Boise State,64,71,1,-7,2015-11-26
Iowa,Dayton,77,82,1,-5,2015-11-26
UNC Asheville,Drexel,85,66,0,19,2015-11-26
Little Rock,East Carolina,54,46,0,8,2015-11-26
Mount St. Mary's,Elon,74,79,1,-5,2015-11-26
Texas A&M-Corpus Christi,Furman,73,69,0,4,2015-11-26
Arkansas,Georgia Tech,73,83,1,-10,2015-11-26
Texas A&M,Gonzaga,62,61,0,1,2015-11-26
Appalachian State,Liberty,73,62,0,11,2015-11-26
Tulane,Mercer,61,71,1,-10,2015-11-26
Charlotte,Michigan,47,102,1,-55,2015-11-26
Boston College,Michigan State,68,99,1,-31,2015-11-26
Notre Dame,Monmouth,68,70,1,-2,2015-11-26
Evansville,Providence,64,74,1,-10,2015-11-26
California,San Diego State,58,72,1,-14,2015-11-26
Wichita State,USC,69,72,1,-3,2015-11-26
Western Michigan,Stephen F. Austin,71,79,1,-8,2015-11-26
Bethune-Cookman,Stetson,70,83,1,-13,2015-11-26
UConn,Syracuse,76,79,1,-3,2015-11-26
Washington,Texas,70,82,1,-12,2015-11-26
Stanford,Villanova,45,59,1,-14,2015-11-26
Richmond,West Virginia,59,67,1,-8,2015-11-26
Alabama,Xavier,45,64,1,-19,2015-11-26
Charleston Southern,Akron,58,82,1,-24,2015-11-27
Illinois,Alabama-Birmingham,72,58,0,14,2015-11-27
Chattanooga,Alabama State,95,58,0,37,2015-11-27
Drexel,Alaska-Anchorage,65,71,1,-6,2015-11-27
NJIT,Albany (NY),73,74,1,-1,2015-11-27
Providence,Arizona,69,65,0,4,2015-11-27
Arkansas-Pine Bluff,Army,60,81,1,-21,2015-11-27
Northwestern State,Auburn,81,119,1,-38,2015-11-27
Arkansas State,Baylor,72,94,1,-22,2015-11-27
UC-Irvine,Boston College,80,67,0,13,2015-11-27
Richmond,California,94,90,0,4,2015-11-27
Washington,Charlotte,71,66,0,5,2015-11-27
Jacksonville State,Chicago State,68,65,0,3,2015-11-27
Bob Jones University,Citadel,81,121,1,-40,2015-11-27
Western Carolina,College of Charleston,56,57,1,-1,2015-11-27
Portland,Colorado State,74,90,1,-16,2015-11-27
Monmouth,Dayton,70,73,1,-3,2015-11-27
Texas A&M-Corpus Christi,Elon,85,81,0,4,2015-11-27
Santa Clara,Evansville,57,69,1,-12,2015-11-27
Columbia,Fairfield,81,82,1,-1,2015-11-27
Florida Gulf Coast,Florida,50,70,1,-20,2015-11-27
Abilene Christian,Florida A&M,72,62,0,10,2015-11-27
Delaware State,Fresno State,59,80,1,-21,2015-11-27
Southeastern Louisiana,Gardner-Webb,68,77,1,-9,2015-11-27
IUPUI,Georgia State,72,78,1,-6,2015-11-27
UConn,Gonzaga,70,73,1,-3,2015-11-27
North Florida,Hartford,81,60,0,21,2015-11-27
Quincy,Illinois State,63,73,1,-10,2015-11-27
Virginia Tech,Iowa State,77,99,1,-22,2015-11-27
Savannah State,Jackson State,42,69,1,-27,2015-11-27
Purdue-Fort Wayne,Jacksonville,71,63,0,8,2015-11-27
Western Michigan,Liberty,68,58,0,10,2015-11-27
North Carolina Central,Louisiana Tech,50,71,1,-21,2015-11-27
Toledo,Loyola (IL),82,74,0,8,2015-11-27
James Madison,Marshall,89,75,0,14,2015-11-27
Saint Francis (PA),Maryland-Eastern Shore,57,70,1,-13,2015-11-27
Appalachian State,Mercer,70,71,1,-1,2015-11-27
Northeastern,Miami (FL),78,77,0,1,2015-11-27
Boise State,Michigan State,67,77,1,-10,2015-11-27
Omaha,Minnesota,90,93,1,-3,2015-11-27
William Woods,Missouri State,56,77,1,-21,2015-11-27
Furman,Mount St. Mary's,69,60,0,9,2015-11-27
Cincinnati,Nebraska,65,61,0,4,2015-11-27
Middle Tennessee,UNC Asheville,63,61,0,2,2015-11-27
Navy,UNC Greensboro,70,66,0,4,2015-11-27
Winthrop,NC State,79,87,1,-8,2015-11-27
Iowa,Notre Dame,62,68,1,-6,2015-11-27
Alcorn State,Oakland,51,84,1,-33,2015-11-27
Memphis,Ohio State,81,76,0,5,2015-11-27
Long Beach State,Oklahoma State,73,79,1,-6,2015-11-27
UC-Riverside,Rice,81,87,1,-6,2015-11-27
Bethune-Cookman,Sam Houston State,46,71,1,-25,2015-11-27
San Jose State,San Diego,76,67,0,9,2015-11-27
West Virginia,San Diego State,72,50,0,22,2015-11-27
Lipscomb,South Carolina,76,92,1,-16,2015-11-27
Georgia Southern,USC Upstate,84,80,0,4,2015-11-27
Kentucky,South Florida,84,63,0,21,2015-11-27
UTEP,Southern Illinois,71,66,0,5,2015-11-27
Arkansas,Stanford,66,69,1,-3,2015-11-27
East Carolina,Stetson,93,73,0,20,2015-11-27
George Washington,Tennessee,73,70,0,3,2015-11-27
Robert Morris,Tennessee Tech,72,85,1,-13,2015-11-27
Michigan,Texas,78,72,0,6,2015-11-27
Syracuse,Texas A&M,74,67,0,7,2015-11-27
Stephen F. Austin,Tulane,59,60,1,-1,2015-11-27
Idaho State,Utah,72,102,1,-30,2015-11-27
Georgia Tech,Villanova,52,69,1,-17,2015-11-27
Alabama,Wichita State,64,60,0,4,2015-11-27
USC,Xavier,77,87,1,-10,2015-11-27
Oakland,Abilene Christian,85,57,0,28,2015-11-28
New Mexico State,Air Force,64,66,1,-2,2015-11-28
Virginia Tech,Alabama-Birmingham,82,77,0,5,2015-11-28
San Jose State,Alaska-Anchorage,91,87,0,4,2015-11-28
Southeastern Louisiana,Arkansas-Pine Bluff,60,62,1,-2,2015-11-28
Gardner-Webb,Army,98,103,1,-5,2015-11-28
Samford,Austin Peay,73,74,1,-1,2015-11-28
Valparaiso,Ball State,66,69,1,-3,2015-11-28
Boston University,Binghamton,75,65,0,10,2015-11-28
Ole Miss,Bradley,67,54,0,13,2015-11-28
Belmont,BYU,81,95,1,-14,2015-11-28
Canisius,Buffalo,96,98,1,-2,2015-11-28
SIU-Edwardsville,Butler,73,89,1,-16,2015-11-28
Antelope Valley,Cal Poly,55,85,1,-30,2015-11-28
Nevada,Cal State Fullerton,66,75,1,-9,2015-11-28
Coastal Carolina,Campbell,73,79,1,-6,2015-11-28
Jacksonville State,Chattanooga,52,62,1,-10,2015-11-28
Alabama State,Chicago State,66,64,0,2,2015-11-28
George Washington,Cincinnati,56,61,1,-5,2015-11-28
Longwood,Columbia,70,69,0,1,2015-11-28
Towson,Coppin State,81,77,0,4,2015-11-28
Western Illinois,Creighton,67,97,1,-30,2015-11-28
Denison,Davidson,70,83,1,-13,2015-11-28
South Alabama,Denver,56,69,1,-13,2015-11-28
UIC,Drake,62,83,1,-21,2015-11-28
San Diego,Drexel,62,59,0,3,2015-11-28
UNC Wilmington,ETSU,94,73,0,21,2015-11-28
Green Bay,Eastern Illinois,81,72,0,9,2015-11-28
Southern Utah,Eastern Kentucky,85,98,1,-13,2015-11-28
Madonna,Eastern Michigan,63,79,1,-16,2015-11-28
Pacific,Eastern Washington,63,70,1,-7,2015-11-28
St. Peter's,Fairleigh Dickinson,62,77,1,-15,2015-11-28
Alcorn State,Florida A&M,71,73,1,-2,2015-11-28
Manhattan,Fordham,64,87,1,-23,2015-11-28
Wright State,George Mason,39,66,1,-27,2015-11-28
Bryant,Georgetown,47,77,1,-30,2015-11-28
Morgan State,High Point,72,82,1,-10,2015-11-28
Louisiana-Monroe,Houston,64,76,1,-12,2015-11-28
William & Mary,Howard,77,79,1,-2,2015-11-28
Northern Illinois,Idaho,66,59,0,7,2015-11-28
Iowa State,Illinois,84,73,0,11,2015-11-28
Navy,Jacksonville,71,65,0,6,2015-11-28
Tennessee State,Kennesaw State,56,49,0,7,2015-11-28
Saint Louis,Louisville,57,77,1,-20,2015-11-28
Cleveland State,Maryland,63,80,1,-17,2015-11-28
Colgate,UMBC,71,63,0,8,2015-11-28
Texas State,McNeese State,70,67,0,3,2015-11-28
UCF,Miami (OH),63,64,1,-1,2015-11-28
Toledo,Middle Tennessee,70,78,1,-8,2015-11-28
UT-Martin,Mississippi State,51,76,1,-25,2015-11-28
Robert Morris,Mississippi Valley State,67,64,0,3,2015-11-28
South Dakota State,UMKC,57,64,1,-7,2015-11-28
Southern Miss,Morehead State,46,61,1,-15,2015-11-28
Alabama A&M,Murray State,61,63,1,-2,2015-11-28
Prairie View,UNLV,62,80,1,-18,2015-11-28
American,New Hampshire,68,50,0,18,2015-11-28
Youngstown State,Niagara,88,70,0,18,2015-11-28
Loyola (IL),UNC Asheville,48,59,1,-11,2015-11-28
Purdue-Fort Wayne,UNC Greensboro,64,58,0,6,2015-11-28
Northern Iowa,North Dakota,97,51,0,46,2015-11-28
North Carolina A&T,North Dakota State,56,77,1,-21,2015-11-28
New Orleans,Northwestern,63,90,1,-27,2015-11-28
Detroit,Oral Roberts,95,100,1,-5,2015-11-28
Bucknell,Penn State,58,62,1,-4,2015-11-28
Kent State,Pitt,76,85,1,-9,2015-11-28
Southern Illinois,Portland,80,79,0,1,2015-11-28
Multnomah,Portland State,82,100,1,-18,2015-11-28
Wofford,Presbyterian,68,58,0,10,2015-11-28
Lehigh,Purdue,55,77,1,-22,2015-11-28
La Salle,Rowan,81,51,0,30,2015-11-28
South Dakota,Sacramento State,96,90,0,6,2015-11-28
Georgia,Seton Hall,62,69,1,-7,2015-11-28
Loyola (MD),Siena,82,90,1,-8,2015-11-28
Citadel,USC Upstate,88,81,0,7,2015-11-28
Loyola Marymount,Southeast Missouri State,73,60,0,13,2015-11-28
Hofstra,St. Bonaventure,89,83,0,6,2015-11-28
North Florida,St. Francis (NY),78,65,0,13,2015-11-28
Farmingdale State,Stony Brook,42,91,1,-49,2015-11-28
Nebraska,Tennessee,82,71,0,11,2015-11-28
Cincinnati-Clermont,Tennessee Tech,66,91,1,-25,2015-11-28
Colorado State,UTEP,90,99,1,-9,2015-11-28
Hawaii,Texas Tech,74,82,1,-8,2015-11-28
Little Rock,Tulsa,64,60,0,4,2015-11-28
UC-Davis,Utah Valley,82,70,0,12,2015-11-28
Old Dominion,VCU,67,76,1,-9,2015-11-28
Staten Island,Wagner,59,83,1,-24,2015-11-28
Texas Southern,Washington State,65,77,1,-12,2015-11-28
Montana State,Wyoming,68,82,1,-14,2015-11-28
Yale,Albany (NY),54,88,1,-34,2015-11-29
Stephen F. Austin,Appalachian State,94,84,0,10,2015-11-29
Boise State,Arizona,59,68,1,-9,2015-11-29
UCSB,Arizona State,68,70,1,-2,2015-11-29
Urbana,Bowling Green State,55,96,1,-41,2015-11-29
Maine,Central Connecticut,81,74,0,7,2015-11-29
Northern Colorado,Colorado,52,82,1,-30,2015-11-29
LIU-Brooklyn,Dartmouth,56,79,1,-23,2015-11-29
Xavier,Dayton,90,61,0,29,2015-11-29
Utah State,Duke,52,85,1,-33,2015-11-29
South Dakota,Eastern Washington,77,71,0,6,2015-11-29
UC-Irvine,Evansville,56,75,1,-19,2015-11-29
Ave Maria,Florida Gulf Coast,34,91,1,-57,2015-11-29
St. Francis (NY),Hartford,74,67,0,7,2015-11-29
Harvard,Holy Cross,49,50,1,-1,2015-11-29
Wichita State,Iowa,61,84,1,-23,2015-11-29
Navy,Purdue-Fort Wayne,75,53,0,22,2015-11-29
South Carolina State,Kansas State,66,68,1,-2,2015-11-29
Penn,Lafayette,86,92,1,-6,2015-11-29
UC-Riverside,Lamar,74,69,0,5,2015-11-29
Tulane,Liberty,72,51,0,21,2015-11-29
Jackson State,Marquette,61,80,1,-19,2015-11-29
Cornell,UMass-Lowell,77,80,1,-3,2015-11-29
Western Michigan,Mercer,65,68,1,-3,2015-11-29
USC,Monmouth,73,83,1,-10,2015-11-29
Maine-Fort Kent,NJIT,60,89,1,-29,2015-11-29
Jacksonville,UNC Greensboro,69,71,1,-2,2015-11-29
Alabama,Notre Dame,74,73,0,1,2015-11-29
Wisconsin,Oklahoma,48,65,1,-17,2015-11-29
Montana,Pepperdine,63,69,1,-6,2015-11-29
Michigan State,Providence,77,64,0,13,2015-11-29
Rider,Rhode Island,57,82,1,-25,2015-11-29
Texas-Arlington,Rice,92,74,0,18,2015-11-29
Pacific,Sacramento State,71,79,1,-8,2015-11-29
Cal State Bakersfield,Saint Mary's,59,94,1,-35,2015-11-29
Wiley,Sam Houston State,67,66,0,1,2015-11-29
Delaware State,San Francisco,47,67,1,-20,2015-11-29
Boston College,Santa Clara,45,62,1,-17,2015-11-29
Savannah State,South Florida,57,67,1,-10,2015-11-29
Brown,SMU,69,77,1,-8,2015-11-29
Delaware,Temple,50,69,1,-19,2015-11-29
Mississippi Valley State,Tennessee Tech,64,101,1,-37,2015-11-29
Texas-Permian Basin,UTSA,90,85,0,5,2015-11-29
Cal State Northridge,UCLA,45,77,1,-32,2015-11-29
Marist,Vermont,60,86,1,-26,2015-11-29
VMI,Campbell,65,66,1,-1,2015-11-30
McNeese State,Central Michigan,73,74,1,-1,2015-11-30
LSU,College of Charleston,58,70,1,-12,2015-11-30
Kennesaw State,Elon,93,103,1,-10,2015-11-30
Stetson,Florida International,81,75,0,6,2015-11-30
Bob Jones University,Georgia Southern,52,104,1,-52,2015-11-30
Selma University,Grambling,53,98,1,-45,2015-11-30
Hampton,Grand Canyon,51,63,1,-12,2015-11-30
Texas-Rio Grande Valley,Houston,65,78,1,-13,2015-11-30
Central Pennsylvania College,Howard,79,98,1,-19,2015-11-30
Alcorn State,Indiana,70,112,1,-42,2015-11-30
Illinois State,Kentucky,63,75,1,-12,2015-11-30
Chattanooga,Louisiana-Monroe,54,64,1,-10,2015-11-30
Clemson,Minnesota,83,89,1,-6,2015-11-30
Holy Names,Nevada,57,108,1,-51,2015-11-30
Bryant,New Hampshire,67,75,1,-8,2015-11-30
Northern Kentucky,North Carolina A&T,63,74,1,-11,2015-11-30
Trinity Baptist,North Florida,72,80,1,-8,2015-11-30
Norfolk State,Northern Arizona,70,66,0,4,2015-11-30
North Texas,Northern Iowa,70,93,1,-23,2015-11-30
Fresno State,Oregon,73,78,1,-5,2015-11-30
Fairleigh Dickinson,Princeton,61,91,1,-30,2015-11-30
James Madison,Radford,70,68,0,2,2015-11-30
Wake Forest,Rutgers,69,68,0,1,2015-11-30
Spring Hill,South Alabama,50,79,1,-29,2015-11-30
Western Carolina,South Carolina,53,76,1,-23,2015-11-30
Toccoa Falls,USC Upstate,54,101,1,-47,2015-11-30
Paul Quinn,Southern,63,96,1,-33,2015-11-30
Green Bay,SIU-Edwardsville,87,69,0,18,2015-11-30
Georgia State,Alabama-Birmingham,57,64,1,-7,2015-12-01
Northwestern State,Arkansas,78,117,1,-39,2015-12-01
Central Arkansas,Little Rock,73,79,1,-6,2015-12-01
IUPUI,Ball State,58,61,1,-3,2015-12-01
Lipscomb,Belmont,89,105,1,-16,2015-12-01
Colgate,Binghamton,50,69,1,-19,2015-12-01
Cal St Dominguez Hills,Cal State Fullerton,56,88,1,-32,2015-12-01
Seattle,California,52,66,1,-14,2015-12-01
Davidson,Charlotte,109,74,0,35,2015-12-01
Siena,Cornell,80,81,1,-1,2015-12-01
Bradley,Delaware,47,70,1,-23,2015-12-01
Mississippi Valley State,Duquesne,77,91,1,-14,2015-12-01
Florida Atlantic,East Carolina,48,74,1,-26,2015-12-01
Indiana State,Eastern Illinois,62,68,1,-6,2015-12-01
Alabama State,Evansville,56,88,1,-32,2015-12-01
Richmond,Florida,56,76,1,-20,2015-12-01
Piedmont,Furman,38,99,1,-61,2015-12-01
Maryland-Eastern Shore,Georgetown,49,68,1,-19,2015-12-01
Oakland,Georgia,82,86,1,-4,2015-12-01
Wofford,Georgia Tech,61,77,1,-16,2015-12-01
Fairfield,Iona,77,101,1,-24,2015-12-01
North Dakota State,Iowa State,64,84,1,-20,2015-12-01
Samford,Jacksonville State,77,71,0,6,2015-12-01
Loyola (MD),Kansas,61,94,1,-33,2015-12-01
San Diego State,Long Beach State,76,72,0,4,2015-12-01
Louisiana Tech,Memphis,68,94,1,-26,2015-12-01
Arkansas State,Missouri,78,88,1,-10,2015-12-01
UT-Martin,UMKC,70,74,1,-4,2015-12-01
Utah State,Missouri State,69,68,0,1,2015-12-01
American,Mount St. Mary's,56,81,1,-25,2015-12-01
Miami (FL),Nebraska,77,72,0,5,2015-12-01
Eastern Michigan,Omaha,80,73,0,7,2015-12-01
Oral Roberts,New Mexico,75,91,1,-16,2015-12-01
Louisiana College,Nicholls State,62,80,1,-18,2015-12-01
Maryland,UNC,81,89,1,-8,2015-12-01
Michigan,NC State,66,59,0,7,2015-12-01
Waldorf,North Dakota,58,78,1,-20,2015-12-01
Marshall,Ohio,70,85,1,-15,2015-12-01
Virginia,Ohio State,64,58,0,6,2015-12-01
Purdue,Pitt,72,59,0,13,2015-12-01
Albany (NY),Quinnipiac,58,54,0,4,2015-12-01
Villanova,St. Joseph's,86,72,0,14,2015-12-01
Eastern Washington,San Francisco,81,77,0,4,2015-12-01
Loyola (LA),Southeastern Louisiana,65,101,1,-36,2015-12-01
Texas-Arlington,Texas,73,80,1,-7,2015-12-01
Southern Miss,Troy,59,69,1,-10,2015-12-01
Montana State,Utah Valley,76,72,0,4,2015-12-01
Northwestern,Virginia Tech,81,79,0,2,2015-12-01
Pacific Union,Weber State,57,95,1,-38,2015-12-01
Eastern Kentucky,Western Kentucky,84,86,1,-2,2015-12-01
Old Dominion,William & Mary,48,55,1,-7,2015-12-01
Albion,Wright State,50,68,1,-18,2015-12-01
Citadel,Air Force,93,97,1,-4,2015-12-02
Coppin State,Akron,71,77,1,-6,2015-12-02
Prairie View,Baylor,41,80,1,-39,2015-12-02
Willamette,Boise State,36,100,1,-64,2015-12-02
Penn State,Boston College,67,58,0,9,2015-12-02
UMBC,Bowling Green State,64,72,1,-8,2015-12-02
Central Connecticut,Brown,64,82,1,-18,2015-12-02
Columbia,Bucknell,72,61,0,11,2015-12-02
St. Bonaventure,Buffalo,60,58,0,2,2015-12-02
Sacramento State,UC-Davis,61,66,1,-5,2015-12-02
Winthrop,Charleston Southern,83,82,0,1,2015-12-02
Butler,Cincinnati,78,76,0,2,2015-12-02
USC Upstate,Clemson,56,76,1,-20,2015-12-02
Auburn,Coastal Carolina,81,78,0,3,2015-12-02
Fort Lewis,Colorado,71,95,1,-24,2015-12-02
Sacred Heart,UConn,49,82,1,-33,2015-12-02
Arizona State,Creighton,79,77,0,2,2015-12-02
Vermont,Dartmouth,68,63,0,5,2015-12-02
Wyoming,Denver,68,52,0,16,2015-12-02
Indiana,Duke,74,94,1,-20,2015-12-02
St. John's (NY),Fordham,57,73,1,-16,2015-12-02
Seton Hall,George Washington,64,72,1,-8,2015-12-02
Arkansas-Pine Bluff,Hawaii,47,75,1,-28,2015-12-02
Longwood,High Point,66,90,1,-24,2015-12-02
Murray State,Houston,78,93,1,-15,2015-12-02
Rice,Houston Baptist,73,77,1,-4,2015-12-02
Cal State Bakersfield,Idaho,63,67,1,-4,2015-12-02
Notre Dame,Illinois,84,79,0,5,2015-12-02
DePaul,UIC,82,55,0,27,2015-12-02
Florida State,Iowa,75,78,1,-3,2015-12-02
Fisk,Jackson State,59,94,1,-35,2015-12-02
Florida Memorial,Jacksonville,73,92,1,-19,2015-12-02
Florida A&M,Kennesaw State,41,61,1,-20,2015-12-02
Hofstra,La Salle,84,80,0,4,2015-12-02
St. Francis (NY),Lafayette,69,62,0,7,2015-12-02
Texas-Rio Grande Valley,Lamar,60,83,1,-23,2015-12-02
North Florida,LSU,108,119,1,-11,2015-12-02
Army,Maine,84,71,0,13,2015-12-02
Grambling,Marquette,49,95,1,-46,2015-12-02
Boston University,UMass,69,99,1,-30,2015-12-02
Hiwassee,Mercer,47,82,1,-35,2015-12-02
Louisville,Michigan State,67,71,1,-4,2015-12-02
VCU,Middle Tennessee,62,56,0,6,2015-12-02
Texas Southern,Mississippi State,73,86,1,-13,2015-12-02
UTEP,New Mexico State,59,73,1,-14,2015-12-02
Mercy,Norfolk State,65,71,1,-6,2015-12-02
UNC Greensboro,North Carolina A&T,68,77,1,-9,2015-12-02
Coker,UNC Wilmington,73,93,1,-20,2015-12-02
Harvard,Northeastern,71,80,1,-9,2015-12-02
Hampton,Northern Arizona,98,94,0,4,2015-12-02
Chicago State,Northern Illinois,58,80,1,-22,2015-12-02
Tulsa,Oklahoma State,66,56,0,10,2015-12-02
Loyola Marymount,Oregon State,70,79,1,-9,2015-12-02
Navy,Penn,65,59,0,6,2015-12-02
Portland,Portland State,78,72,0,6,2015-12-02
Gardner-Webb,Presbyterian,87,76,0,11,2015-12-02
Hartford,Providence,66,89,1,-23,2015-12-02
Holy Cross,Rhode Island,56,74,1,-18,2015-12-02
St. Peter's,Rider,73,61,0,12,2015-12-02
Lehigh,Saint Francis (PA),73,84,1,-11,2015-12-02
Morehead State,Saint Louis,60,46,0,14,2015-12-02
Bethesda University (CA),San Diego,56,71,1,-15,2015-12-02
Antelope Valley,San Jose State,60,90,1,-30,2015-12-02
Georgia Southern,Savannah State,67,76,1,-9,2015-12-02
Wayne State (NE),South Dakota State,53,80,1,-27,2015-12-02
Southeast Missouri State,Southern Illinois,50,74,1,-24,2015-12-02
UCF,Stetson,94,85,0,9,2015-12-02
Wisconsin,Syracuse,66,58,0,8,2015-12-02
Fairleigh Dickinson,Temple,70,79,1,-9,2015-12-02
ETSU,Tennessee Tech,61,63,1,-2,2015-12-02
Florida Gulf Coast,Texas A&M,65,75,1,-10,2015-12-02
Austin Peay,Texas A&M-Corpus Christi,48,61,1,-13,2015-12-02
SMU,TCU,75,70,0,5,2015-12-02
UTSA,Texas State,53,76,1,-23,2015-12-02
Sam Houston State,Texas Tech,56,71,1,-15,2015-12-02
Cleveland State,Toledo,65,76,1,-11,2015-12-02
George Mason,Towson,54,75,1,-21,2015-12-02
New Orleans,Tulane,62,64,1,-2,2015-12-02
BYU,Utah,75,83,1,-8,2015-12-02
Detroit,Vanderbilt,52,102,1,-50,2015-12-02
Central Pennsylvania College,VMI,72,107,1,-35,2015-12-02
Morgan State,Wagner,61,62,1,-1,2015-12-02
Gonzaga,Washington State,69,60,0,9,2015-12-02
Silver Lake,Western Illinois,49,84,1,-35,2015-12-02
Bryant,Yale,40,79,1,-39,2015-12-02
Robert Morris,Youngstown State,58,65,1,-7,2015-12-02
New Hampshire,Abilene Christian,86,75,0,11,2015-12-03
Auburn Montgomery,Alabama State,78,80,1,-2,2015-12-03
Trinity Baptist,Bethune-Cookman,49,78,1,-29,2015-12-03
Purdue-Fort Wayne,Cal Poly,75,73,0,2,2015-12-03
Northern Colorado,UC-Riverside,66,77,1,-11,2015-12-03
USC,UCSB,75,63,0,12,2015-12-03
Long Beach State,Colorado State,83,77,0,6,2015-12-03
South Florida,Delaware,58,67,1,-9,2015-12-03
Master's,Fresno State,72,84,1,-12,2015-12-03
Central Michigan,Grand Canyon,72,75,1,-3,2015-12-03
Dallas Christian,Incarnate Word,71,108,1,-37,2015-12-03
Western Michigan,James Madison,57,63,1,-6,2015-12-03
UMass-Lowell,LIU-Brooklyn,72,84,1,-12,2015-12-03
Louisiana,Louisiana-Monroe,70,81,1,-11,2015-12-03
SIU-Edwardsville,Milwaukee,51,64,1,-13,2015-12-03
Mississippi Valley State,North Carolina Central,79,86,1,-7,2015-12-03
Central Arkansas,Oklahoma,68,111,1,-43,2015-12-03
Liberty,Radford,52,56,1,-4,2015-12-03
La Verne,Southern Utah,85,105,1,-20,2015-12-03
North Texas,Texas-Arlington,67,90,1,-23,2015-12-03
Kentucky,UCLA,77,87,1,-10,2015-12-03
Belmont,Valparaiso,57,61,1,-4,2015-12-03
Warren Wilson,Western Carolina,45,96,1,-51,2015-12-03
Kentucky Christian,Wofford,66,86,1,-20,2015-12-03
North Dakota State,Arkansas State,74,73,0,1,2015-12-04
Monmouth,Canisius,86,96,1,-10,2015-12-04
St. Joseph's,Columbia,80,78,0,2,2015-12-04
Pitt,Duquesne,96,75,0,21,2015-12-04
USC Upstate,East Carolina,71,82,1,-11,2015-12-04
Rider,Fairfield,70,74,1,-4,2015-12-04
Elon,Florida International,77,71,0,6,2015-12-04
Kansas State,Georgia,68,66,0,2,2015-12-04
Jackson State,Louisiana Tech,88,95,1,-7,2015-12-04
Iona,Marist,101,66,0,35,2015-12-04
Akron,Marshall,75,65,0,10,2015-12-04
Saint Francis (PA),Maryland,55,96,1,-41,2015-12-04
Northern Illinois,Missouri,71,78,1,-7,2015-12-04
San Francisco,Montana,50,82,1,-32,2015-12-04
Oregon,UNLV,69,80,1,-11,2015-12-04
Quinnipiac,Niagara,72,76,1,-4,2015-12-04
Delaware State,Old Dominion,38,82,1,-44,2015-12-04
UC-Irvine,Pacific,70,67,0,3,2015-12-04
UC-Davis,Saint Mary's,67,81,1,-14,2015-12-04
Cal State Fullerton,Seattle,70,61,0,9,2015-12-04
Manhattan,Siena,54,89,1,-35,2015-12-04
Southern,Southeastern Louisiana,73,69,0,4,2015-12-04
Alabama,Southern Miss,58,55,0,3,2015-12-04
Samford,Texas,49,59,1,-10,2015-12-04
Arkansas,Wake Forest,85,88,1,-3,2015-12-04
Georgia State,Wright State,59,46,0,13,2015-12-04
American,Youngstown State,60,56,0,4,2015-12-04
Texas A&M,Arizona State,54,67,1,-13,2015-12-05
New Orleans,Ball State,52,66,1,-14,2015-12-05
Drake,Bowling Green State,63,75,1,-12,2015-12-05
North Dakota,Bradley,65,59,0,6,2015-12-05
Weber State,BYU,68,73,1,-5,2015-12-05
Brown,Bryant,76,68,0,8,2015-12-05
Indiana State,Butler,71,85,1,-14,2015-12-05
Fresno State,Cal Poly,65,77,1,-12,2015-12-05
Northern Arizona,Cal State Bakersfield,55,72,1,-17,2015-12-05
Pepperdine,Cal State Northridge,70,55,0,15,2015-12-05
Quinnipiac,Canisius,78,76,0,2,2015-12-05
UIC,UCF,58,88,1,-30,2015-12-05
College of Charleston,Citadel,82,74,0,8,2015-12-05
Kent State,Cleveland State,66,62,0,4,2015-12-05
Hampton,Coppin State,74,71,0,3,2015-12-05
Lafayette,Cornell,67,85,1,-18,2015-12-05
Hartford,Dartmouth,65,74,1,-9,2015-12-05
North Florida,Dayton,71,86,1,-15,2015-12-05
Air Force,Denver,61,59,0,2,2015-12-05
Chicago State,DePaul,72,96,1,-24,2015-12-05
Northeastern,Detroit,73,76,1,-3,2015-12-05
Buffalo,Duke,59,82,1,-23,2015-12-05
Northern Kentucky,Eastern Illinois,73,79,1,-6,2015-12-05
South Carolina State,Florida A&M,79,67,0,12,2015-12-05
Central Connecticut,Fordham,54,86,1,-32,2015-12-05
High Point,Gardner-Webb,66,64,0,2,2015-12-05
Penn,George Mason,44,63,1,-19,2015-12-05
Syracuse,Georgetown,72,79,1,-7,2015-12-05
Arizona,Gonzaga,68,63,0,5,2015-12-05
Albany (NY),Holy Cross,88,84,0,4,2015-12-05
Little Rock,Idaho,64,54,0,10,2015-12-05
Western Carolina,Illinois,68,80,1,-12,2015-12-05
Alabama-Birmingham,Illinois State,74,61,0,13,2015-12-05
Morehead State,Indiana,59,92,1,-33,2015-12-05
UMKC,Iowa,75,95,1,-20,2015-12-05
Miami (OH),IUPUI,64,78,1,-14,2015-12-05
Jacksonville,Jacksonville State,86,82,0,4,2015-12-05
Harvard,Kansas,69,75,1,-6,2015-12-05
Drexel,La Salle,66,53,0,13,2015-12-05
Idaho State,Lamar,70,82,1,-12,2015-12-05
Rochester (MI),Lehigh,50,84,1,-34,2015-12-05
Charleston Southern,Liberty,68,61,0,7,2015-12-05
Tennessee Tech,Lipscomb,81,78,0,3,2015-12-05
New Mexico State,Long Beach State,53,67,1,-14,2015-12-05
UMBC,Longwood,70,59,0,11,2015-12-05
Grand Canyon,Louisville,63,111,1,-48,2015-12-05
Creighton,Loyola (IL),65,68,1,-3,2015-12-05
Maine,Marquette,67,104,1,-37,2015-12-05
Ole Miss,UMass,74,64,0,10,2015-12-05
Southeast Missouri State,Memphis,65,80,1,-15,2015-12-05
Alcorn State,Mercer,43,68,1,-25,2015-12-05
Charlotte,Miami (FL),60,88,1,-28,2015-12-05
Houston Baptist,Michigan,57,82,1,-25,2015-12-05
Binghamton,Michigan State,33,76,1,-43,2015-12-05
South Alabama,Middle Tennessee,55,68,1,-13,2015-12-05
South Dakota,Minnesota,85,81,0,4,2015-12-05
Loyola (MD),Mount St. Mary's,68,85,1,-17,2015-12-05
Evansville,Murray State,85,81,0,4,2015-12-05
Abilene Christian,Nebraska,63,73,1,-10,2015-12-05
Loyola (LA),Nicholls State,74,89,1,-15,2015-12-05
UMass-Lowell,NJIT,77,90,1,-13,2015-12-05
Johnson & Wales (NC),UNC Asheville,36,103,1,-67,2015-12-05
Howard,North Carolina A&T,63,66,1,-3,2015-12-05
Maryland-Eastern Shore,North Carolina Central,59,70,1,-11,2015-12-05
Bucknell,NC State,86,99,1,-13,2015-12-05
Southern Illinois,North Texas,95,63,0,32,2015-12-05
SIU-Edwardsville,Northwestern,56,81,1,-25,2015-12-05
VMI,Ohio State,62,89,1,-27,2015-12-05
Missouri State,Oklahoma State,64,63,0,1,2015-12-05
Nevada,Oregon State,62,66,1,-4,2015-12-05
Eastern Michigan,Penn State,70,81,1,-11,2015-12-05
Boise State,Portland,81,71,0,10,2015-12-05
New Mexico,Purdue,58,70,1,-12,2015-12-05
Providence,Rhode Island,74,72,0,2,2015-12-05
St. Edward's,Rice,72,93,1,-21,2015-12-05
Northern Iowa,Richmond,67,82,1,-15,2015-12-05
Oakland,Robert Morris,92,74,0,18,2015-12-05
Seton Hall,Rutgers,84,55,0,29,2015-12-05
Wichita State,Saint Louis,68,53,0,15,2015-12-05
San Jose State,Santa Clara,75,78,1,-3,2015-12-05
Eastern Kentucky,Savannah State,74,71,0,3,2015-12-05
South Florida,South Carolina,63,81,1,-18,2015-12-05
New Hampshire,SMU,44,98,1,-54,2015-12-05
Ohio,St. Bonaventure,68,81,1,-13,2015-12-05
Texas Southern,Stephen F. Austin,62,66,1,-4,2015-12-05
Princeton,Stony Brook,77,91,1,-14,2015-12-05
Stetson,Tennessee State,54,74,1,-20,2015-12-05
Texas State,Texas A&M-Corpus Christi,39,47,1,-8,2015-12-05
Colgate,TCU,49,76,1,-27,2015-12-05
Texas-Arlington,UTEP,76,62,0,14,2015-12-05
Sacred Heart,Towson,61,83,1,-22,2015-12-05
Austin Peay,Troy,80,71,0,9,2015-12-05
Georgia Tech,Tulane,76,68,0,8,2015-12-05
Oral Roberts,Tulsa,70,68,0,2,2015-12-05
Purdue-Fort Wayne,Utah,79,96,1,-17,2015-12-05
Southern Utah,Utah Valley,68,54,0,14,2015-12-05
William & Mary,Virginia,52,67,1,-15,2015-12-05
Arkansas-Pine Bluff,Virginia Tech,45,80,1,-35,2015-12-05
Kennesaw State,West Virginia,54,87,1,-33,2015-12-05
Presbyterian,Winthrop,70,74,1,-4,2015-12-05
Temple,Wisconsin,60,76,1,-16,2015-12-05
California,Wyoming,78,72,0,6,2015-12-05
Western Kentucky,Xavier,64,95,1,-31,2015-12-05
Vermont,Yale,54,72,1,-18,2015-12-05
Vanderbilt,Baylor,67,69,1,-2,2015-12-06
UMass-Lowell,Boston College,68,66,0,2,2015-12-06
Morgan State,Cincinnati,66,87,1,-21,2015-12-06
Wofford,Clemson,51,66,1,-15,2015-12-06
Radford,Coastal Carolina,58,63,1,-5,2015-12-06
Colorado,Colorado State,88,77,0,11,2015-12-06
Delaware,Columbia,69,82,1,-13,2015-12-06
Great Falls,Eastern Washington,64,104,1,-40,2015-12-06
Florida Gulf Coast,Florida International,84,76,0,8,2015-12-06
VCU,Florida State,71,76,1,-5,2015-12-06
Toledo,Green Bay,71,69,0,2,2015-12-06
Appalachian State,Hofstra,80,86,1,-6,2015-12-06
Marshall,James Madison,84,107,1,-23,2015-12-06
UC-Riverside,Loyola Marymount,76,77,1,-1,2015-12-06
Marist,Manhattan,75,70,0,5,2015-12-06
Omaha,Montana State,100,97,0,3,2015-12-06
Monmouth,Niagara,56,42,0,14,2015-12-06
Davidson,UNC,65,98,1,-33,2015-12-06
Central Arkansas,Pitt,47,100,1,-53,2015-12-06
UC-Irvine,Saint Mary's,60,70,1,-10,2015-12-06
Siena,St. Peter's,68,72,1,-4,2015-12-06
Sul Ross State,Sam Houston State,61,109,1,-48,2015-12-06
San Diego State,San Diego,48,53,1,-5,2015-12-06
Mississippi Valley State,Seattle,72,84,1,-12,2015-12-06
North Dakota State,Southern Miss,62,74,1,-12,2015-12-06
St. Francis (NY),St. John's (NY),56,63,1,-7,2015-12-06
Angelo State,Texas-Rio Grande Valley,75,76,1,-1,2015-12-06
Long Beach State,UCLA,76,83,1,-7,2015-12-06
American,Wagner,48,55,1,-7,2015-12-06
Cal State Fullerton,Washington,69,87,1,-18,2015-12-06
Portland State,Washington State,67,91,1,-24,2015-12-06
South Carolina State,Bethune-Cookman,54,69,1,-15,2015-12-07
VMI,Butler,66,93,1,-27,2015-12-07
Aquinas,Central Michigan,51,90,1,-39,2015-12-07
East Carolina,College of Charleston,73,77,1,-4,2015-12-07
Norfolk State,Coppin State,88,56,0,32,2015-12-07
Brown,Georgetown,57,74,1,-17,2015-12-07
Western Illinois,Iowa,56,90,1,-34,2015-12-07
Buffalo,Iowa State,63,84,1,-21,2015-12-07
Thomas University,Kennesaw State,59,69,1,-10,2015-12-07
Belmont,Lipscomb,93,84,0,9,2015-12-07
Oregon,Navy,67,47,0,20,2015-12-07
Kent State,NJIT,80,75,0,5,2015-12-07
Maryland-Eastern Shore,North Carolina A&T,74,80,1,-6,2015-12-07
Howard,North Carolina Central,71,69,0,2,2015-12-07
Binghamton,Oakland,72,83,1,-11,2015-12-07
Montreat,Presbyterian,69,93,1,-24,2015-12-07
IUPUI,Purdue,53,80,1,-27,2015-12-07
Incarnate Word,Sacramento State,70,73,1,-3,2015-12-07
Biola,San Diego State,53,73,1,-20,2015-12-07
Cal State Northridge,San Francisco,61,65,1,-4,2015-12-07
Idaho,USC,55,74,1,-19,2015-12-07
Oklahoma,Villanova,78,55,0,23,2015-12-07
Northeastern,Western Michigan,86,87,1,-1,2015-12-07
Evansville,Arkansas,76,89,1,-13,2015-12-08
Northwestern State,Baylor,62,75,1,-13,2015-12-08
Harvard,Boston University,75,69,0,6,2015-12-08
Army,Bryant,77,55,0,22,2015-12-08
UMass,UCF,63,67,1,-4,2015-12-08
Tennessee Wesleyan,Chattanooga,63,91,1,-28,2015-12-08
Voorhees,Citadel,85,89,1,-4,2015-12-08
Maryland,UConn,76,66,0,10,2015-12-08
UMBC,Duquesne,70,89,1,-19,2015-12-08
Rochester (MI),Eastern Michigan,58,86,1,-28,2015-12-08
LIU-Brooklyn,Fordham,84,89,1,-5,2015-12-08
Liberty,Furman,56,79,1,-23,2015-12-08
Northern Iowa,George Mason,73,65,0,8,2015-12-08
Penn State,George Washington,66,76,1,-10,2015-12-08
Winthrop,Georgia,64,74,1,-10,2015-12-08
Montana,Gonzaga,58,61,1,-3,2015-12-08
Southern,Grand Canyon,56,70,1,-14,2015-12-08
Hawaii-Hilo,Hawaii,67,86,1,-19,2015-12-08
Louisiana State-Shreveport,Louisiana Tech,49,82,1,-33,2015-12-08
Towson,Loyola (MD),65,54,0,11,2015-12-08
San Jose State,Marquette,62,80,1,-18,2015-12-08
Florida,Miami (FL),55,66,1,-11,2015-12-08
South Dakota State,Minnesota,84,70,0,14,2015-12-08
Bucknell,Mount St. Mary's,73,81,1,-8,2015-12-08
Worcester State,New Hampshire,66,100,1,-34,2015-12-08
Stony Brook,Notre Dame,61,86,1,-25,2015-12-08
Air Force,Ohio State,50,74,1,-24,2015-12-08
Idaho State,Portland,66,65,0,1,2015-12-08
Houston,Rhode Island,57,67,1,-10,2015-12-08
Wagner,Rider,65,64,0,1,2015-12-08
Central Connecticut,Rutgers,59,75,1,-16,2015-12-08
Princeton,St. Joseph's,50,62,1,-12,2015-12-08
UMKC,South Dakota,70,79,1,-9,2015-12-08
Bowling Green State,Southeast Missouri State,79,52,0,27,2015-12-08
Michigan,SMU,58,82,1,-24,2015-12-08
Vermont,St. Bonaventure,68,80,1,-12,2015-12-08
Henderson State,Stephen F. Austin,54,87,1,-33,2015-12-08
Colgate,Syracuse,51,78,1,-27,2015-12-08
UTSA,Texas,50,116,1,-66,2015-12-08
Bradley,Texas-Arlington,61,97,1,-36,2015-12-08
Iona,Tulsa,81,90,1,-9,2015-12-08
West Virginia,Virginia,54,70,1,-16,2015-12-08
TCU,Washington,67,92,1,-25,2015-12-08
Wright State,Xavier,55,90,1,-35,2015-12-08
Fresno State,Arizona,72,85,1,-13,2015-12-09
Loyola Marymount,Boise State,66,67,1,-1,2015-12-09
Utah State,BYU,68,80,1,-12,2015-12-09
Incarnate Word,California,62,74,1,-12,2015-12-09
Campbell,Charlotte,76,70,0,6,2015-12-09
North Carolina Wesleyan,Coastal Carolina,73,98,1,-25,2015-12-09
Arkansas-Fort Smith,Colorado State,72,97,1,-25,2015-12-09
Nebraska,Creighton,67,83,1,-16,2015-12-09
Eastern Washington,Davidson,86,96,1,-10,2015-12-09
Toledo,Detroit,72,75,1,-3,2015-12-09
DePaul,Drake,74,71,0,3,2015-12-09
Quinnipiac,Hartford,68,66,0,2,2015-12-09
UNC Greensboro,High Point,72,90,1,-18,2015-12-09
Yale,Illinois,65,69,1,-4,2015-12-09
Purdue-Fort Wayne,Indiana,65,90,1,-25,2015-12-09
Valparaiso,Indiana State,69,63,0,6,2015-12-09
Holy Cross,Kansas,59,92,1,-33,2015-12-09
Coppin State,Kansas State,58,83,1,-25,2015-12-09
Eastern Kentucky,Kentucky,67,88,1,-21,2015-12-09
Fairleigh Dickinson,Lafayette,91,89,0,2,2015-12-09
McNeese State,Louisiana,64,97,1,-33,2015-12-09
Dartmouth,Maine,79,69,0,10,2015-12-09
Columbia,Manhattan,72,71,0,1,2015-12-09
Albany (NY),Marist,75,53,0,22,2015-12-09
Eastern Illinois,Marshall,76,82,1,-6,2015-12-09
Maryland-Eastern Shore,Michigan State,35,78,1,-43,2015-12-09
Omaha,Missouri,78,85,1,-7,2015-12-09
Fresno Pacific,Nevada,70,119,1,-49,2015-12-09
York (NE),Northern Colorado,58,91,1,-33,2015-12-09
John Brown,Oral Roberts,53,88,1,-35,2015-12-09
Temple,Penn,77,73,0,4,2015-12-09
Long Beach State,Pepperdine,75,77,1,-2,2015-12-09
Boston College,Providence,51,66,1,-15,2015-12-09
Howard,Purdue,55,93,1,-38,2015-12-09
Virginia Tech,Radford,74,65,0,9,2015-12-09
Denver,San Diego,59,47,0,12,2015-12-09
Hofstra,Siena,68,81,1,-13,2015-12-09
SIU-Edwardsville,Southern Illinois,76,74,0,2,2015-12-09
Niagara,St. John's (NY),44,48,1,-4,2015-12-09
UT-Martin,Texas Tech,49,68,1,-19,2015-12-09
Weber State,Utah Valley,81,84,1,-3,2015-12-09
Dayton,Vanderbilt,72,67,0,5,2015-12-09
UNLV,Wichita State,50,56,1,-6,2015-12-09
Milwaukee,Wisconsin,68,67,0,1,2015-12-09
Utica,Colgate,68,90,1,-22,2015-12-10
Milligan,ETSU,47,98,1,-51,2015-12-10
Ave Maria,Florida Atlantic,59,72,1,-13,2015-12-10
Washington State,Idaho,74,78,1,-4,2015-12-10
Iowa,Iowa State,82,83,1,-1,2015-12-10
Louisiana-Monroe,Kent State,62,73,1,-11,2015-12-10
Cumberland,Lipscomb,53,83,1,-30,2015-12-10
Boston University,UMass-Lowell,80,60,0,20,2015-12-10
IUPUI,Missouri State,74,88,1,-14,2015-12-10
Canisius,Penn State,67,81,1,-14,2015-12-10
Nicholls State,San Diego State,47,84,1,-37,2015-12-10
Troy,Seton Hall,69,78,1,-9,2015-12-10
NJIT,St. Francis (NY),92,86,0,6,2015-12-10
Southern,Wyoming,68,58,0,10,2015-12-10
Valparaiso,Chicago State,71,53,0,18,2015-12-11
North Dakota State,North Dakota,69,67,0,2,2015-12-11
Eastern Washington,Pitt,51,84,1,-33,2015-12-11
North Greenville,USC Upstate,58,70,1,-12,2015-12-11
Prairie View,TCU,55,73,1,-18,2015-12-11
UT-Martin,Texas-Rio Grande Valley,72,64,0,8,2015-12-11
Schreiner,Abilene Christian,46,69,1,-23,2015-12-12
Army,Air Force,90,80,0,10,2015-12-12
Bethune-Cookman,Akron,60,81,1,-21,2015-12-12
Tennessee Tech,Arkansas,57,83,1,-26,2015-12-12
Arkansas-Monticello,Arkansas State,71,104,1,-33,2015-12-12
Pepperdine,Ball State,72,63,0,9,2015-12-12
Oregon,Boise State,72,74,1,-2,2015-12-12
Binghamton,Buffalo,64,80,1,-16,2015-12-12
Tennessee,Butler,86,94,1,-8,2015-12-12
Loyola Marymount,Cal State Fullerton,82,70,0,12,2015-12-12
Saint Mary's,California,59,63,1,-4,2015-12-12
UNLV,UC-Riverside,73,62,0,11,2015-12-12
Florida Atlantic,UCF,61,75,1,-14,2015-12-12
Texas Southern,Central Michigan,71,79,1,-8,2015-12-12
Rider,Charleston Southern,82,72,0,10,2015-12-12
Ohio,Cleveland State,76,67,0,9,2015-12-12
BYU,Colorado,83,92,1,-9,2015-12-12
NJIT,Columbia,56,65,1,-9,2015-12-12
Ohio State,UConn,55,75,1,-20,2015-12-12
IUPUI,Creighton,65,90,1,-25,2015-12-12
Western Carolina,Davidson,54,87,1,-33,2015-12-12
Chattanooga,Dayton,61,59,0,2,2015-12-12
Little Rock,DePaul,66,44,0,22,2015-12-12
Bowling Green State,Detroit,80,95,1,-15,2015-12-12
Mississippi Valley State,Evansville,60,95,1,-35,2015-12-12
Samford,Florida A&M,86,67,0,19,2015-12-12
Pacific,Fresno State,52,71,1,-19,2015-12-12
Gardner-Webb,Furman,73,53,0,20,2015-12-12
Rutgers,George Washington,49,83,1,-34,2015-12-12
UNC Wilmington,Georgetown,82,87,1,-5,2015-12-12
Old Dominion,Georgia State,64,68,1,-4,2015-12-12
UCLA,Gonzaga,71,66,0,5,2015-12-12
Holy Cross,Hartford,90,68,0,22,2015-12-12
Hawaii Pacific,Hawaii,71,83,1,-12,2015-12-12
Arlington Baptist,Houston Baptist,53,110,1,-57,2015-12-12
Radford,Howard,92,91,0,1,2015-12-12
Utah Valley,Idaho State,100,76,0,24,2015-12-12
UIC,Illinois,79,83,1,-4,2015-12-12
McNeese State,Indiana,60,105,1,-45,2015-12-12
Austin Peay,Purdue-Fort Wayne,68,85,1,-17,2015-12-12
Blue Mountain College,Jackson State,37,75,1,-38,2015-12-12
George Mason,James Madison,46,69,1,-23,2015-12-12
Oregon State,Kansas,67,82,1,-15,2015-12-12
Canisius,Kent State,77,84,1,-7,2015-12-12
Arizona State,Kentucky,58,72,1,-14,2015-12-12
Lamar,Liberty,73,58,0,15,2015-12-12
Princeton,Lipscomb,78,64,0,14,2015-12-12
Tampa,Long Beach State,60,87,1,-27,2015-12-12
Louisiana,Louisiana Tech,79,91,1,-12,2015-12-12
Eastern Michigan,Louisville,53,86,1,-33,2015-12-12
Delaware,Marist,70,69,0,1,2015-12-12
Eastern Kentucky,Marshall,72,96,1,-24,2015-12-12
Maryland-Eastern Shore,Maryland,56,77,1,-21,2015-12-12
Mount St. Mary's,UMBC,63,75,1,-12,2015-12-12
Manhattan,Memphis,57,89,1,-32,2015-12-12
Delaware State,Michigan,33,80,1,-47,2015-12-12
Florida,Michigan State,52,58,1,-6,2015-12-12
Auburn,Middle Tennessee,81,88,1,-7,2015-12-12
Mississippi State,UMKC,67,72,1,-5,2015-12-12
Drake,Nevada,71,79,1,-8,2015-12-12
Northern Iowa,New Mexico,57,76,1,-19,2015-12-12
Williams Baptist,New Orleans,66,83,1,-17,2015-12-12
LIU-Brooklyn,Niagara,80,79,0,1,2015-12-12
Belmont Abbey,UNC Greensboro,61,84,1,-23,2015-12-12
Coastal Georgia,North Florida,71,117,1,-46,2015-12-12
Stony Brook,Northeastern,62,75,1,-13,2015-12-12
Oral Roberts,Oklahoma,73,96,1,-23,2015-12-12
Minnesota,Oklahoma State,60,62,1,-2,2015-12-12
Louisiana-Monroe,Penn State,50,54,1,-4,2015-12-12
Sacramento State,Portland,73,81,1,-8,2015-12-12
Bryant,Providence,67,74,1,-7,2015-12-12
Youngstown State,Purdue,64,95,1,-31,2015-12-12
Longwood,Richmond,59,77,1,-18,2015-12-12
Lafayette,Sacred Heart,90,86,0,4,2015-12-12
Duquesne,Saint Francis (PA),67,65,0,2,2015-12-12
Alabama A&M,Saint Louis,58,75,1,-17,2015-12-12
Pacific Union,Santa Clara,66,73,1,-7,2015-12-12
Albany (NY),Siena,70,78,1,-8,2015-12-12
Jacksonville,South Carolina State,74,81,1,-7,2015-12-12
Cal State Bakersfield,South Dakota,77,67,0,10,2015-12-12
Ole Miss,Southeast Missouri State,75,64,0,11,2015-12-12
North Texas,Southern Illinois,66,74,1,-8,2015-12-12
Portland State,SIU-Edwardsville,64,74,1,-10,2015-12-12
Bristol University,Southern Utah,41,79,1,-38,2015-12-12
Dartmouth,Stanford,50,64,1,-14,2015-12-12
Arkansas Tech,Stephen F. Austin,48,86,1,-38,2015-12-12
Grambling,Tennessee State,52,64,1,-12,2015-12-12
UNC,Texas,82,84,1,-2,2015-12-12
Kansas State,Texas A&M,68,78,1,-10,2015-12-12
Texas A&M-Corpus Christi,UTSA,85,79,0,6,2015-12-12
Oakland,Toledo,76,64,0,12,2015-12-12
UC-Irvine,Utah State,73,63,0,10,2015-12-12
Navy,VMI,68,62,0,6,2015-12-12
Montana,Washington,62,92,1,-30,2015-12-12
Eastern Illinois,Western Illinois,57,64,1,-7,2015-12-12
Marygrove,Western Michigan,59,101,1,-42,2015-12-12
Utah,Wichita State,50,67,1,-17,2015-12-12
Marquette,Wisconsin,57,55,0,2,2015-12-12
Cincinnati,Xavier,55,65,1,-10,2015-12-12
Seattle,Alabama-Birmingham,73,79,1,-6,2015-12-13
Missouri,Arizona,52,88,1,-36,2015-12-13
Maine,Boston College,60,91,1,-31,2015-12-13
Alabama,Clemson,51,50,0,1,2015-12-13
New Hampshire,Colgate,59,75,1,-16,2015-12-13
North Greenville,College of Charleston,52,89,1,-37,2015-12-13
Weber State,Denver,68,69,1,-1,2015-12-13
North Carolina A&T,East Carolina,60,71,1,-11,2015-12-13
Wesley,Elon,77,106,1,-29,2015-12-13
UMass,Florida Gulf Coast,76,77,1,-1,2015-12-13
Southeastern Louisiana,Florida State,58,75,1,-17,2015-12-13
Coppin State,Fordham,55,92,1,-37,2015-12-13
Omaha,Grand Canyon,108,104,0,4,2015-12-13
Virginia Wise,High Point,74,111,1,-37,2015-12-13
LSU,Houston,98,105,1,-7,2015-12-13
Murray State,Illinois State,61,63,1,-2,2015-12-13
Arkansas-Pine Bluff,Iowa State,64,78,1,-14,2015-12-13
Alabama State,Jacksonville State,63,60,0,3,2015-12-13
Wright State,Miami (OH),67,72,1,-5,2015-12-13
Judson,Milwaukee,74,125,1,-51,2015-12-13
Tulsa,Missouri State,70,61,0,9,2015-12-13
Wagner,Monmouth,54,73,1,-19,2015-12-13
Rhode Island,Nebraska,67,70,1,-3,2015-12-13
Wyoming,New Mexico State,62,59,0,3,2015-12-13
Campbell,UNC Asheville,60,80,1,-20,2015-12-13
Colorado State,Northern Colorado,64,73,1,-9,2015-12-13
Norfolk State,Northern Kentucky,60,81,1,-21,2015-12-13
Chicago State,Northwestern,35,77,1,-42,2015-12-13
Loyola (IL),Notre Dame,61,81,1,-20,2015-12-13
Morehead State,Pitt,62,72,1,-10,2015-12-13
Boston University,Quinnipiac,64,57,0,7,2015-12-13
Montana State,San Jose State,91,83,0,8,2015-12-13
St. Peter's,Seton Hall,46,72,1,-26,2015-12-13
UCSB,South Dakota State,68,86,1,-18,2015-12-13
NC State,South Florida,65,46,0,19,2015-12-13
Ecclesia,Southern,69,96,1,-27,2015-12-13
Yale,USC,56,68,1,-12,2015-12-13
Syracuse,St. John's (NY),72,84,1,-12,2015-12-13
St. Joseph's,Temple,66,65,0,1,2015-12-13
Texas-Rio Grande Valley,Texas State,59,68,1,-9,2015-12-13
La Salle,Villanova,47,76,1,-29,2015-12-13
Lamar,Virginia Tech,53,88,1,-35,2015-12-13
UTEP,Washington State,68,84,1,-16,2015-12-13
Louisiana-Monroe,West Virginia,58,100,1,-42,2015-12-13
Indiana State,Western Kentucky,62,75,1,-13,2015-12-13
Blue Mountain College,Alcorn State,60,68,1,-8,2015-12-14
Dartmouth,Cal State Bakersfield,62,69,1,-7,2015-12-14
Columbia International,Charleston Southern,74,107,1,-33,2015-12-14
Robert Morris,Columbia,71,78,1,-7,2015-12-14
Saint Martin's,Gonzaga,50,86,1,-36,2015-12-14
Sacred Heart,Hartford,71,80,1,-9,2015-12-14
St. Francis (NY),Manhattan,60,71,1,-11,2015-12-14
North Carolina Central,Marshall,73,92,1,-19,2015-12-14
USC Upstate,Navy,66,57,0,9,2015-12-14
Florida International,North Florida,72,94,1,-22,2015-12-14
Nicholls State,North Texas,60,78,1,-18,2015-12-14
Cal Poly,Saint Mary's,63,93,1,-30,2015-12-14
Le Tourneau,Sam Houston State,54,96,1,-42,2015-12-14
Southern Miss,South Alabama,57,54,0,3,2015-12-14
Tennessee State,Stetson,93,90,0,3,2015-12-14
Prairie View,Tulane,49,63,1,-14,2015-12-14
Eastern Washington,Western Carolina,80,97,1,-17,2015-12-14
Coastal Carolina,Wofford,71,63,0,8,2015-12-14
Mercer,Auburn,71,78,1,-7,2015-12-15
Ouachita,Belmont,54,80,1,-26,2015-12-15
Saint Francis (PA),Binghamton,67,61,0,6,2015-12-15
Tennessee Tech,Chattanooga,69,80,1,-11,2015-12-15
Norfolk State,Cincinnati,59,75,1,-16,2015-12-15
Presbyterian,Clemson,41,69,1,-28,2015-12-15
Georgia Southern,Duke,65,99,1,-34,2015-12-15
Florida Atlantic,Eastern Kentucky,73,80,1,-7,2015-12-15
Southeastern Louisiana,Florida A&M,64,67,1,-3,2015-12-15
Monmouth,Georgetown,83,68,0,15,2015-12-15
VCU,Georgia Tech,64,77,1,-13,2015-12-15
Delaware State,Grand Canyon,59,88,1,-29,2015-12-15
Pacific,Green Bay,88,93,1,-5,2015-12-15
UC-Riverside,Houston Baptist,59,72,1,-13,2015-12-15
Our Lady of the Lake,Incarnate Word,99,97,0,2,2015-12-15
Southern,Memphis,67,72,1,-5,2015-12-15
Jackson State,Miami (OH),53,64,1,-11,2015-12-15
Northern Kentucky,Michigan,62,77,1,-15,2015-12-15
Louisiana Tech,Ole Miss,80,99,1,-19,2015-12-15
Great Falls,Montana,59,79,1,-20,2015-12-15
ETSU,UNC Asheville,64,84,1,-20,2015-12-15
Mississippi Valley State,Northwestern,48,78,1,-30,2015-12-15
Ohio Dominican,Ohio,69,93,1,-24,2015-12-15
Longwood,Oklahoma State,55,73,1,-18,2015-12-15
UC-Irvine,Oregon,63,78,1,-15,2015-12-15
UC-Davis,San Diego,55,61,1,-6,2015-12-15
Arkansas-Pine Bluff,Santa Clara,57,69,1,-12,2015-12-15
Drexel,South Carolina,54,79,1,-25,2015-12-15
DePaul,Stanford,60,79,1,-19,2015-12-15
Appalachian State,Texas,55,67,1,-12,2015-12-15
Louisiana,UCLA,80,89,1,-9,2015-12-15
UNC Greensboro,Wake Forest,71,81,1,-10,2015-12-15
Texas A&M-Corpus Christi,Wisconsin,49,64,1,-15,2015-12-15
Geneva,Youngstown State,58,99,1,-41,2015-12-15
Winthrop,Alabama,60,72,1,-12,2015-12-16
USC Upstate,Alabama-Birmingham,54,96,1,-42,2015-12-16
Northern Arizona,Arizona,37,92,1,-55,2015-12-16
Hardin-Simmons,Baylor,59,104,1,-45,2015-12-16
Citadel,Bethune-Cookman,99,87,0,12,2015-12-16
Johnson & Wales (NC),Campbell,53,87,1,-34,2015-12-16
Little Rock,Central Arkansas,77,54,0,23,2015-12-16
South Carolina State,Duquesne,68,83,1,-15,2015-12-16
UNC Wilmington,East Carolina,73,78,1,-5,2015-12-16
Alabama State,Elon,74,91,1,-17,2015-12-16
Mississippi State,Florida State,66,90,1,-24,2015-12-16
Cal State Bakersfield,Fresno State,68,76,1,-8,2015-12-16
Bluefield College (VA),Furman,46,94,1,-48,2015-12-16
North Carolina Central,Houston,65,73,1,-8,2015-12-16
Illinois State,UIC,72,60,0,12,2015-12-16
Illinois-Springfield,Indiana State,60,75,1,-15,2015-12-16
Texas Southern,Iona,73,83,1,-10,2015-12-16
Gardner-Webb,LSU,57,78,1,-21,2015-12-16
Kennesaw State,Louisville,57,94,1,-37,2015-12-16
Cleveland State,Loyola (IL),60,54,0,6,2015-12-16
New Orleans,UMass,95,103,1,-8,2015-12-16
Louisiana State-Alexandria,McNeese State,72,77,1,-5,2015-12-16
Chicago State,Minnesota,52,70,1,-18,2015-12-16
Oral Roberts,Missouri State,66,85,1,-19,2015-12-16
Simpson,Omaha,71,81,1,-10,2015-12-16
Arizona State,UNLV,66,56,0,10,2015-12-16
New Mexico State,New Mexico,61,79,1,-18,2015-12-16
Tulane,UNC,72,96,1,-24,2015-12-16
High Point,NC State,73,76,1,-3,2015-12-16
Montana State,North Dakota State,64,73,1,-9,2015-12-16
Austin Peay,North Florida,70,80,1,-10,2015-12-16
Denver,Northern Colorado,81,77,0,4,2015-12-16
Northern Illinois,Ohio State,54,67,1,-13,2015-12-16
Texas State,Prairie View,62,44,0,18,2015-12-16
Old Dominion,Richmond,61,77,1,-16,2015-12-16
UT-Martin,Saint Louis,82,76,0,6,2015-12-16
Southern Utah,Saint Mary's,36,92,1,-56,2015-12-16
Jacksonville,South Florida,75,88,1,-13,2015-12-16
Nicholls State,SMU,42,86,1,-44,2015-12-16
Albany State (GA),Stetson,69,95,1,-26,2015-12-16
Florida Atlantic,Tennessee,62,81,1,-19,2015-12-16
East Central,UTSA,61,75,1,-14,2015-12-16
South Dakota State,Texas Tech,67,79,1,-12,2015-12-16
Savannah State,Utah,53,99,1,-46,2015-12-16
UCSB,Vermont,68,75,1,-7,2015-12-16
Alabama A&M,Western Kentucky,70,79,1,-9,2015-12-16
Stony Brook,American,86,68,0,18,2015-12-17
Maryville (MO),Bradley,53,61,1,-8,2015-12-17
Norfolk State,Evansville,70,84,1,-14,2015-12-17
Belmont,Middle Tennessee,62,83,1,-21,2015-12-17
South Dakota,Milwaukee,92,91,0,1,2015-12-17
Grambling,North Carolina A&T,47,61,1,-14,2015-12-17
Valley City State,North Dakota,59,80,1,-21,2015-12-17
Mississippi Valley State,North Texas,74,87,1,-13,2015-12-17
Jackson State,Ohio,67,72,1,-5,2015-12-17
Troy,Paine,85,77,0,8,2015-12-17
Cal State Northridge,Portland State,77,71,0,6,2015-12-17
Liberty,Princeton,72,77,1,-5,2015-12-17
St. Thomas (TX),Rice,54,67,1,-13,2015-12-17
Lehigh,Robert Morris,67,69,1,-2,2015-12-17
Northwest Indian College,Seattle,36,98,1,-62,2015-12-17
Cal Poly,USC,82,101,1,-19,2015-12-17
Hampton,SMU,72,105,1,-33,2015-12-17
Lipscomb,Tennessee State,86,89,1,-3,2015-12-17
Marshall,West Virginia,68,86,1,-18,2015-12-17
Charleston Southern,Wright State,65,71,1,-6,2015-12-17
UC-Riverside,Abilene Christian,60,56,0,4,2015-12-18
Central Michigan,BYU,85,98,1,-13,2015-12-18
Chapman,UC-Irvine,51,65,1,-14,2015-12-18
UMass-Lowell,Central Connecticut,79,83,1,-4,2015-12-18
Kennesaw State,Chattanooga,66,78,1,-12,2015-12-18
South Carolina,Clemson,65,59,0,6,2015-12-18
Nicholls State,Colorado,68,85,1,-17,2015-12-18
Eastern Kentucky,ETSU,81,87,1,-6,2015-12-18
Wagner,Fairfield,76,64,0,12,2015-12-18
Towson,Fairleigh Dickinson,68,69,1,-1,2015-12-18
Warren Wilson,Gardner-Webb,62,107,1,-45,2015-12-18
New Hope Christian,Idaho,54,127,1,-73,2015-12-18
Jarvis Christian,Lamar,56,80,1,-24,2015-12-18
Sam Houston State,LIU-Brooklyn,75,69,0,6,2015-12-18
Central Baptist,Louisiana-Monroe,76,101,1,-25,2015-12-18
Southern,Louisiana Tech,76,83,1,-7,2015-12-18
Jacksonville State,Loyola Marymount,60,77,1,-17,2015-12-18
Ole Miss,Memphis,85,79,0,6,2015-12-18
Southern Illinois,Murray State,88,73,0,15,2015-12-18
Santa Clara,Nevada,69,72,1,-3,2015-12-18
Maryland-Eastern Shore,Old Dominion,47,77,1,-30,2015-12-18
Long Beach State,Oregon,73,94,1,-21,2015-12-18
Cal State Fullerton,Oregon State,69,82,1,-13,2015-12-18
Louisiana,Pepperdine,59,79,1,-20,2015-12-18
Weber State,Portland,92,82,0,10,2015-12-18
South Alabama,Samford,72,70,0,2,2015-12-18
Grand Canyon,San Diego State,52,45,0,7,2015-12-18
Coppin State,San Francisco,93,96,1,-3,2015-12-18
Incarnate Word,St. John's (NY),73,51,0,22,2015-12-18
Arkansas State,UT-Martin,70,74,1,-4,2015-12-18
Miami (OH),Tennessee Tech,64,77,1,-13,2015-12-18
Coastal Carolina,Wake Forest,77,83,1,-6,2015-12-18
Texas State,Washington State,73,78,1,-5,2015-12-18
Mary Washington,William & Mary,64,94,1,-30,2015-12-18
Saint Francis (PA),Albany (NY),58,65,1,-7,2015-12-19
Charlotte,Appalachian State,82,66,0,16,2015-12-19
UNLV,Arizona,70,82,1,-12,2015-12-19
Houston Baptist,Arizona State,79,98,1,-19,2015-12-19
Mercer,Arkansas,69,66,0,3,2015-12-19
Delaware,Boston College,61,69,1,-8,2015-12-19
Montana State,Buffalo,73,80,1,-7,2015-12-19
Menlo,Cal State Bakersfield,50,82,1,-32,2015-12-19
Coppin State,California,51,84,1,-33,2015-12-19
Air Force,UC-Davis,67,60,0,7,2015-12-19
Citadel,Campbell,82,101,1,-19,2015-12-19
Boston University,Canisius,68,84,1,-16,2015-12-19
Western Illinois,Chicago State,70,77,1,-7,2015-12-19
Belmont,Cleveland State,65,67,1,-2,2015-12-19
Hampton,Colorado,53,95,1,-42,2015-12-19
Furman,Dayton,50,70,1,-20,2015-12-19
Northwestern,DePaul,78,70,0,8,2015-12-19
UCF,Detroit,89,95,1,-6,2015-12-19
Penn State,Drexel,63,57,0,6,2015-12-19
Utah,Duke,77,75,0,2,2015-12-19
Robert Morris,Duquesne,65,72,1,-7,2015-12-19
UNC Greensboro,Elon,69,79,1,-10,2015-12-19
Oklahoma State,Florida,70,72,1,-2,2015-12-19
South Dakota State,Florida Gulf Coast,56,52,0,4,2015-12-19
Florida Atlantic,Florida State,59,64,1,-5,2015-12-19
Maine,Fordham,53,70,1,-17,2015-12-19
Longwood,George Mason,70,75,1,-5,2015-12-19
St. Peter's,George Washington,74,87,1,-13,2015-12-19
UNC Asheville,Georgetown,79,73,0,6,2015-12-19
Georgia Tech,Georgia,61,75,1,-14,2015-12-19
Winthrop,Georgia Southern,88,81,0,7,2015-12-19
Tennessee,Gonzaga,79,86,1,-7,2015-12-19
Eastern Illinois,Houston,65,81,1,-16,2015-12-19
UMBC,Howard,93,103,1,-10,2015-12-19
South Dakota,Illinois,79,91,1,-12,2015-12-19
Drake,Iowa,64,70,1,-6,2015-12-19
Northern Iowa,Iowa State,81,79,0,2,2015-12-19
Stetson,Purdue-Fort Wayne,89,95,1,-6,2015-12-19
Southern Utah,IUPUI,68,82,1,-14,2015-12-19
Montana,Kansas,46,88,1,-42,2015-12-19
Colorado State,Kansas State,56,61,1,-5,2015-12-19
Mount St. Mary's,Lehigh,73,76,1,-3,2015-12-19
Oral Roberts,LSU,77,100,1,-23,2015-12-19
Western Kentucky,Louisville,56,78,1,-22,2015-12-19
UIC,Loyola (IL),47,64,1,-17,2015-12-19
Princeton,Maryland,61,82,1,-21,2015-12-19
College of Charleston,Miami (FL),63,85,1,-22,2015-12-19
Youngstown State,Michigan,46,105,1,-59,2015-12-19
Tulane,Mississippi State,59,69,1,-10,2015-12-19
NC State,Missouri,73,59,0,14,2015-12-19
Rockhurst,UMKC,60,71,1,-11,2015-12-19
Dartmouth,New Hampshire,56,76,1,-20,2015-12-19
Rice,New Mexico,90,89,0,1,2015-12-19
Florida A&M,North Florida,70,87,1,-17,2015-12-19
Michigan State,Northeastern,78,58,0,20,2015-12-19
Florida International,Northern Illinois,75,78,1,-3,2015-12-19
Southeast Missouri State,Northern Kentucky,69,79,1,-10,2015-12-19
Missouri Valley,Northwestern State,79,105,1,-26,2015-12-19
Indiana,Notre Dame,80,73,0,7,2015-12-19
Kentucky,Ohio State,67,74,1,-7,2015-12-19
Creighton,Oklahoma,74,87,1,-13,2015-12-19
Tulsa,Oregon State,71,76,1,-5,2015-12-19
Ursinus,Penn,66,73,1,-7,2015-12-19
Cal State Fullerton,Portland,60,65,1,-5,2015-12-19
Piedmont,Presbyterian,65,69,1,-4,2015-12-19
Rider,Providence,65,73,1,-8,2015-12-19
Butler,Purdue,74,68,0,6,2015-12-19
UNC Wilmington,Radford,67,69,1,-2,2015-12-19
Iona,Rhode Island,74,79,1,-5,2015-12-19
Illinois State,St. Joseph's,65,79,1,-14,2015-12-19
Indiana State,Saint Louis,76,68,0,8,2015-12-19
Wichita State,Seton Hall,76,80,1,-4,2015-12-19
Alabama-Birmingham,South Florida,79,68,0,11,2015-12-19
Georgia State,Southern Miss,66,46,0,20,2015-12-19
South Carolina State,St. Bonaventure,45,64,1,-19,2015-12-19
Texas,Stanford,75,73,0,2,2015-12-19
Our Lady of the Lake,Stephen F. Austin,56,95,1,-39,2015-12-19
Cornell,Syracuse,46,67,1,-21,2015-12-19
Delaware State,Temple,63,78,1,-15,2015-12-19
Alcorn State,Tennessee State,76,81,1,-5,2015-12-19
Baylor,Texas A&M,61,80,1,-19,2015-12-19
New Mexico State,UTEP,73,53,0,20,2015-12-19
Utah Valley,UTSA,83,78,0,5,2015-12-19
Arkansas-Pine Bluff,Texas Tech,54,94,1,-40,2015-12-19
Bethune-Cookman,Toledo,68,102,1,-34,2015-12-19
UNC,UCLA,89,76,0,13,2015-12-19
Missouri State,Valparaiso,45,74,1,-29,2015-12-19
Wofford,Vanderbilt,56,80,1,-24,2015-12-19
Fisher College,Vermont,37,84,1,-47,2015-12-19
Villanova,Virginia,75,86,1,-11,2015-12-19
Cincinnati,VCU,69,63,0,6,2015-12-19
Grambling,Virginia Tech,52,87,1,-35,2015-12-19
Oakland,Washington,97,83,0,14,2015-12-19
Omaha,Wyoming,75,76,1,-1,2015-12-19
Auburn,Xavier,61,85,1,-24,2015-12-19
Maryland-Eastern Shore,American,79,64,0,15,2015-12-20
Northern Arizona,Little Rock,57,84,1,-27,2015-12-20
Marist,Army,89,83,0,6,2015-12-20
Bradley,Boise State,70,90,1,-20,2015-12-20
Bethesda University (CA),Cal State Northridge,49,79,1,-30,2015-12-20
Life Pacific,UC-Riverside,48,95,1,-47,2015-12-20
Alabama State,Coastal Carolina,65,68,1,-3,2015-12-20
UMass-Lowell,UConn,79,88,1,-9,2015-12-20
Pitt,Davidson,94,69,0,25,2015-12-20
Eastern Washington,Denver,74,58,0,16,2015-12-20
Evansville,Fresno State,85,77,0,8,2015-12-20
Wisconsin-Superior,Green Bay,57,108,1,-51,2015-12-20
East Carolina,James Madison,61,67,1,-6,2015-12-20
Austin Peay,Lipscomb,92,84,0,8,2015-12-20
Western Carolina,Morehead State,52,60,1,-8,2015-12-20
Manhattan,Morgan State,78,66,0,12,2015-12-20
Samford,Nebraska,69,58,0,11,2015-12-20
Monmouth,Rutgers,73,67,0,6,2015-12-20
San Jose State,Seattle,64,67,1,-3,2015-12-20
Liberty,St. Francis (NY),55,64,1,-9,2015-12-20
NJIT,St. John's (NY),83,74,0,9,2015-12-20
Hofstra,Stony Brook,68,71,1,-3,2015-12-20
Cal Poly,Texas A&M-Corpus Christi,74,80,1,-6,2015-12-20
Abilene Christian,TCU,69,80,1,-11,2015-12-20
Rio Grande,Towson,47,88,1,-41,2015-12-20
Bowling Green State,Wright State,47,83,1,-36,2015-12-20
Oregon,Alabama,72,68,0,4,2015-12-21
New Hampshire,Boston University,74,78,1,-4,2015-12-21
Sam Houston State,UC-Irvine,53,63,1,-10,2015-12-21
Akron,UCSB,84,70,0,14,2015-12-21
USC Upstate,Colorado State,61,89,1,-28,2015-12-21
Eastern Michigan,Coppin State,73,62,0,11,2015-12-21
North Texas,Creighton,82,105,1,-23,2015-12-21
Omaha,Eastern Illinois,80,68,0,12,2015-12-21
Charleston Southern,Florida State,64,75,1,-11,2015-12-21
VMI,Gardner-Webb,76,75,0,1,2015-12-21
Southeastern Louisiana,Georgia Tech,62,75,1,-13,2015-12-21
Pepperdine,Gonzaga,73,99,1,-26,2015-12-21
Maine,Holy Cross,75,76,1,-1,2015-12-21
Grand Canyon,Houston,78,69,0,9,2015-12-21
North Dakota State,Idaho State,67,62,0,5,2015-12-21
Florida A&M,Jacksonville,66,68,1,-2,2015-12-21
Northern Colorado,Jacksonville State,76,79,1,-3,2015-12-21
Texas Lutheran,Lamar,69,86,1,-17,2015-12-21
New Orleans,Louisiana,69,79,1,-10,2015-12-21
Western Illinois,Loyola (IL),67,72,1,-5,2015-12-21
Chicago State,Marquette,74,91,1,-17,2015-12-21
Wyoming,Marshall,82,90,1,-8,2015-12-21
Providence,UMass,90,66,0,24,2015-12-21
Oral Roberts,New Mexico State,61,76,1,-15,2015-12-21
Appalachian State,UNC,70,94,1,-24,2015-12-21
Elon,UNC Asheville,86,81,0,5,2015-12-21
Southern,North Carolina Central,68,63,0,5,2015-12-21
Sacred Heart,Northwestern,67,103,1,-36,2015-12-21
Youngstown State,Notre Dame,78,87,1,-9,2015-12-21
Arkansas-Pine Bluff,Ohio,58,65,1,-7,2015-12-21
Quinnipiac,Oregon State,61,82,1,-21,2015-12-21
Santa Clara,Pacific,72,73,1,-1,2015-12-21
Loyola Marymount,Portland,60,87,1,-27,2015-12-21
Southern Illinois,Saint Louis,65,52,0,13,2015-12-21
San Francisco,Saint Mary's,52,74,1,-22,2015-12-21
SIU-Edwardsville,USC,51,70,1,-19,2015-12-21
Sacramento State,Stanford,60,70,1,-10,2015-12-21
Alcorn State,UT-Martin,47,70,1,-23,2015-12-21
Sul Ross State,Texas-Arlington,40,98,1,-58,2015-12-21
Norfolk State,UTEP,85,76,0,9,2015-12-21
Howard Payne,Texas State,43,92,1,-49,2015-12-21
North Carolina A&T,Toledo,62,95,1,-33,2015-12-21
Texas-Rio Grande Valley,Utah State,69,94,1,-25,2015-12-21
Eastern Kentucky,West Virginia,59,84,1,-25,2015-12-21
High Point,William & Mary,75,78,1,-3,2015-12-21
Johnson & Wales,Air Force,56,80,1,-24,2015-12-22
Hiwassee,Alabama-Birmingham,43,116,1,-73,2015-12-22
Long Beach State,Arizona,70,85,1,-15,2015-12-22
Stephen F. Austin,Arizona State,73,80,1,-7,2015-12-22
North Florida,Arkansas,72,97,1,-25,2015-12-22
Central Arkansas,Arkansas State,67,77,1,-10,2015-12-22
Wofford,Austin Peay,77,84,1,-7,2015-12-22
Florida International,Binghamton,66,49,0,17,2015-12-22
Fordham,Boston College,55,64,1,-9,2015-12-22
Marist,Brown,84,83,0,1,2015-12-22
Southern Utah,Butler,52,88,1,-36,2015-12-22
Portland State,Cal State Bakersfield,66,78,1,-12,2015-12-22
Idaho,UC-Davis,68,51,0,17,2015-12-22
Denver,UC-Riverside,54,63,1,-9,2015-12-22
Iona,UCSB,76,80,1,-4,2015-12-22
College of Charleston,Campbell,86,68,0,18,2015-12-22
Louisiana-Monroe,Canisius,96,108,1,-12,2015-12-22
Bethune-Cookman,UCF,96,101,1,-5,2015-12-22
Howard,Central Michigan,52,72,1,-20,2015-12-22
Georgetown,Charlotte,62,59,0,3,2015-12-22
Radford,Chattanooga,75,77,1,-2,2015-12-22
Iowa State,Cincinnati,81,79,0,2,2015-12-22
Longwood,Dartmouth,54,78,1,-24,2015-12-22
Miami (OH),Dayton,63,64,1,-1,2015-12-22
George Washington,DePaul,61,82,1,-21,2015-12-22
Abilene Christian,Drake,70,87,1,-17,2015-12-22
Penn,Drexel,52,53,1,-1,2015-12-22
South Carolina State,East Carolina,71,98,1,-27,2015-12-22
Alabama A&M,Evansville,70,91,1,-21,2015-12-22
Loyola (MD),Fairfield,88,94,1,-6,2015-12-22
Jacksonville,Florida,65,89,1,-24,2015-12-22
Louisiana Tech,Florida Gulf Coast,66,63,0,3,2015-12-22
Wagner,George Mason,60,71,1,-11,2015-12-22
Clemson,Georgia,48,71,1,-23,2015-12-22
Stetson,Georgia Southern,58,78,1,-20,2015-12-22
Middle Tennessee,Georgia State,62,64,1,-2,2015-12-22
Nicholls State,Hampton,84,81,0,3,2015-12-22
Widener,Hartford,46,69,1,-23,2015-12-22
BYU,Harvard,82,85,1,-3,2015-12-22
Northern Iowa,Hawaii,52,68,1,-16,2015-12-22
Florida Atlantic,Hofstra,54,68,1,-14,2015-12-22
Purdue Calumet,UIC,74,91,1,-17,2015-12-22
Tennessee State,Illinois State,55,66,1,-11,2015-12-22
Kennesaw State,Indiana,72,99,1,-27,2015-12-22
Ball State,Indiana State,61,73,1,-12,2015-12-22
Tennessee Tech,Iowa,63,85,1,-22,2015-12-22
Mount St. Mary's,James Madison,53,73,1,-20,2015-12-22
North Dakota,Kansas State,49,63,1,-14,2015-12-22
Miami (FL),La Salle,95,49,0,46,2015-12-22
Stony Brook,Lehigh,75,62,0,13,2015-12-22
Incarnate Word,LIU-Brooklyn,59,66,1,-7,2015-12-22
American,LSU,51,79,1,-28,2015-12-22
UMKC,Louisville,47,75,1,-28,2015-12-22
Grand Canyon,Marshall,85,81,0,4,2015-12-22
Central Pennsylvania College,Maryland-Eastern Shore,86,115,1,-29,2015-12-22
IUPUI,Memphis,48,84,1,-36,2015-12-22
Troy,Ole Miss,80,83,1,-3,2015-12-22
Southeast Missouri State,Missouri State,78,74,0,4,2015-12-22
Montana Western,Montana,43,75,1,-32,2015-12-22
Furman,Navy,49,62,1,-13,2015-12-22
Prairie View,Nebraska,50,81,1,-31,2015-12-22
Southern,Omaha,53,74,1,-21,2015-12-22
South Dakota,UNLV,68,103,1,-35,2015-12-22
Auburn,New Mexico,83,78,0,5,2015-12-22
UC-Irvine,Norfolk State,80,62,0,18,2015-12-22
Eastern Illinois,North Carolina Central,52,57,1,-5,2015-12-22
UNC Greensboro,NC State,52,58,1,-6,2015-12-22
Utah Valley,UNC Wilmington,77,102,1,-25,2015-12-22
Vermont,Northeastern,65,77,1,-12,2015-12-22
Roosevelt,Northern Illinois,52,85,1,-33,2015-12-22
Michigan State,Oakland,99,93,0,6,2015-12-22
Mercer,Ohio State,44,64,1,-20,2015-12-22
Rhode Island,Old Dominion,65,71,1,-6,2015-12-22
Colorado,Penn State,71,70,0,1,2015-12-22
Bucknell,Princeton,77,89,1,-12,2015-12-22
Vanderbilt,Purdue,55,68,1,-13,2015-12-22
Presbyterian,Richmond,44,74,1,-30,2015-12-22
Virginia Tech,St. Joseph's,62,79,1,-17,2015-12-22
Kansas,San Diego State,70,57,0,13,2015-12-22
Life Pacific,San Jose State,66,128,1,-62,2015-12-22
South Florida,Seton Hall,49,66,1,-17,2015-12-22
St. Bonaventure,Siena,70,73,1,-3,2015-12-22
Rice,South Alabama,67,74,1,-7,2015-12-22
St. John's (NY),South Carolina,61,75,1,-14,2015-12-22
Kent State,SMU,74,90,1,-16,2015-12-22
Montana State,Syracuse,60,82,1,-22,2015-12-22
ETSU,Tennessee,67,76,1,-9,2015-12-22
Sam Houston State,UTEP,68,87,1,-19,2015-12-22
North Dakota State,Texas-Rio Grande Valley,68,50,0,18,2015-12-22
Cal Poly,UTSA,88,73,0,15,2015-12-22
Little Rock,Texas Tech,53,65,1,-12,2015-12-22
Southern Miss,Tulane,40,59,1,-19,2015-12-22
Northern Arizona,Tulsa,55,90,1,-35,2015-12-22
McNeese State,UCLA,53,67,1,-14,2015-12-22
Delaware State,Utah,58,105,1,-47,2015-12-22
Idaho State,Utah State,58,69,1,-11,2015-12-22
Delaware,Villanova,48,78,1,-30,2015-12-22
California,Virginia,62,63,1,-1,2015-12-22
Buffalo,VCU,69,90,1,-21,2015-12-22
Xavier,Wake Forest,78,70,0,8,2015-12-22
Seattle,Washington,68,79,1,-11,2015-12-22
Oklahoma,Washington State,88,60,0,28,2015-12-22
South Dakota State,Weber State,95,99,1,-4,2015-12-22
Detroit,Western Kentucky,74,79,1,-5,2015-12-22
Purdue-Fort Wayne,Western Michigan,89,86,0,3,2015-12-22
Nevada,Wichita State,69,98,1,-29,2015-12-22
Alabama State,Winthrop,84,92,1,-8,2015-12-22
Murray State,Wright State,49,65,1,-16,2015-12-22
Houston,Wyoming,94,89,0,5,2015-12-22
Niagara,Albany (NY),56,65,1,-9,2015-12-23
New Mexico State,Baylor,70,85,1,-15,2015-12-23
TCU,Bradley,53,49,0,4,2015-12-23
New Mexico,BYU,66,96,1,-30,2015-12-23
Nicholls State,Canisius,74,83,1,-9,2015-12-23
Bowling Green State,Cleveland State,62,47,0,15,2015-12-23
Central Connecticut,UConn,52,99,1,-47,2015-12-23
Monmouth,Cornell,78,69,0,9,2015-12-23
Morehead State,Davidson,77,81,1,-4,2015-12-23
Colgate,Georgia Tech,60,76,1,-16,2015-12-23
Loyola Marymount,Gonzaga,62,85,1,-23,2015-12-23
Auburn,Harvard,51,69,1,-18,2015-12-23
Oklahoma,Hawaii,84,81,0,3,2015-12-23
Texas-Rio Grande Valley,Idaho State,64,76,1,-12,2015-12-23
Missouri,Illinois,63,68,1,-5,2015-12-23
Akron,Iona,78,64,0,14,2015-12-23
Penn State,Kent State,75,69,0,6,2015-12-23
Hampton,Louisiana-Monroe,75,64,0,11,2015-12-23
Utah Valley,Louisville,68,98,1,-30,2015-12-23
Bryant,Michigan,60,96,1,-36,2015-12-23
Milwaukee,Minnesota,74,65,0,9,2015-12-23
Northern Colorado,Mississippi State,69,93,1,-24,2015-12-23
Rider,Morgan State,71,49,0,22,2015-12-23
UMKC,UNC Wilmington,56,76,1,-20,2015-12-23
Washington State,Northern Iowa,59,63,1,-4,2015-12-23
Indiana-Kokomo,Northern Kentucky,44,88,1,-44,2015-12-23
Western Carolina,Pitt,73,79,1,-6,2015-12-23
Pepperdine,Portland,79,87,1,-8,2015-12-23
Fairleigh Dickinson,Rutgers,64,72,1,-8,2015-12-23
St. Francis (NY),St. Peter's,45,56,1,-11,2015-12-23
Cal State Northridge,San Diego,63,81,1,-18,2015-12-23
Pacific,San Francisco,76,89,1,-13,2015-12-23
Saint Mary's,Santa Clara,81,59,0,22,2015-12-23
Lafayette,USC,64,100,1,-36,2015-12-23
Colorado,SMU,66,70,1,-4,2015-12-23
UMBC,Towson,65,91,1,-26,2015-12-23
North Dakota State,Utah State,62,76,1,-14,2015-12-23
Green Bay,Wisconsin,79,84,1,-5,2015-12-23
Northern Iowa,BYU,76,84,1,-8,2015-12-25
Auburn,Hawaii,67,79,1,-12,2015-12-25
Harvard,Oklahoma,71,83,1,-12,2015-12-25
New Mexico,Washington State,59,82,1,-23,2015-12-25
Louisville,Kentucky,73,75,1,-2,2015-12-26
Fairfield,Bucknell,101,91,0,10,2015-12-27
Pacific Union,Fresno State,46,89,1,-43,2015-12-27
Presbyterian,Marquette,66,84,1,-18,2015-12-27
Marshall,Maryland,67,87,1,-20,2015-12-27
Loyola (MD),Northwestern,59,74,1,-15,2015-12-27
South Carolina State,Ohio State,57,73,1,-16,2015-12-27
Central Pennsylvania College,Radford,63,123,1,-60,2015-12-27
Middle Tennessee,South Dakota State,61,65,1,-4,2015-12-27
Harris-Stowe,Southeast Missouri State,84,94,1,-10,2015-12-27
Carroll,Stanford,38,83,1,-45,2015-12-27
Texas Southern,Syracuse,67,80,1,-13,2015-12-27
Liberty,VCU,57,85,1,-28,2015-12-27
Cal State Bakersfield,Arizona State,59,75,1,-16,2015-12-28
Monmouth,Army,84,91,1,-7,2015-12-28
Texas A&M-Corpus Christi,Austin Peay,74,70,0,4,2015-12-28
Valparaiso,Belmont,81,85,1,-4,2015-12-28
Kean,Boston University,53,86,1,-33,2015-12-28
Bethune-Cookman,Brown,73,81,1,-8,2015-12-28
IUPUI,Butler,54,92,1,-38,2015-12-28
Davidson,California,60,86,1,-26,2015-12-28
Howard,Columbia,59,72,1,-13,2015-12-28
Coppin State,Creighton,77,102,1,-25,2015-12-28
Elon,Duke,66,105,1,-39,2015-12-28
Hannibal-LaGrange,Eastern Illinois,53,78,1,-25,2015-12-28
Detroit,Eastern Michigan,73,88,1,-15,2015-12-28
Middle Georgia State,Gardner-Webb,78,101,1,-23,2015-12-28
Methodist,High Point,50,96,1,-46,2015-12-28
Sacred Heart,Hofstra,73,80,1,-7,2015-12-28
Nicholls State,Houston,49,76,1,-27,2015-12-28
Drexel,Iona,70,77,1,-7,2015-12-28
Cairn,Longwood,52,90,1,-38,2015-12-28
Prairie View,Louisiana Tech,58,77,1,-19,2015-12-28
Green Bay,Morehead State,78,72,0,6,2015-12-28
UC-Riverside,Morgan State,81,72,0,9,2015-12-28
Stony Brook,NJIT,83,61,0,22,2015-12-28
UNC Greensboro,UNC,63,96,1,-33,2015-12-28
Campbell,UNC Wilmington,83,106,1,-23,2015-12-28
Chicago State,Oakland,93,101,1,-8,2015-12-28
UMass-Lowell,Rutgers,66,89,1,-23,2015-12-28
Pacific Union,Sacramento State,49,78,1,-29,2015-12-28
Utah Valley,Saint Mary's,50,65,1,-15,2015-12-28
Cornell,St. Peter's,65,62,0,3,2015-12-28
UC-Davis,Seattle,75,80,1,-5,2015-12-28
Florida Gulf Coast,South Dakota,81,89,1,-8,2015-12-28
Grand Canyon,SIU-Edwardsville,86,75,0,11,2015-12-28
Delaware State,TCU,47,75,1,-28,2015-12-28
College of Idaho,Utah,74,115,1,-41,2015-12-28
Penn,Villanova,57,77,1,-20,2015-12-28
UCSB,Washington,83,78,0,5,2015-12-28
Multnomah,Weber State,47,114,1,-67,2015-12-28
Brescia,Western Kentucky,66,93,1,-27,2015-12-28
Rio Grande,Winthrop,84,116,1,-32,2015-12-28
Western State,Air Force,66,86,1,-20,2015-12-29
Jacksonville State,Alabama,59,67,1,-8,2015-12-29
Stephen F. Austin,Alabama-Birmingham,66,76,1,-10,2015-12-29
Alabama A&M,Ball State,62,63,1,-1,2015-12-29
Texas Southern,Baylor,59,72,1,-13,2015-12-29
Mount St. Mary's,Binghamton,53,62,1,-9,2015-12-29
Delaware,Buffalo,79,99,1,-20,2015-12-29
Northwestern State,Centenary (LA),92,69,0,23,2015-12-29
George Washington,UCF,67,50,0,17,2015-12-29
St. Andrews,Charleston Southern,39,92,1,-53,2015-12-29
Citadel,Charlotte,93,111,1,-18,2015-12-29
Temple,Cincinnati,77,70,0,7,2015-12-29
Cedarville,Cleveland State,37,77,1,-40,2015-12-29
Regis,Colorado State,53,77,1,-24,2015-12-29
Manhattan,Eastern Kentucky,64,76,1,-12,2015-12-29
Florida State,Florida,73,71,0,2,2015-12-29
UT-Martin,Florida Atlantic,57,48,0,9,2015-12-29
Florida A&M,Florida International,45,65,1,-20,2015-12-29
Robert Morris,Georgia,67,79,1,-12,2015-12-29
Duquesne,Georgia Tech,67,73,1,-6,2015-12-29
Mississippi Valley State,Hawaii,48,77,1,-29,2015-12-29
Ecclesia,Houston Baptist,47,101,1,-54,2015-12-29
Cal State Northridge,Idaho State,79,84,1,-5,2015-12-29
Northern Illinois,UIC,70,65,0,5,2015-12-29
Michigan State,Iowa,70,83,1,-13,2015-12-29
Marist,Jacksonville,68,69,1,-1,2015-12-29
UC-Irvine,Kansas,53,78,1,-25,2015-12-29
Saint Louis,Kansas State,47,75,1,-28,2015-12-29
Howard Payne,Lamar,74,97,1,-23,2015-12-29
Chattanooga,Lipscomb,80,56,0,24,2015-12-29
Wake Forest,LSU,77,71,0,6,2015-12-29
Quinnipiac,Maine,95,98,1,-3,2015-12-29
LIU-Brooklyn,UMass,79,83,1,-4,2015-12-29
Tulane,Memphis,65,77,1,-12,2015-12-29
Princeton,Miami (FL),64,76,1,-12,2015-12-29
Arkansas-Pine Bluff,Missouri,25,78,1,-53,2015-12-29
Blue Mountain College,New Orleans,61,94,1,-33,2015-12-29
Furman,UNC Asheville,65,67,1,-2,2015-12-29
Montreat,North Carolina Central,68,107,1,-39,2015-12-29
Northeastern,NC State,66,72,1,-6,2015-12-29
Sam Houston State,North Texas,64,69,1,-5,2015-12-29
Liberty,Notre Dame,56,73,1,-17,2015-12-29
UMKC,Oklahoma State,43,61,1,-18,2015-12-29
Norfolk State,Old Dominion,57,68,1,-11,2015-12-29
Western Oregon,Oregon,60,88,1,-28,2015-12-29
Cal State Fullerton,Portland State,82,89,1,-7,2015-12-29
Incarnate Word,Rice,82,76,0,6,2015-12-29
Maryland-Eastern Shore,St. Joseph's,68,78,1,-10,2015-12-29
Miles,Samford,76,104,1,-28,2015-12-29
SE Oklahoma St.,Southern Miss,52,66,1,-14,2015-12-29
Albany (NY),St. Francis (NY),71,66,0,5,2015-12-29
Tennessee State,Tennessee,69,74,1,-5,2015-12-29
UConn,Texas,71,66,0,5,2015-12-29
Cal Poly,Texas A&M,63,82,1,-19,2015-12-29
Texas-Rio Grande Valley,UTEP,64,85,1,-21,2015-12-29
Richmond,Texas Tech,70,85,1,-15,2015-12-29
SMU,Tulsa,81,69,0,12,2015-12-29
Siena,Vermont,64,73,1,-9,2015-12-29
Central Michigan,William & Mary,84,88,1,-4,2015-12-29
Purdue,Wisconsin,61,55,0,6,2015-12-29
Hillsdale,Abilene Christian,48,90,1,-42,2015-12-30
South Carolina State,Akron,68,78,1,-10,2015-12-30
Fort Valley State,Alabama State,89,105,1,-16,2015-12-30
Louisiana College,Alcorn State,69,81,1,-12,2015-12-30
Westminster (MO),Austin Peay,61,112,1,-51,2015-12-30
UC-Davis,Boise State,56,64,1,-8,2015-12-30
New Hampshire,Boston College,67,72,1,-5,2015-12-30
Rhode Island,Brown,88,85,0,3,2015-12-30
Navy,Bucknell,58,88,1,-30,2015-12-30
Yale,Central Connecticut,62,42,0,20,2015-12-30
Lafayette,Colgate,70,77,1,-7,2015-12-30
Arkansas,Dayton,81,85,1,-4,2015-12-30
Georgetown,DePaul,70,58,0,12,2015-12-30
Long Beach State,Duke,81,103,1,-22,2015-12-30
Morehead State,ETSU,72,75,1,-3,2015-12-30
Indiana State,Evansville,62,70,1,-8,2015-12-30
Boston University,Holy Cross,64,80,1,-16,2015-12-30
Michigan,Illinois,78,68,0,10,2015-12-30
Missouri State,Illinois State,61,74,1,-13,2015-12-30
Coppin State,Iowa State,84,104,1,-20,2015-12-30
Oral Roberts,Purdue-Fort Wayne,84,90,1,-6,2015-12-30
Southeastern Louisiana,Jackson State,66,89,1,-23,2015-12-30
Mercer,Kennesaw State,76,73,0,3,2015-12-30
Army,Lehigh,88,82,0,6,2015-12-30
Southern Illinois,Loyola (IL),72,62,0,10,2015-12-30
American,Loyola (MD),67,75,1,-8,2015-12-30
Seton Hall,Marquette,83,63,0,20,2015-12-30
Penn State,Maryland,64,70,1,-6,2015-12-30
Trevecca Nazarene,Middle Tennessee,67,82,1,-15,2015-12-30
Brescia,Murray State,75,101,1,-26,2015-12-30
Northwestern,Nebraska,81,72,0,9,2015-12-30
Fresno State,UNLV,69,66,0,3,2015-12-30
Nevada,New Mexico,76,88,1,-12,2015-12-30
Arizona Christian,New Mexico State,61,81,1,-20,2015-12-30
Clemson,UNC,69,80,1,-11,2015-12-30
Kent State,North Carolina A&T,61,60,0,1,2015-12-30
Northland,North Dakota State,47,105,1,-58,2015-12-30
Bradley,Northern Iowa,44,80,1,-36,2015-12-30
UC-Riverside,Ohio,59,81,1,-22,2015-12-30
Minnesota,Ohio State,63,78,1,-15,2015-12-30
Syracuse,Pitt,61,72,1,-11,2015-12-30
Hartford,Rider,80,82,1,-2,2015-12-30
Indiana,Rutgers,79,72,0,7,2015-12-30
NJIT,Saint Francis (PA),77,65,0,12,2015-12-30
Wyoming,San Diego State,55,67,1,-12,2015-12-30
Utah State,San Jose State,80,71,0,9,2015-12-30
UCSB,Seattle,88,50,0,38,2015-12-30
Little Rock,South Alabama,69,60,0,9,2015-12-30
Francis Marion,South Carolina,56,78,1,-22,2015-12-30
Lees-McRae,USC Upstate,60,88,1,-28,2015-12-30
Houston,South Florida,73,67,0,6,2015-12-30
Niagara,St. Bonaventure,68,82,1,-14,2015-12-30
Florida Tech,Stetson,83,93,1,-10,2015-12-30
Georgia State,Texas-Arlington,70,85,1,-15,2015-12-30
Georgia Southern,Texas State,66,80,1,-14,2015-12-30
Northern Kentucky,Toledo,73,90,1,-17,2015-12-30
Arkansas State,Troy,84,81,0,3,2015-12-30
Western Michigan,Vanderbilt,61,86,1,-25,2015-12-30
Oakland,Virginia,58,71,1,-13,2015-12-30
North Florida,VCU,68,80,1,-12,2015-12-30
Bridgewater (VA),VMI,37,72,1,-35,2015-12-30
West Virginia,Virginia Tech,88,63,0,25,2015-12-30
UMass-Lowell,Wagner,62,76,1,-14,2015-12-30
Mars Hill,Western Carolina,62,82,1,-20,2015-12-30
Chicago State,Ball State,48,73,1,-25,2015-12-31
Providence,Butler,81,73,0,8,2015-12-31
Morgan State,Cal State Bakersfield,68,80,1,-12,2015-12-31
Lourdes,Central Michigan,66,87,1,-21,2015-12-31
Bryant,Dartmouth,62,60,0,2,2015-12-31
Northeastern,Elon,86,79,0,7,2015-12-31
La Salle,Florida Gulf Coast,77,86,1,-9,2015-12-31
Coastal Carolina,Gardner-Webb,61,65,1,-4,2015-12-31
Wofford,Harvard,57,77,1,-20,2015-12-31
Radford,High Point,60,77,1,-17,2015-12-31
Delaware,Hofstra,80,90,1,-10,2015-12-31
Bethune-Cookman,Jacksonville,70,74,1,-4,2015-12-31
SIU-Edwardsville,Jacksonville State,67,72,1,-5,2015-12-31
College of Charleston,James Madison,65,62,0,3,2015-12-31
UNC Asheville,Longwood,70,61,0,9,2015-12-31
Appalachian State,Louisiana-Monroe,56,72,1,-16,2015-12-31
Maryland-Eastern Shore,UMBC,75,89,1,-14,2015-12-31
North Carolina Central,Mississippi State,48,71,1,-23,2015-12-31
Drexel,UNC Wilmington,63,75,1,-12,2015-12-31
Idaho,North Dakota,74,71,0,3,2015-12-31
Montana,Northern Arizona,90,84,0,6,2015-12-31
Eastern Washington,Northern Colorado,90,96,1,-6,2015-12-31
San Diego,Pacific,75,77,1,-2,2015-12-31
BYU,Saint Mary's,74,85,1,-11,2015-12-31
Portland,San Francisco,95,107,1,-12,2015-12-31
Gonzaga,Santa Clara,79,77,0,2,2015-12-31
Belmont,Southeast Missouri State,92,82,0,10,2015-12-31
Montana State,Southern Utah,82,93,1,-11,2015-12-31
Creighton,St. John's (NY),80,70,0,10,2015-12-31
Eastern Illinois,Tennessee Tech,84,94,1,-10,2015-12-31
Xavier,Villanova,64,95,1,-31,2015-12-31
Drake,Wichita State,47,67,1,-20,2015-12-31
Towson,William & Mary,76,69,0,7,2015-12-31
Campbell,Winthrop,90,83,0,7,2015-12-31
Colorado,California,65,79,1,-14,2016-01-01
Western Illinois,Omaha,80,82,1,-2,2016-01-01
IUPUI,South Dakota,77,66,0,11,2016-01-01
Denver,South Dakota State,59,68,1,-9,2016-01-01
Utah,Stanford,68,70,1,-2,2016-01-01
Rice,UTEP,60,61,1,-1,2016-01-01
North Texas,UTSA,70,66,0,4,2016-01-01
UCLA,Washington,93,96,1,-3,2016-01-01
USC,Washington State,90,77,0,13,2016-01-01
San Jose State,Air Force,57,64,1,-7,2016-01-02
Lipscomb,Akron,73,80,1,-7,2016-01-02
Norfolk State,Alabama,49,68,1,-19,2016-01-02
Bucknell,Army,84,76,0,8,2016-01-02
Tennessee,Auburn,77,83,1,-6,2016-01-02
Eastern Kentucky,Austin Peay,79,70,0,9,2016-01-02
Colorado State,Boise State,80,84,1,-4,2016-01-02
Duke,Boston College,81,64,0,17,2016-01-02
Oakland City,Bowling Green State,56,87,1,-31,2016-01-02
Central Connecticut,Bryant,72,88,1,-16,2016-01-02
Cal State East Bay,Cal State Fullerton,52,75,1,-23,2016-01-02
Morgan State,Cal State Northridge,74,88,1,-14,2016-01-02
Holy Names,UC-Davis,49,74,1,-25,2016-01-02
New Mexico State,UC-Irvine,52,54,1,-2,2016-01-02
Cal State Bakersfield,UC-Riverside,67,48,0,19,2016-01-02
Point Loma Nazarene,UCSB,46,87,1,-41,2016-01-02
Presbyterian,Campbell,70,63,0,7,2016-01-02
Abilene Christian,Central Arkansas,62,61,0,1,2016-01-02
High Point,Charleston Southern,78,73,0,5,2016-01-02
Tulsa,Cincinnati,57,76,1,-19,2016-01-02
Chattanooga,Citadel,84,78,0,6,2016-01-02
Florida State,Clemson,75,84,1,-9,2016-01-02
Winthrop,Coastal Carolina,63,82,1,-19,2016-01-02
Albany (NY),Cornell,75,70,0,5,2016-01-02
Villanova,Creighton,85,71,0,14,2016-01-02
James Madison,Delaware,73,63,0,10,2016-01-02
Youngstown State,Detroit,87,96,1,-9,2016-01-02
Dayton,Duquesne,66,58,0,8,2016-01-02
UCF,East Carolina,71,68,0,3,2016-01-02
North Florida,Eastern Michigan,82,77,0,5,2016-01-02
Drexel,Elon,78,83,1,-5,2016-01-02
St. Francis (NY),Fairleigh Dickinson,77,86,1,-9,2016-01-02
Georgia,Florida,63,77,1,-14,2016-01-02
Eckerd,Florida Gulf Coast,57,68,1,-11,2016-01-02
New Mexico,Fresno State,77,62,0,15,2016-01-02
VMI,Furman,57,85,1,-28,2016-01-02
Marquette,Georgetown,70,80,1,-10,2016-01-02
Alabama A&M,Grambling,78,81,1,-3,2016-01-02
Northern Kentucky,Green Bay,70,86,1,-16,2016-01-02
Yale,Hartford,88,53,0,35,2016-01-02
Howard,Hawaii,59,94,1,-35,2016-01-02
Sam Houston State,Incarnate Word,78,72,0,6,2016-01-02
Loyola (IL),Indiana State,58,73,1,-15,2016-01-02
Purdue North Central,Purdue-Fort Wayne,95,126,1,-31,2016-01-02
Alabama State,Jackson State,61,68,1,-7,2016-01-02
Eastern Illinois,Jacksonville State,75,64,0,11,2016-01-02
Baylor,Kansas,74,102,1,-28,2016-01-02
West Virginia,Kansas State,87,83,0,4,2016-01-02
Oberlin,Kent State,58,104,1,-46,2016-01-02
Ole Miss,Kentucky,61,83,1,-22,2016-01-02
Loyola (MD),Lafayette,81,78,0,3,2016-01-02
Boston University,Lehigh,73,81,1,-8,2016-01-02
UNC Asheville,Liberty,76,69,0,7,2016-01-02
Gardner-Webb,Longwood,67,66,0,1,2016-01-02
Appalachian State,Louisiana,58,79,1,-21,2016-01-02
Southern Miss,Louisiana Tech,57,87,1,-30,2016-01-02
Brown,Maine,92,98,1,-6,2016-01-02
Fairfield,Manhattan,66,72,1,-6,2016-01-02
Canisius,Marist,92,83,0,9,2016-01-02
Samford,Mercer,50,69,1,-19,2016-01-02
Syracuse,Miami (FL),51,64,1,-13,2016-01-02
South Carolina State,Miami (OH),71,67,0,4,2016-01-02
Penn State,Michigan,56,79,1,-23,2016-01-02
Wright State,Milwaukee,84,82,0,2,2016-01-02
Michigan State,Minnesota,69,61,0,8,2016-01-02
Savannah State,Missouri,50,81,1,-31,2016-01-02
Evansville,Missouri State,76,59,0,17,2016-01-02
LIU-Brooklyn,Mount St. Mary's,63,79,1,-16,2016-01-02
Morehead State,Murray State,57,62,1,-5,2016-01-02
Holy Cross,Navy,60,65,1,-5,2016-01-02
Indiana,Nebraska,79,69,0,10,2016-01-02
Wyoming,Nevada,68,71,1,-3,2016-01-02
Lamar,Nicholls State,79,67,0,12,2016-01-02
UMBC,NJIT,83,86,1,-3,2016-01-02
Georgia Tech,UNC,78,86,1,-8,2016-01-02
Northeastern,UNC Wilmington,65,63,0,2,2016-01-02
Eastern Washington,North Dakota,71,79,1,-8,2016-01-02
Montana State,Northern Arizona,74,72,0,2,2016-01-02
Idaho,Northern Colorado,75,70,0,5,2016-01-02
Judson,Northern Illinois,48,91,1,-43,2016-01-02
Maryland,Northwestern,72,59,0,13,2016-01-02
Houston Baptist,Northwestern State,99,73,0,26,2016-01-02
Cleveland State,Oakland,68,86,1,-18,2016-01-02
Iowa State,Oklahoma,83,87,1,-4,2016-01-02
TCU,Oklahoma State,48,69,1,-21,2016-01-02
Charlotte,Old Dominion,65,74,1,-9,2016-01-02
BYU,Pacific,81,67,0,14,2016-01-02
Binghamton,Penn,45,80,1,-35,2016-01-02
Loyola Marymount,Pepperdine,65,68,1,-3,2016-01-02
Maryland-Eastern Shore,Pitt,58,92,1,-34,2016-01-02
Sacramento State,Portland State,68,76,1,-8,2016-01-02
Alcorn State,Prairie View,73,70,0,3,2016-01-02
St. John's (NY),Providence,65,83,1,-18,2016-01-02
Iowa,Purdue,70,63,0,7,2016-01-02
Iona,Quinnipiac,78,66,0,12,2016-01-02
Saint Louis,Rhode Island,57,85,1,-28,2016-01-02
St. Joseph's,Richmond,77,73,0,4,2016-01-02
Sacred Heart,Robert Morris,69,65,0,4,2016-01-02
Wagner,Saint Francis (PA),65,73,1,-8,2016-01-02
San Diego,Saint Mary's,46,79,1,-33,2016-01-02
Gonzaga,San Francisco,102,94,0,8,2016-01-02
Portland,Santa Clara,77,84,1,-7,2016-01-02
DePaul,Seton Hall,74,78,1,-4,2016-01-02
Niagara,Siena,63,75,1,-12,2016-01-02
Arkansas State,South Alabama,89,67,0,22,2016-01-02
Memphis,South Carolina,76,86,1,-10,2016-01-02
UMKC,USC Upstate,68,70,1,-2,2016-01-02
Tennessee State,Southeast Missouri State,72,66,0,6,2016-01-02
Northern Iowa,Southern Illinois,73,75,1,-2,2016-01-02
South Florida,SMU,58,72,1,-14,2016-01-02
Montana,Southern Utah,83,66,0,17,2016-01-02
Davidson,St. Bonaventure,85,97,1,-12,2016-01-02
McNeese State,Stephen F. Austin,57,86,1,-29,2016-01-02
Webber,Stetson,53,103,1,-50,2016-01-02
Columbia,Stony Brook,60,69,1,-9,2016-01-02
Houston,Temple,77,50,0,27,2016-01-02
Boyce,UT-Martin,60,122,1,-62,2016-01-02
SIU-Edwardsville,Tennessee Tech,63,86,1,-23,2016-01-02
Arkansas,Texas A&M,69,92,1,-23,2016-01-02
Georgia Southern,Texas-Arlington,72,92,1,-20,2016-01-02
Our Lady of the Lake,Texas-Rio Grande Valley,81,89,1,-8,2016-01-02
Southern,Texas Southern,66,88,1,-22,2016-01-02
Georgia State,Texas State,58,46,0,12,2016-01-02
Texas,Texas Tech,74,82,1,-8,2016-01-02
Hofstra,Towson,90,58,0,32,2016-01-02
Little Rock,Troy,67,61,0,6,2016-01-02
UConn,Tulane,75,67,0,8,2016-01-02
San Diego State,Utah State,70,67,0,3,2016-01-02
San Diego Christian,Utah Valley,79,88,1,-9,2016-01-02
UIC,Valparaiso,47,75,1,-28,2016-01-02
LSU,Vanderbilt,90,82,0,8,2016-01-02
Notre Dame,Virginia,66,77,1,-11,2016-01-02
George Mason,VCU,47,71,1,-24,2016-01-02
NC State,Virginia Tech,68,73,1,-5,2016-01-02
Idaho State,Weber State,56,77,1,-21,2016-01-02
ETSU,Western Carolina,82,66,0,16,2016-01-02
Jacksonville,Western Michigan,72,76,1,-4,2016-01-02
College of Charleston,William & Mary,70,78,1,-8,2016-01-02
Rutgers,Wisconsin,57,79,1,-22,2016-01-02
UNC Greensboro,Wofford,76,87,1,-11,2016-01-02
Butler,Xavier,69,88,1,-19,2016-01-02
Middle Tennessee,Alabama-Birmingham,67,78,1,-11,2016-01-03
Colgate,American,56,37,0,19,2016-01-03
Arizona,Arizona State,94,82,0,12,2016-01-03
Wichita State,Bradley,85,58,0,27,2016-01-03
Utah,California,58,71,1,-13,2016-01-03
Illinois State,Drake,67,62,0,5,2016-01-03
Florida Atlantic,Florida International,59,76,1,-17,2016-01-03
Fordham,George Washington,63,69,1,-6,2016-01-03
Bethune-Cookman,Grand Canyon,53,74,1,-21,2016-01-03
Princeton,Hampton,89,59,0,30,2016-01-03
Vermont,Harvard,65,62,0,3,2016-01-03
UMass,La Salle,74,67,0,7,2016-01-03
Wake Forest,Louisville,57,65,1,-8,2016-01-03
Western Kentucky,Marshall,76,94,1,-18,2016-01-03
IUPUI,Omaha,71,76,1,-5,2016-01-03
Denver,North Dakota State,49,75,1,-26,2016-01-03
Illinois,Ohio State,73,75,1,-2,2016-01-03
South Dakota,Oral Roberts,94,84,0,10,2016-01-03
Oregon,Oregon State,57,70,1,-13,2016-01-03
Western Illinois,South Dakota State,59,63,1,-4,2016-01-03
Colorado,Stanford,56,55,0,1,2016-01-03
North Texas,UTEP,75,84,1,-9,2016-01-03
Rice,UTSA,80,85,1,-5,2016-01-03
USC,Washington,85,87,1,-2,2016-01-03
UCLA,Washington State,78,85,1,-7,2016-01-03
LIU-Brooklyn,Central Connecticut,76,67,0,9,2016-01-04
Summit,Delaware State,44,93,1,-49,2016-01-04
Cleveland State,Detroit,80,88,1,-8,2016-01-04
Dartmouth,Fairfield,85,97,1,-12,2016-01-04
Bryant,Fairleigh Dickinson,85,80,0,5,2016-01-04
UNC,Florida State,106,90,0,16,2016-01-04
Alabama State,Grambling,81,84,1,-3,2016-01-04
Wright State,Green Bay,68,76,1,-8,2016-01-04
Niagara,Iona,52,65,1,-13,2016-01-04
Alabama A&M,Jackson State,66,67,1,-1,2016-01-04
Oklahoma,Kansas,106,109,1,-3,2016-01-04
Reinhardt,Kennesaw State,71,103,1,-32,2016-01-04
New Orleans,Lamar,68,64,0,4,2016-01-04
Siena,Manhattan,87,92,1,-5,2016-01-04
St. Peter's,Marist,68,60,0,8,2016-01-04
Northern Kentucky,Milwaukee,67,76,1,-9,2016-01-04
Arkansas-Pine Bluff,Mississippi Valley State,60,66,1,-6,2016-01-04
Canisius,Monmouth,66,81,1,-15,2016-01-04
St. Francis (NY),Mount St. Mary's,40,44,1,-4,2016-01-04
ETSU,North Carolina Central,72,68,0,4,2016-01-04
Sam Houston State,Northwestern State,94,79,0,15,2016-01-04
Youngstown State,Oakland,100,98,0,2,2016-01-04
Southern,Prairie View,65,71,1,-6,2016-01-04
Rider,Quinnipiac,60,64,1,-4,2016-01-04
Wagner,Robert Morris,72,69,0,3,2016-01-04
Sacred Heart,Saint Francis (PA),80,84,1,-4,2016-01-04
Stephen F. Austin,Southeastern Louisiana,89,69,0,20,2016-01-04
West Virginia,TCU,95,87,0,8,2016-01-04
Alcorn State,Texas Southern,58,74,1,-16,2016-01-04
Virginia,Virginia Tech,68,70,1,-2,2016-01-04
Vanderbilt,Arkansas,85,90,1,-5,2016-01-05
South Carolina,Auburn,81,69,0,12,2016-01-05
Oklahoma State,Baylor,62,79,1,-17,2016-01-05
Akron,Buffalo,75,71,0,4,2016-01-05
Mercer,Chattanooga,62,74,1,-12,2016-01-05
Temple,UConn,55,53,0,2,2016-01-05
Georgetown,Creighton,66,79,1,-13,2016-01-05
Butler,DePaul,77,72,0,5,2016-01-05
Savannah State,Florida A&M,58,61,1,-3,2016-01-05
Webber,Florida Gulf Coast,59,104,1,-45,2016-01-05
Tulane,Houston,45,63,1,-18,2016-01-05
McNeese State,Houston Baptist,73,82,1,-9,2016-01-05
Wisconsin,Indiana,58,59,1,-1,2016-01-05
Nebraska,Iowa,66,77,1,-11,2016-01-05
Trinity Baptist,Jacksonville,45,84,1,-39,2016-01-05
Kentucky,LSU,67,85,1,-18,2016-01-05
Nicholls State,Memphis,46,82,1,-36,2016-01-05
Princeton,Norfolk State,83,74,0,9,2016-01-05
Furman,UNC Greensboro,66,67,1,-1,2016-01-05
Minnesota,Penn State,77,86,1,-9,2016-01-05
Marquette,Providence,65,64,0,1,2016-01-05
Richmond,Rhode Island,65,77,1,-12,2016-01-05
VCU,St. Joseph's,85,82,0,3,2016-01-05
Citadel,Samford,74,94,1,-20,2016-01-05
North Carolina A&T,USC Upstate,68,78,1,-10,2016-01-05
Clemson,Syracuse,74,73,0,1,2016-01-05
Kansas State,Texas,57,60,1,-3,2016-01-05
Central Arkansas,Texas A&M-Corpus Christi,82,94,1,-12,2016-01-05
East Carolina,Tulsa,43,55,1,-12,2016-01-05
Boise State,Utah State,76,61,0,15,2016-01-05
Wofford,VMI,65,61,0,4,2016-01-05
Kent State,Western Michigan,87,84,0,3,2016-01-05
UMBC,Albany (NY),59,73,1,-14,2016-01-06
Lafayette,Army,76,73,0,3,2016-01-06
Toledo,Ball State,69,87,1,-18,2016-01-06
Stony Brook,Binghamton,62,52,0,10,2016-01-06
Navy,Boston University,83,67,0,16,2016-01-06
Miami (OH),Bowling Green State,62,73,1,-11,2016-01-06
Southern Illinois,Bradley,65,44,0,21,2016-01-06
American,Bucknell,54,72,1,-18,2016-01-06
Long Beach State,Cal State Northridge,94,79,0,15,2016-01-06
South Florida,UCF,64,75,1,-11,2016-01-06
Eastern Michigan,Central Michigan,99,80,0,19,2016-01-06
Liberty,Coastal Carolina,62,61,0,1,2016-01-06
UNLV,Colorado State,65,66,1,-1,2016-01-06
Maryland-Eastern Shore,Columbia,75,81,1,-6,2016-01-06
Duquesne,Davidson,66,77,1,-11,2016-01-06
UMass,Dayton,63,93,1,-30,2016-01-06
Oral Roberts,Denver,75,78,1,-3,2016-01-06
Indiana State,Drake,79,69,0,10,2016-01-06
Tennessee State,Eastern Illinois,66,61,0,5,2016-01-06
La Salle,Fordham,61,66,1,-5,2016-01-06
Nevada,Fresno State,63,85,1,-22,2016-01-06
Campbell,Gardner-Webb,68,71,1,-3,2016-01-06
St. Bonaventure,George Mason,77,58,0,19,2016-01-06
Missouri,Georgia,59,77,1,-18,2016-01-06
Jarvis Christian,Grambling,58,80,1,-22,2016-01-06
Cal Poly,Hawaii,73,86,1,-13,2016-01-06
Colgate,Holy Cross,63,65,1,-2,2016-01-06
Cornell,Howard,84,81,0,3,2016-01-06
Loyola (IL),Illinois State,52,54,1,-2,2016-01-06
Texas Tech,Iowa State,69,76,1,-7,2016-01-06
South Dakota,Purdue-Fort Wayne,65,85,1,-20,2016-01-06
Lehigh,Loyola (MD),50,51,1,-1,2016-01-06
Vermont,Maine,90,72,0,18,2016-01-06
Rutgers,Maryland,63,88,1,-25,2016-01-06
Hartford,UMass-Lowell,76,80,1,-4,2016-01-06
Texas A&M,Mississippi State,61,60,0,1,2016-01-06
Northern Iowa,Missouri State,58,59,1,-1,2016-01-06
Hampton,Morgan State,83,80,0,3,2016-01-06
Winthrop,UNC Asheville,84,85,1,-1,2016-01-06
Johnson & Wales (NC),North Carolina Central,70,78,1,-8,2016-01-06
Ohio,Northern Illinois,69,80,1,-11,2016-01-06
Ohio State,Northwestern,65,56,0,9,2016-01-06
California,Oregon,65,68,1,-3,2016-01-06
Stanford,Oregon State,78,72,0,6,2016-01-06
Georgia Tech,Pitt,84,89,1,-5,2016-01-06
Longwood,Presbyterian,65,78,1,-13,2016-01-06
Charleston Southern,Radford,73,80,1,-7,2016-01-06
George Washington,Saint Louis,62,65,1,-3,2016-01-06
San Jose State,San Diego State,62,77,1,-15,2016-01-06
Belmont,SIU-Edwardsville,85,77,0,8,2016-01-06
Xavier,St. John's (NY),74,66,0,8,2016-01-06
North Florida,Stetson,97,79,0,18,2016-01-06
Florida,Tennessee,69,83,1,-14,2016-01-06
Seton Hall,Villanova,63,72,1,-9,2016-01-06
Duke,Wake Forest,91,75,0,16,2016-01-06
Evansville,Wichita State,64,67,1,-3,2016-01-06
Air Force,Wyoming,52,64,1,-12,2016-01-06
NJIT,Yale,65,83,1,-18,2016-01-06
UTSA,Alabama-Birmingham,82,104,1,-22,2016-01-07
Texas-Arlington,Appalachian State,71,67,0,4,2016-01-07
Louisiana,Little Rock,57,77,1,-20,2016-01-07
Louisiana-Monroe,Arkansas State,65,68,1,-3,2016-01-07
Jacksonville State,Austin Peay,54,73,1,-19,2016-01-07
Notre Dame,Boston College,82,54,0,28,2016-01-07
Santa Clara,BYU,61,97,1,-36,2016-01-07
UC-Davis,UC-Irvine,55,76,1,-21,2016-01-07
Cal State Fullerton,UC-Riverside,79,73,0,6,2016-01-07
Manhattan,Canisius,94,86,0,8,2016-01-07
Green Bay,Cleveland State,87,67,0,20,2016-01-07
Hofstra,College of Charleston,61,72,1,-11,2016-01-07
William & Mary,Drexel,72,63,0,9,2016-01-07
UT-Martin,Eastern Kentucky,78,70,0,8,2016-01-07
South Alabama,Georgia Southern,64,58,0,6,2016-01-07
Troy,Georgia State,68,72,1,-4,2016-01-07
Texas-Rio Grande Valley,Grand Canyon,63,83,1,-20,2016-01-07
Northern Colorado,Idaho State,78,83,1,-5,2016-01-07
Rider,Iona,58,67,1,-9,2016-01-07
South Dakota State,IUPUI,67,74,1,-7,2016-01-07
Elon,James Madison,79,73,0,6,2016-01-07
Robert Morris,LIU-Brooklyn,70,60,0,10,2016-01-07
Old Dominion,Louisiana Tech,56,53,0,3,2016-01-07
Saint Mary's,Loyola Marymount,73,48,0,25,2016-01-07
Florida Atlantic,Marshall,67,90,1,-23,2016-01-07
Illinois,Michigan State,54,79,1,-25,2016-01-07
UTEP,Middle Tennessee,72,78,1,-6,2016-01-07
Alabama,Ole Miss,66,74,1,-8,2016-01-07
Seattle,UMKC,69,84,1,-15,2016-01-07
Portland State,Montana,66,79,1,-13,2016-01-07
Sacramento State,Montana State,64,71,1,-7,2016-01-07
Southeast Missouri State,Morehead State,69,96,1,-27,2016-01-07
Central Connecticut,Mount St. Mary's,62,73,1,-11,2016-01-07
Tennessee Tech,Murray State,71,65,0,6,2016-01-07
St. Peter's,Niagara,61,63,1,-2,2016-01-07
Louisville,NC State,77,72,0,5,2016-01-07
Omaha,North Dakota State,91,82,0,9,2016-01-07
Delaware,Northeastern,56,88,1,-32,2016-01-07
Pacific,Pepperdine,76,81,1,-5,2016-01-07
Michigan,Purdue,70,87,1,-17,2016-01-07
Fairleigh Dickinson,Sacred Heart,80,68,0,12,2016-01-07
San Francisco,San Diego,73,65,0,8,2016-01-07
Fairfield,Siena,76,91,1,-15,2016-01-07
Arizona State,USC,65,75,1,-10,2016-01-07
Cincinnati,SMU,57,59,1,-2,2016-01-07
Charlotte,Southern Miss,82,76,0,6,2016-01-07
Saint Francis (PA),St. Francis (NY),56,73,1,-17,2016-01-07
UNC Wilmington,Towson,60,76,1,-16,2016-01-07
Arizona,UCLA,84,87,1,-3,2016-01-07
New Mexico State,Utah Valley,78,66,0,12,2016-01-07
Bryant,Wagner,56,65,1,-9,2016-01-07
North Dakota,Weber State,62,74,1,-12,2016-01-07
Florida International,Western Kentucky,75,72,0,3,2016-01-07
Milwaukee,Youngstown State,81,65,0,16,2016-01-07
Western Michigan,Akron,53,62,1,-9,2016-01-08
Utah,Colorado,56,54,0,2,2016-01-08
UIC,Detroit,69,87,1,-18,2016-01-08
Buffalo,Kent State,76,67,0,9,2016-01-08
Valparaiso,Oakland,84,67,0,17,2016-01-08
Daniel Webster,Yale,53,94,1,-41,2016-01-08
Nevada,Air Force,86,63,0,23,2016-01-09
Kentucky,Alabama,77,61,0,16,2016-01-09
Arkansas-Pine Bluff,Alabama A&M,70,85,1,-15,2016-01-09
UTEP,Alabama-Birmingham,80,87,1,-7,2016-01-09
Mississippi Valley State,Alabama State,74,75,1,-1,2016-01-09
Jackson State,Alcorn State,80,71,0,9,2016-01-09
Lehigh,American,65,50,0,15,2016-01-09
Texas State,Appalachian State,56,76,1,-20,2016-01-09
Mississippi State,Arkansas,68,82,1,-14,2016-01-09
Louisiana-Monroe,Little Rock,57,58,1,-1,2016-01-09
Louisiana,Arkansas State,69,71,1,-2,2016-01-09
Tennessee Tech,Austin Peay,72,66,0,6,2016-01-09
Eastern Illinois,Belmont,59,85,1,-26,2016-01-09
Fresno State,Boise State,70,81,1,-11,2016-01-09
Lafayette,Boston University,47,68,1,-21,2016-01-09
Central Michigan,Bowling Green State,79,67,0,12,2016-01-09
San Francisco,BYU,92,102,1,-10,2016-01-09
Daniel Webster,Brown,43,69,1,-26,2016-01-09
Holy Cross,Bucknell,71,98,1,-27,2016-01-09
Cal State Northridge,Cal State Fullerton,85,75,0,10,2016-01-09
UC-Riverside,UC-Irvine,68,84,1,-16,2016-01-09
St. Peter's,Canisius,70,53,0,17,2016-01-09
Lamar,Central Arkansas,76,93,1,-17,2016-01-09
UNC Asheville,Charleston Southern,83,73,0,10,2016-01-09
Seattle,Chicago State,66,50,0,16,2016-01-09
Mercer,Citadel,91,80,0,11,2016-01-09
Milwaukee,Cleveland State,65,62,0,3,2016-01-09
Navy,Colgate,71,68,0,3,2016-01-09
Central Pennsylvania College,Columbia,68,96,1,-28,2016-01-09
Memphis,UConn,78,81,1,-3,2016-01-09
George Mason,Davidson,75,81,1,-6,2016-01-09
UNC Wilmington,Delaware,85,67,0,18,2016-01-09
Purdue-Fort Wayne,Denver,65,64,0,1,2016-01-09
College of Charleston,Drexel,54,61,1,-7,2016-01-09
Virginia Tech,Duke,58,82,1,-24,2016-01-09
UNC Greensboro,ETSU,83,86,1,-3,2016-01-09
Southeast Missouri State,Eastern Kentucky,69,88,1,-19,2016-01-09
Idaho,Eastern Washington,60,74,1,-14,2016-01-09
Hofstra,Elon,80,76,0,4,2016-01-09
Bradley,Evansville,35,67,1,-32,2016-01-09
Central Connecticut,Fairleigh Dickinson,73,92,1,-19,2016-01-09
LSU,Florida,62,68,1,-6,2016-01-09
Stetson,Florida Gulf Coast,53,82,1,-29,2016-01-09
Chattanooga,Furman,55,70,1,-15,2016-01-09
Radford,Gardner-Webb,61,83,1,-22,2016-01-09
Duquesne,George Washington,64,91,1,-27,2016-01-09
DePaul,Georgetown,63,74,1,-11,2016-01-09
Troy,Georgia Southern,88,93,1,-5,2016-01-09
South Alabama,Georgia State,55,70,1,-15,2016-01-09
Virginia,Georgia Tech,64,68,1,-4,2016-01-09
Portland,Gonzaga,74,85,1,-11,2016-01-09
New Mexico State,Grand Canyon,75,79,1,-4,2016-01-09
Bethune-Cookman,Hampton,70,75,1,-5,2016-01-09
Dartmouth,Harvard,70,77,1,-7,2016-01-09
UCSB,Hawaii,57,65,1,-8,2016-01-09
Presbyterian,High Point,66,82,1,-16,2016-01-09
Southeastern Louisiana,Houston Baptist,58,77,1,-19,2016-01-09
Coppin State,Howard,63,72,1,-9,2016-01-09
North Dakota,Idaho State,84,76,0,8,2016-01-09
Northwestern State,Incarnate Word,56,70,1,-14,2016-01-09
Illinois State,Indiana State,65,77,1,-12,2016-01-09
Marist,Iona,80,90,1,-10,2016-01-09
Baylor,Iowa State,94,89,0,5,2016-01-09
Towson,James Madison,59,73,1,-14,2016-01-09
Lipscomb,Kennesaw State,86,102,1,-16,2016-01-09
Dayton,La Salle,57,61,1,-4,2016-01-09
Campbell,Liberty,52,55,1,-3,2016-01-09
UC-Davis,Long Beach State,47,59,1,-12,2016-01-09
Saint Francis (PA),LIU-Brooklyn,72,65,0,7,2016-01-09
Coastal Carolina,Longwood,61,76,1,-15,2016-01-09
Charlotte,Louisiana Tech,90,93,1,-3,2016-01-09
Missouri State,Loyola (IL),56,54,0,2,2016-01-09
Pacific,Loyola Marymount,60,58,0,2,2016-01-09
Army,Loyola (MD),73,59,0,14,2016-01-09
St. John's (NY),Marquette,75,81,1,-6,2016-01-09
Florida International,Marshall,81,99,1,-18,2016-01-09
Maine,UMBC,76,89,1,-13,2016-01-09
St. Bonaventure,UMass,88,77,0,11,2016-01-09
Texas A&M-Corpus Christi,McNeese State,77,68,0,9,2016-01-09
Florida State,Miami (FL),59,72,1,-13,2016-01-09
Toledo,Miami (OH),84,76,0,8,2016-01-09
UTSA,Middle Tennessee,71,79,1,-8,2016-01-09
Northwestern,Minnesota,77,52,0,25,2016-01-09
Georgia,Ole Miss,71,72,1,-1,2016-01-09
Auburn,Missouri,61,76,1,-15,2016-01-09
Cal State Bakersfield,UMKC,83,72,0,11,2016-01-09
Quinnipiac,Monmouth,74,88,1,-14,2016-01-09
Sacramento State,Montana,58,77,1,-19,2016-01-09
Portland State,Montana State,77,70,0,7,2016-01-09
UT-Martin,Morehead State,58,64,1,-6,2016-01-09
Delaware State,Morgan State,58,63,1,-5,2016-01-09
Bryant,Mount St. Mary's,82,79,0,3,2016-01-09
Jacksonville State,Murray State,54,69,1,-15,2016-01-09
Binghamton,New Hampshire,43,58,1,-15,2016-01-09
Utah State,New Mexico,59,77,1,-18,2016-01-09
Manhattan,Niagara,53,55,1,-2,2016-01-09
Abilene Christian,Nicholls State,62,63,1,-1,2016-01-09
USC Upstate,NJIT,80,78,0,2,2016-01-09
Florida A&M,Norfolk State,56,77,1,-21,2016-01-09
Jacksonville,North Florida,68,83,1,-15,2016-01-09
Rice,North Texas,74,85,1,-11,2016-01-09
Eastern Michigan,Northern Illinois,63,80,1,-17,2016-01-09
Drake,Northern Iowa,44,77,1,-33,2016-01-09
Wright State,Northern Kentucky,60,46,0,14,2016-01-09
Pitt,Notre Dame,86,82,0,4,2016-01-09
Ball State,Ohio,73,79,1,-6,2016-01-09
Kansas State,Oklahoma,76,86,1,-10,2016-01-09
North Dakota State,Oral Roberts,65,66,1,-1,2016-01-09
California,Oregon State,71,77,1,-6,2016-01-09
Princeton,Penn,73,71,0,2,2016-01-09
Saint Mary's,Pepperdine,64,67,1,-3,2016-01-09
Fairfield,Rider,69,64,0,5,2016-01-09
Nebraska,Rutgers,90,56,0,34,2016-01-09
Wagner,Sacred Heart,76,59,0,17,2016-01-09
New Orleans,Sam Houston State,70,73,1,-3,2016-01-09
Santa Clara,San Diego,65,53,0,12,2016-01-09
Colorado State,San Jose State,85,84,0,1,2016-01-09
North Carolina A&T,Savannah State,68,75,1,-7,2016-01-09
Creighton,Seton Hall,82,67,0,15,2016-01-09
Vanderbilt,South Carolina,65,69,1,-4,2016-01-09
North Carolina Central,South Carolina State,75,91,1,-16,2016-01-09
Omaha,South Dakota,79,73,0,6,2016-01-09
Grambling,Southern,61,66,1,-5,2016-01-09
Arizona,USC,101,103,1,-2,2016-01-09
Wichita State,Southern Illinois,83,58,0,25,2016-01-09
Old Dominion,Southern Miss,71,73,1,-2,2016-01-09
Northern Arizona,Southern Utah,73,63,0,10,2016-01-09
Robert Morris,St. Francis (NY),49,56,1,-7,2016-01-09
UMass-Lowell,Stony Brook,59,86,1,-27,2016-01-09
UNC,Syracuse,84,73,0,11,2016-01-09
East Carolina,Temple,60,78,1,-18,2016-01-09
Texas A&M,Tennessee,92,88,0,4,2016-01-09
SIU-Edwardsville,Tennessee State,60,63,1,-3,2016-01-09
Texas,TCU,57,58,1,-1,2016-01-09
Prairie View,Texas Southern,38,64,1,-26,2016-01-09
Kansas,Texas Tech,69,59,0,10,2016-01-09
Arizona State,UCLA,74,81,1,-7,2016-01-09
Texas-Rio Grande Valley,Utah Valley,65,98,1,-33,2016-01-09
Albany (NY),Vermont,69,57,0,12,2016-01-09
Washington,Washington State,99,95,0,4,2016-01-09
Northern Colorado,Weber State,68,85,1,-17,2016-01-09
Oklahoma State,West Virginia,60,77,1,-17,2016-01-09
VMI,Western Carolina,52,73,1,-21,2016-01-09
IUPUI,Western Illinois,67,60,0,7,2016-01-09
Florida Atlantic,Western Kentucky,82,86,1,-4,2016-01-09
Northeastern,William & Mary,60,78,1,-18,2016-01-09
Maryland,Wisconsin,63,60,0,3,2016-01-09
Samford,Wofford,64,69,1,-5,2016-01-09
UNLV,Wyoming,57,59,1,-2,2016-01-09
Green Bay,Youngstown State,93,103,1,-10,2016-01-09
Villanova,Butler,60,55,0,5,2016-01-10
Louisville,Clemson,62,66,1,-4,2016-01-10
Valparaiso,Detroit,92,74,0,18,2016-01-10
Richmond,Fordham,93,82,0,11,2016-01-10
Purdue,Illinois,70,84,1,-14,2016-01-10
Ohio State,Indiana,60,85,1,-25,2016-01-10
UIC,Oakland,61,86,1,-25,2016-01-10
Stanford,Oregon,58,71,1,-13,2016-01-10
Michigan State,Penn State,92,65,0,27,2016-01-10
Rhode Island,St. Joseph's,67,72,1,-5,2016-01-10
VCU,Saint Louis,72,56,0,16,2016-01-10
Cincinnati,South Florida,54,51,0,3,2016-01-10
UCF,SMU,73,88,1,-15,2016-01-10
Tulsa,Tulane,81,67,0,14,2016-01-10
NC State,Wake Forest,74,77,1,-3,2016-01-10
Mississippi Valley State,Alabama A&M,79,73,0,6,2016-01-11
Arkansas-Pine Bluff,Alabama State,59,55,0,4,2016-01-11
Grambling,Alcorn State,53,69,1,-16,2016-01-11
Cal State Bakersfield,Chicago State,67,56,0,11,2016-01-11
Howard,Delaware State,71,67,0,4,2016-01-11
VMI,ETSU,51,88,1,-37,2016-01-11
Monmouth,Fairfield,86,74,0,12,2016-01-11
Samford,Furman,57,77,1,-20,2016-01-11
Florida A&M,Hampton,65,71,1,-6,2016-01-11
Texas A&M-Corpus Christi,Lamar,91,82,0,9,2016-01-11
Bucknell,Lehigh,82,76,0,6,2016-01-11
Morgan State,Maryland-Eastern Shore,65,69,1,-4,2016-01-11
Incarnate Word,New Orleans,71,68,0,3,2016-01-11
Bethune-Cookman,Norfolk State,72,70,0,2,2016-01-11
Southeastern Louisiana,Sam Houston State,63,70,1,-7,2016-01-11
North Carolina Central,Savannah State,69,46,0,23,2016-01-11
North Carolina A&T,South Carolina State,85,92,1,-7,2016-01-11
Jackson State,Southern,66,74,1,-8,2016-01-11
UNC Greensboro,Western Carolina,77,83,1,-6,2016-01-11
Ferrum,Winthrop,63,81,1,-18,2016-01-11
Chattanooga,Wofford,77,68,0,9,2016-01-11
Northwestern State,Abilene Christian,72,87,1,-15,2016-01-12
New Hampshire,Albany (NY),75,80,1,-5,2016-01-12
Akron,Central Michigan,81,92,1,-11,2016-01-12
Providence,Creighton,50,48,0,2,2016-01-12
Canisius,Dartmouth,69,80,1,-11,2016-01-12
Davidson,Dayton,74,80,1,-6,2016-01-12
Buffalo,Eastern Michigan,69,81,1,-12,2016-01-12
Drake,Evansville,65,84,1,-19,2016-01-12
Ryerson,Harvard,57,73,1,-16,2016-01-12
Texas Tech,Kansas State,70,83,1,-13,2016-01-12
Miami (OH),Kent State,68,76,1,-8,2016-01-12
Mississippi State,Kentucky,74,80,1,-6,2016-01-12
George Washington,UMass,81,70,0,11,2016-01-12
Maryland,Michigan,67,70,1,-3,2016-01-12
Arkansas,Missouri,94,61,0,33,2016-01-12
Minnesota,Nebraska,59,84,1,-25,2016-01-12
New Mexico,UNLV,74,86,1,-12,2016-01-12
Wisconsin,Northwestern,65,70,1,-5,2016-01-12
Bowling Green State,Ohio,91,75,0,16,2016-01-12
Tulane,South Florida,81,70,0,11,2016-01-12
Illinois State,Southern Illinois,78,81,1,-3,2016-01-12
Central Arkansas,Stephen F. Austin,64,85,1,-21,2016-01-12
Iowa State,Texas,91,94,1,-3,2016-01-12
Florida,Texas A&M,68,71,1,-3,2016-01-12
Northern Illinois,Toledo,71,66,0,5,2016-01-12
Air Force,Utah State,60,79,1,-19,2016-01-12
Auburn,Vanderbilt,57,75,1,-18,2016-01-12
Miami (FL),Virginia,58,66,1,-8,2016-01-12
Kansas,West Virginia,63,74,1,-11,2016-01-12
Ball State,Western Michigan,74,64,0,10,2016-01-12
DePaul,Xavier,64,84,1,-20,2016-01-12
South Carolina,Alabama,50,73,1,-23,2016-01-13
Boston University,American,61,50,0,11,2016-01-13
TCU,Baylor,54,82,1,-28,2016-01-13
Hartford,Binghamton,76,72,0,4,2016-01-13
Houston,Cincinnati,59,70,1,-11,2016-01-13
Duke,Clemson,63,68,1,-5,2016-01-13
Army,Colgate,66,80,1,-14,2016-01-13
Oregon State,Colorado,54,71,1,-17,2016-01-13
San Diego State,Colorado State,69,62,0,7,2016-01-13
Saint Louis,Duquesne,71,81,1,-10,2016-01-13
SMU,East Carolina,79,55,0,24,2016-01-13
St. Joseph's,George Mason,87,73,0,14,2016-01-13
Tennessee,Georgia,72,81,1,-9,2016-01-13
Nicholls State,Houston Baptist,69,78,1,-9,2016-01-13
Northern Iowa,Indiana State,60,74,1,-14,2016-01-13
Holy Cross,Lafayette,52,65,1,-13,2016-01-13
Ole Miss,LSU,81,90,1,-9,2016-01-13
Bradley,Loyola (IL),54,53,0,1,2016-01-13
Maine,UMass-Lowell,95,81,0,14,2016-01-13
Temple,Memphis,65,67,1,-2,2016-01-13
Wichita State,Missouri State,78,62,0,16,2016-01-13
Loyola (MD),Navy,52,60,1,-8,2016-01-13
Boise State,Nevada,74,67,0,7,2016-01-13
Florida State,NC State,85,78,0,7,2016-01-13
South Dakota,North Dakota State,65,66,1,-1,2016-01-13
Georgia Tech,Notre Dame,64,72,1,-8,2016-01-13
Rutgers,Ohio State,68,94,1,-26,2016-01-13
Oklahoma,Oklahoma State,74,72,0,2,2016-01-13
Penn State,Purdue,57,74,1,-17,2016-01-13
La Salle,Richmond,61,83,1,-22,2016-01-13
Wyoming,San Jose State,55,62,1,-7,2016-01-13
Jacksonville State,Southeast Missouri State,74,60,0,14,2016-01-13
Rhode Island,St. Bonaventure,64,69,1,-5,2016-01-13
Georgetown,St. John's (NY),93,73,0,20,2016-01-13
UMBC,Stony Brook,74,86,1,-12,2016-01-13
Boston College,Syracuse,40,62,1,-22,2016-01-13
Tennessee Tech,UT-Martin,90,96,1,-6,2016-01-13
USC,UCLA,89,75,0,14,2016-01-13
Marquette,Villanova,68,83,1,-15,2016-01-13
Fordham,VCU,54,88,1,-34,2016-01-13
Wake Forest,Virginia Tech,91,93,1,-2,2016-01-13
Washington,Arizona,67,99,1,-32,2016-01-14
Washington State,Arizona State,73,84,1,-11,2016-01-14
Appalachian State,Little Rock,55,81,1,-26,2016-01-14
Murray State,Belmont,73,81,1,-8,2016-01-14
St. Francis (NY),Bryant,59,61,1,-2,2016-01-14
UCSB,Cal Poly,76,73,0,3,2016-01-14
Cal State Northridge,UC-Davis,62,63,1,-1,2016-01-14
Hawaii,UC-Riverside,80,71,0,9,2016-01-14
Longwood,Campbell,74,57,0,17,2016-01-14
Sacred Heart,Central Connecticut,80,78,0,2,2016-01-14
Liberty,Charleston Southern,63,64,1,-1,2016-01-14
Middle Tennessee,Charlotte,73,72,0,1,2016-01-14
Western Carolina,Chattanooga,58,77,1,-19,2016-01-14
Wofford,Citadel,86,83,0,3,2016-01-14
Presbyterian,Coastal Carolina,58,87,1,-29,2016-01-14
William & Mary,College of Charleston,63,61,0,2,2016-01-14
Towson,Delaware,79,77,0,2,2016-01-14
Eastern Kentucky,Eastern Illinois,85,97,1,-12,2016-01-14
Southern Utah,Eastern Washington,80,106,1,-26,2016-01-14
UNC Wilmington,Elon,91,82,0,9,2016-01-14
Southern Miss,Florida Atlantic,51,58,1,-7,2016-01-14
NJIT,Florida Gulf Coast,78,82,1,-4,2016-01-14
Louisiana Tech,Florida International,74,88,1,-14,2016-01-14
Louisiana,Georgia Southern,74,65,0,9,2016-01-14
Louisiana-Monroe,Georgia State,51,65,1,-14,2016-01-14
BYU,Gonzaga,69,68,0,1,2016-01-14
Drexel,Hofstra,61,69,1,-8,2016-01-14
Northern Arizona,Idaho,76,83,1,-7,2016-01-14
Green Bay,UIC,78,76,0,2,2016-01-14
Oral Roberts,IUPUI,80,71,0,9,2016-01-14
Kennesaw State,Jacksonville,70,83,1,-13,2016-01-14
UC-Irvine,Long Beach State,58,54,0,4,2016-01-14
Pitt,Louisville,41,59,1,-18,2016-01-14
Furman,Mercer,65,69,1,-4,2016-01-14
Iowa,Michigan State,76,59,0,17,2016-01-14
UMKC,New Mexico State,64,65,1,-1,2016-01-14
Montana State,North Dakota,68,85,1,-17,2016-01-14
Lipscomb,North Florida,83,95,1,-12,2016-01-14
Marshall,North Texas,97,78,0,19,2016-01-14
James Madison,Northeastern,75,63,0,12,2016-01-14
Montana,Northern Colorado,73,66,0,7,2016-01-14
Youngstown State,Northern Kentucky,64,84,1,-20,2016-01-14
Alabama-Birmingham,Old Dominion,72,71,0,1,2016-01-14
San Diego,Portland,82,71,0,11,2016-01-14
Weber State,Portland State,73,58,0,15,2016-01-14
UNC Asheville,Radford,86,91,1,-5,2016-01-14
Western Kentucky,Rice,73,83,1,-10,2016-01-14
Marist,Rider,100,102,1,-2,2016-01-14
Mount St. Mary's,Robert Morris,76,52,0,24,2016-01-14
Idaho State,Sacramento State,71,82,1,-11,2016-01-14
Fairleigh Dickinson,Saint Francis (PA),71,59,0,12,2016-01-14
Pacific,Saint Mary's,62,78,1,-16,2016-01-14
ETSU,Samford,81,77,0,4,2016-01-14
Loyola Marymount,San Francisco,87,83,0,4,2016-01-14
Pepperdine,Santa Clara,60,62,1,-2,2016-01-14
Texas State,South Alabama,78,67,0,11,2016-01-14
Purdue-Fort Wayne,South Dakota State,76,92,1,-16,2016-01-14
Morehead State,SIU-Edwardsville,70,67,0,3,2016-01-14
California,Stanford,71,77,1,-6,2016-01-14
USC Upstate,Stetson,86,89,1,-3,2016-01-14
Austin Peay,Tennessee State,52,66,1,-14,2016-01-14
Chicago State,Texas-Rio Grande Valley,72,82,1,-10,2016-01-14
Texas-Arlington,Troy,90,63,0,27,2016-01-14
UConn,Tulsa,51,60,1,-9,2016-01-14
Oregon,Utah,77,59,0,18,2016-01-14
Milwaukee,Valparaiso,56,68,1,-12,2016-01-14
LIU-Brooklyn,Wagner,71,70,0,1,2016-01-14
Denver,Western Illinois,76,69,0,7,2016-01-14
High Point,Winthrop,66,86,1,-20,2016-01-14
Cleveland State,Wright State,53,70,1,-17,2016-01-14
George Washington,Dayton,70,77,1,-7,2016-01-15
Niagara,Fairfield,68,73,1,-5,2016-01-15
Evansville,Illinois State,66,55,0,11,2016-01-15
Monmouth,Iona,110,102,0,8,2016-01-15
Albany (NY),Maine,79,81,1,-2,2016-01-15
Canisius,Manhattan,65,62,0,3,2016-01-15
Siena,Quinnipiac,64,52,0,12,2016-01-15
Akron,Toledo,64,78,1,-14,2016-01-15
Alabama A&M,Alabama State,80,75,0,5,2016-01-16
Washington State,Arizona,66,90,1,-24,2016-01-16
Washington,Arizona State,89,85,0,4,2016-01-16
Southern,Arkansas-Pine Bluff,69,55,0,14,2016-01-16
Appalachian State,Arkansas State,86,72,0,14,2016-01-16
Kentucky,Auburn,70,75,1,-5,2016-01-16
Miami (OH),Ball State,46,48,1,-2,2016-01-16
Austin Peay,Belmont,58,76,1,-18,2016-01-16
Coppin State,Bethune-Cookman,62,54,0,8,2016-01-16
San Diego State,Boise State,56,53,0,3,2016-01-16
Missouri State,Bradley,61,42,0,19,2016-01-16
LIU-Brooklyn,Bryant,79,61,0,18,2016-01-16
Colgate,Bucknell,84,73,0,11,2016-01-16
Central Michigan,Buffalo,61,74,1,-13,2016-01-16
St. John's (NY),Butler,58,78,1,-20,2016-01-16
Long Beach State,Cal Poly,92,96,1,-4,2016-01-16
Hawaii,Cal State Fullerton,86,79,0,7,2016-01-16
UC-Riverside,Cal State Northridge,75,72,0,3,2016-01-16
UC-Irvine,UCSB,61,52,0,9,2016-01-16
Charleston Southern,Campbell,82,75,0,7,2016-01-16
East Carolina,UCF,69,89,1,-20,2016-01-16
Alabama-Birmingham,Charlotte,74,72,0,2,2016-01-16
ETSU,Chattanooga,84,94,1,-10,2016-01-16
Furman,Citadel,86,89,1,-3,2016-01-16
Miami (FL),Clemson,65,76,1,-11,2016-01-16
Elon,College of Charleston,65,64,0,1,2016-01-16
Utah State,Colorado State,96,92,0,4,2016-01-16
Cornell,Columbia,70,74,1,-4,2016-01-16
Pine Manor,Dartmouth,56,121,1,-65,2016-01-16
UMass,Davidson,74,86,1,-12,2016-01-16
Northeastern,Delaware,69,60,0,9,2016-01-16
Oakland,Detroit,86,82,0,4,2016-01-16
Notre Dame,Duke,95,91,0,4,2016-01-16
St. Bonaventure,Duquesne,88,95,1,-7,2016-01-16
Morehead State,Eastern Illinois,82,84,1,-2,2016-01-16
Bowling Green State,Eastern Michigan,84,79,0,5,2016-01-16
Northern Arizona,Eastern Washington,73,96,1,-23,2016-01-16
Morgan State,Florida A&M,65,72,1,-7,2016-01-16
Louisiana Tech,Florida Atlantic,61,63,1,-2,2016-01-16
USC Upstate,Florida Gulf Coast,56,85,1,-29,2016-01-16
Southern Miss,Florida International,66,60,0,6,2016-01-16
San Jose State,Fresno State,74,81,1,-7,2016-01-16
Villanova,Georgetown,55,50,0,5,2016-01-16
Texas A&M,Georgia,79,45,0,34,2016-01-16
Louisiana-Monroe,Georgia Southern,51,66,1,-15,2016-01-16
Louisiana,Georgia State,87,54,0,33,2016-01-16
Virginia Tech,Georgia Tech,78,77,0,1,2016-01-16
San Diego,Gonzaga,52,88,1,-36,2016-01-16
Prairie View,Grambling,63,66,1,-3,2016-01-16
Utah Valley,Grand Canyon,88,99,1,-11,2016-01-16
Vermont,Hartford,83,68,0,15,2016-01-16
Coastal Carolina,High Point,71,68,0,3,2016-01-16
James Madison,Hofstra,86,82,0,4,2016-01-16
Lehigh,Holy Cross,87,66,0,21,2016-01-16
Harvard,Howard,69,61,0,8,2016-01-16
Southern Utah,Idaho,85,83,0,2,2016-01-16
Nebraska,Illinois,78,67,0,11,2016-01-16
Milwaukee,UIC,87,62,0,25,2016-01-16
Denver,IUPUI,61,76,1,-15,2016-01-16
Texas Southern,Jackson State,71,65,0,6,2016-01-16
Lipscomb,Jacksonville,73,76,1,-3,2016-01-16
UT-Martin,Jacksonville State,60,82,1,-22,2016-01-16
TCU,Kansas,63,70,1,-7,2016-01-16
Iowa State,Kansas State,76,63,0,13,2016-01-16
Ohio,Kent State,82,89,1,-7,2016-01-16
Northwestern State,Lamar,82,86,1,-4,2016-01-16
Arkansas,LSU,74,76,1,-2,2016-01-16
Xavier,Marquette,74,66,0,8,2016-01-16
Ohio State,Maryland,65,100,1,-35,2016-01-16
UMass-Lowell,UMBC,95,89,0,6,2016-01-16
Sam Houston State,McNeese State,68,72,1,-4,2016-01-16
South Florida,Memphis,56,71,1,-15,2016-01-16
Wofford,Mercer,69,70,1,-1,2016-01-16
Indiana,Minnesota,70,63,0,7,2016-01-16
Florida,Ole Miss,80,71,0,9,2016-01-16
Tennessee,Mississippi State,80,75,0,5,2016-01-16
Alcorn State,Mississippi Valley State,93,87,0,6,2016-01-16
Lafayette,Navy,61,87,1,-26,2016-01-16
Purdue-Fort Wayne,Omaha,106,101,0,5,2016-01-16
Air Force,UNLV,64,100,1,-36,2016-01-16
Stony Brook,New Hampshire,80,50,0,30,2016-01-16
Wyoming,New Mexico,70,68,0,2,2016-01-16
Chicago State,New Mexico State,62,80,1,-18,2016-01-16
Houston Baptist,New Orleans,73,69,0,4,2016-01-16
NC State,UNC,55,67,1,-12,2016-01-16
Gardner-Webb,UNC Asheville,69,75,1,-6,2016-01-16
Hampton,North Carolina A&T,79,62,0,17,2016-01-16
Norfolk State,North Carolina Central,88,79,0,9,2016-01-16
William & Mary,UNC Wilmington,94,97,1,-3,2016-01-16
Montana,North Dakota,65,61,0,4,2016-01-16
South Dakota State,North Dakota State,57,68,1,-11,2016-01-16
Kennesaw State,North Florida,78,93,1,-15,2016-01-16
Western Kentucky,North Texas,81,76,0,5,2016-01-16
Montana State,Northern Colorado,76,78,1,-2,2016-01-16
Loyola (IL),Northern Iowa,51,41,0,10,2016-01-16
Cleveland State,Northern Kentucky,70,65,0,5,2016-01-16
Penn State,Northwestern,71,62,0,9,2016-01-16
West Virginia,Oklahoma,68,70,1,-2,2016-01-16
Middle Tennessee,Old Dominion,64,61,0,3,2016-01-16
Bethesda University (CA),Pacific,30,88,1,-58,2016-01-16
Boston College,Pitt,61,84,1,-23,2016-01-16
BYU,Portland,81,84,1,-3,2016-01-16
Idaho State,Portland State,73,70,0,3,2016-01-16
Radford,Presbyterian,68,69,1,-1,2016-01-16
Seton Hall,Providence,81,72,0,9,2016-01-16
La Salle,Rhode Island,62,73,1,-11,2016-01-16
Marshall,Rice,94,90,0,4,2016-01-16
VCU,Richmond,94,89,0,5,2016-01-16
Fairleigh Dickinson,Robert Morris,58,64,1,-6,2016-01-16
Weber State,Sacramento State,85,74,0,11,2016-01-16
Mount St. Mary's,Saint Francis (PA),82,72,0,10,2016-01-16
Fordham,St. Joseph's,55,80,1,-25,2016-01-16
Western Carolina,Samford,68,84,1,-16,2016-01-16
Pepperdine,San Francisco,98,84,0,14,2016-01-16
Loyola Marymount,Santa Clara,76,66,0,10,2016-01-16
Maryland-Eastern Shore,Savannah State,61,68,1,-7,2016-01-16
Cal State Bakersfield,Seattle,79,52,0,27,2016-01-16
Texas-Arlington,South Alabama,85,88,1,-3,2016-01-16
Missouri,South Carolina,72,81,1,-9,2016-01-16
Delaware State,South Carolina State,79,90,1,-11,2016-01-16
Incarnate Word,Southeastern Louisiana,75,71,0,4,2016-01-16
Eastern Kentucky,SIU-Edwardsville,65,67,1,-2,2016-01-16
Sacred Heart,St. Francis (NY),67,85,1,-18,2016-01-16
Abilene Christian,Stephen F. Austin,62,97,1,-35,2016-01-16
NJIT,Stetson,71,59,0,12,2016-01-16
Cincinnati,Temple,65,67,1,-2,2016-01-16
Murray State,Tennessee State,71,73,1,-2,2016-01-16
Southeast Missouri State,Tennessee Tech,55,91,1,-36,2016-01-16
Oklahoma State,Texas,69,74,1,-5,2016-01-16
Nicholls State,Texas A&M-Corpus Christi,71,76,1,-5,2016-01-16
UMKC,Texas-Rio Grande Valley,66,71,1,-5,2016-01-16
UTEP,UTSA,67,71,1,-4,2016-01-16
Baylor,Texas Tech,63,60,0,3,2016-01-16
Drexel,Towson,50,69,1,-19,2016-01-16
Texas State,Troy,57,66,1,-9,2016-01-16
Green Bay,Valparaiso,70,85,1,-15,2016-01-16
Alabama,Vanderbilt,63,71,1,-8,2016-01-16
Central Connecticut,Wagner,48,70,1,-22,2016-01-16
Syracuse,Wake Forest,83,55,0,28,2016-01-16
Oral Roberts,Western Illinois,77,68,0,9,2016-01-16
Northern Illinois,Western Michigan,69,83,1,-14,2016-01-16
Liberty,Winthrop,58,74,1,-16,2016-01-16
Youngstown State,Wright State,45,81,1,-36,2016-01-16
Brown,Yale,68,77,1,-9,2016-01-16
American,Army,45,65,1,-20,2016-01-17
Oregon,Colorado,87,91,1,-4,2016-01-17
Creighton,DePaul,91,80,0,11,2016-01-17
Southern Illinois,Drake,81,76,0,5,2016-01-17
Virginia,Florida State,62,69,1,-7,2016-01-17
UConn,Houston,69,57,0,12,2016-01-17
Michigan,Iowa,71,82,1,-11,2016-01-17
Niagara,Manhattan,64,69,1,-5,2016-01-17
VMI,UNC Greensboro,68,85,1,-17,2016-01-17
Canisius,Quinnipiac,63,53,0,10,2016-01-17
Iona,Rider,75,79,1,-4,2016-01-17
George Mason,Saint Louis,92,79,0,13,2016-01-17
Marist,St. Peter's,67,76,1,-9,2016-01-17
SMU,Tulane,60,45,0,15,2016-01-17
Oregon State,Utah,53,59,1,-6,2016-01-17
Indiana State,Wichita State,62,82,1,-20,2016-01-17
Michigan State,Wisconsin,76,77,1,-1,2016-01-17
Binghamton,Albany (NY),59,80,1,-21,2016-01-18
Alcorn State,Arkansas-Pine Bluff,73,65,0,8,2016-01-18
Little Rock,Arkansas State,73,76,1,-3,2016-01-18
Morgan State,Bethune-Cookman,50,62,1,-12,2016-01-18
Loyola (MD),Boston University,84,87,1,-3,2016-01-18
UIC,Cleveland State,53,70,1,-17,2016-01-18
Syracuse,Duke,64,62,0,2,2016-01-18
Coppin State,Florida A&M,70,66,0,4,2016-01-18
Texas Southern,Grambling,69,54,0,15,2016-01-18
Stony Brook,Hartford,77,43,0,34,2016-01-18
Oklahoma,Iowa State,77,82,1,-5,2016-01-18
Prairie View,Jackson State,57,60,1,-3,2016-01-18
New Hampshire,Maine,99,91,0,8,2016-01-18
Southern,Mississippi Valley State,67,54,0,13,2016-01-18
Siena,Monmouth,69,85,1,-16,2016-01-18
Stephen F. Austin,New Orleans,82,58,0,24,2016-01-18
Norfolk State,North Carolina A&T,75,68,0,7,2016-01-18
Hampton,North Carolina Central,80,79,0,1,2016-01-18
Purdue,Rutgers,107,57,0,50,2016-01-18
Nicholls State,Sam Houston State,76,87,1,-11,2016-01-18
Delaware State,Savannah State,47,64,1,-17,2016-01-18
Maryland-Eastern Shore,South Carolina State,63,68,1,-5,2016-01-18
Lamar,Southeastern Louisiana,70,98,1,-28,2016-01-18
Texas Tech,TCU,76,69,0,7,2016-01-18
UMass-Lowell,Vermont,93,82,0,11,2016-01-18
Detroit,Wright State,76,77,1,-1,2016-01-18
Valparaiso,Youngstown State,96,65,0,31,2016-01-18
McNeese State,Abilene Christian,67,75,1,-8,2016-01-19
Eastern Michigan,Akron,88,92,1,-4,2016-01-19
Alabama,Auburn,77,83,1,-6,2016-01-19
Kent State,Ball State,76,68,0,8,2016-01-19
Toledo,Bowling Green State,81,74,0,7,2016-01-19
Houston Baptist,Central Arkansas,72,61,0,11,2016-01-19
Green Bay,Chicago State,99,66,0,33,2016-01-19
Tulane,UConn,42,60,1,-18,2016-01-19
Tulsa,East Carolina,84,69,0,15,2016-01-19
Loyola (IL),Evansville,66,74,1,-8,2016-01-19
St. Peter's,Fairfield,77,71,0,6,2016-01-19
Mississippi State,Florida,78,81,1,-3,2016-01-19
Georgia Southern,Georgia State,66,69,1,-3,2016-01-19
Illinois,Indiana,69,103,1,-34,2016-01-19
Longwood,Liberty,53,55,1,-2,2016-01-19
Northwestern,Maryland,56,62,1,-6,2016-01-19
Buffalo,Miami (OH),77,60,0,17,2016-01-19
South Carolina,Ole Miss,77,74,0,3,2016-01-19
Central Michigan,Northern Illinois,70,75,1,-5,2016-01-19
Texas A&M-Corpus Christi,Northwestern State,89,79,0,10,2016-01-19
Northern Kentucky,Oakland,90,73,0,17,2016-01-19
Western Michigan,Ohio,64,82,1,-18,2016-01-19
Kansas,Oklahoma State,67,86,1,-19,2016-01-19
NC State,Pitt,78,61,0,17,2016-01-19
Butler,Providence,68,71,1,-3,2016-01-19
Fresno State,San Diego State,67,73,1,-6,2016-01-19
Hannibal-LaGrange,Southeast Missouri State,61,84,1,-23,2016-01-19
Houston,SMU,73,77,1,-4,2016-01-19
Dayton,St. Bonaventure,85,79,0,6,2016-01-19
LSU,Texas A&M,57,71,1,-14,2016-01-19
UNLV,Utah State,80,68,0,12,2016-01-19
Clemson,Virginia,62,69,1,-7,2016-01-19
Tennessee Wesleyan,Wofford,66,89,1,-23,2016-01-19
Georgetown,Xavier,81,72,0,9,2016-01-19
Colorado State,Air Force,83,79,0,4,2016-01-20
Kansas State,Baylor,72,79,1,-7,2016-01-20
San Jose State,Boise State,69,94,1,-25,2016-01-20
Miami (FL),Boston College,67,53,0,14,2016-01-20
Illinois State,Bradley,55,52,0,3,2016-01-20
Cal State Fullerton,UC-Irvine,59,72,1,-13,2016-01-20
Long Beach State,UCSB,77,67,0,10,2016-01-20
Boston University,Colgate,78,85,1,-7,2016-01-20
Missouri State,Drake,79,70,0,9,2016-01-20
George Mason,Fordham,62,73,1,-11,2016-01-20
Winthrop,Gardner-Webb,71,58,0,13,2016-01-20
UNC Asheville,High Point,69,73,1,-4,2016-01-20
Army,Holy Cross,65,69,1,-4,2016-01-20
Temple,La Salle,62,49,0,13,2016-01-20
American,Lafayette,81,73,0,8,2016-01-20
Navy,Lehigh,69,64,0,5,2016-01-20
Florida State,Louisville,65,84,1,-19,2016-01-20
Bucknell,Loyola (MD),67,58,0,9,2016-01-20
DePaul,Marquette,57,56,0,1,2016-01-20
Minnesota,Michigan,69,74,1,-5,2016-01-20
Nebraska,Michigan State,72,71,0,1,2016-01-20
Georgia,Missouri,60,57,0,3,2016-01-20
Wake Forest,UNC,68,83,1,-15,2016-01-20
Wichita State,Northern Iowa,74,55,0,19,2016-01-20
Virginia Tech,Notre Dame,81,83,1,-2,2016-01-20
UCLA,Oregon State,82,73,0,9,2016-01-20
St. Joseph's,Penn,75,60,0,15,2016-01-20
Charleston Southern,Presbyterian,73,72,0,1,2016-01-20
Campbell,Radford,66,78,1,-12,2016-01-20
Davidson,Saint Louis,87,96,1,-9,2016-01-20
Villanova,Seton Hall,72,71,0,1,2016-01-20
Western Illinois,South Dakota,67,76,1,-9,2016-01-20
UCF,South Florida,64,54,0,10,2016-01-20
Indiana State,Southern Illinois,66,79,1,-13,2016-01-20
Vanderbilt,Tennessee,88,74,0,14,2016-01-20
Duquesne,VCU,71,93,1,-22,2016-01-20
Colorado,Washington,83,95,1,-12,2016-01-20
Texas,West Virginia,56,49,0,7,2016-01-20
Nevada,Wyoming,75,69,0,6,2016-01-20
Rice,Alabama-Birmingham,70,82,1,-12,2016-01-21
Georgia State,Appalachian State,67,76,1,-9,2016-01-21
Kentucky,Arkansas,80,66,0,14,2016-01-21
SIU-Edwardsville,Austin Peay,86,90,1,-4,2016-01-21
Vermont,Binghamton,61,52,0,9,2016-01-21
Saint Francis (PA),Bryant,71,65,0,6,2016-01-21
Texas-Rio Grande Valley,Cal State Bakersfield,58,77,1,-19,2016-01-21
Cal Poly,Cal State Northridge,74,76,1,-2,2016-01-21
Arizona State,California,70,75,1,-5,2016-01-21
UC-Riverside,UC-Davis,55,58,1,-3,2016-01-21
Robert Morris,Central Connecticut,59,45,0,14,2016-01-21
Marshall,Charlotte,95,103,1,-8,2016-01-21
Grand Canyon,Chicago State,90,65,0,25,2016-01-21
Memphis,Cincinnati,72,76,1,-4,2016-01-21
Omaha,Denver,69,55,0,14,2016-01-21
Mercer,ETSU,63,65,1,-2,2016-01-21
Jacksonville State,Eastern Kentucky,88,91,1,-3,2016-01-21
LIU-Brooklyn,Fairleigh Dickinson,95,101,1,-6,2016-01-21
North Dakota State,Purdue-Fort Wayne,74,79,1,-5,2016-01-21
Drexel,James Madison,45,68,1,-23,2016-01-21
Florida Gulf Coast,Kennesaw State,79,74,0,5,2016-01-21
Stetson,Lipscomb,87,92,1,-5,2016-01-21
South Alabama,Louisiana,82,92,1,-10,2016-01-21
Troy,Louisiana-Monroe,74,85,1,-11,2016-01-21
BYU,Loyola Marymount,91,80,0,11,2016-01-21
Monmouth,Manhattan,71,78,1,-7,2016-01-21
Hartford,UMBC,98,87,0,11,2016-01-21
New Hampshire,UMass-Lowell,78,76,0,2,2016-01-21
North Texas,Middle Tennessee,64,86,1,-22,2016-01-21
Utah Valley,UMKC,90,79,0,11,2016-01-21
Idaho,Montana,63,58,0,5,2016-01-21
Eastern Washington,Montana State,71,85,1,-14,2016-01-21
Tennessee Tech,Morehead State,74,81,1,-7,2016-01-21
Eastern Illinois,Murray State,58,68,1,-10,2016-01-21
Jacksonville,NJIT,63,83,1,-20,2016-01-21
Chattanooga,UNC Greensboro,73,60,0,13,2016-01-21
Delaware,UNC Wilmington,70,79,1,-9,2016-01-21
Hofstra,Northeastern,96,92,0,4,2016-01-21
North Dakota,Northern Arizona,101,59,0,42,2016-01-21
Western Kentucky,Old Dominion,62,68,1,-6,2016-01-21
South Dakota State,Oral Roberts,86,74,0,12,2016-01-21
USC,Oregon,81,89,1,-8,2016-01-21
Portland,Pacific,61,70,1,-9,2016-01-21
Wisconsin,Penn State,66,60,0,6,2016-01-21
San Diego,Pepperdine,58,76,1,-18,2016-01-21
Ohio State,Purdue,64,75,1,-11,2016-01-21
Iowa,Rutgers,90,76,0,14,2016-01-21
Mount St. Mary's,Sacred Heart,71,76,1,-5,2016-01-21
Gonzaga,Saint Mary's,67,70,1,-3,2016-01-21
San Francisco,Santa Clara,74,61,0,13,2016-01-21
New Mexico State,Seattle,68,60,0,8,2016-01-21
Rider,Siena,52,63,1,-11,2016-01-21
North Florida,USC Upstate,78,62,0,16,2016-01-21
Northern Colorado,Southern Utah,90,80,0,10,2016-01-21
Wagner,St. Francis (NY),83,59,0,24,2016-01-21
Arizona,Stanford,71,57,0,14,2016-01-21
Belmont,UT-Martin,82,72,0,10,2016-01-21
Arkansas State,Texas-Arlington,64,91,1,-27,2016-01-21
Florida Atlantic,UTEP,56,71,1,-15,2016-01-21
Florida International,UTSA,72,56,0,16,2016-01-21
Little Rock,Texas State,77,74,0,3,2016-01-21
College of Charleston,Towson,40,37,0,3,2016-01-21
Samford,VMI,76,83,1,-7,2016-01-21
Utah,Washington State,92,71,0,21,2016-01-21
Citadel,Western Carolina,92,91,0,1,2016-01-21
Elon,William & Mary,67,89,1,-22,2016-01-21
Yale,Brown,90,66,0,24,2016-01-22
Duquesne,George Mason,86,75,0,11,2016-01-22
Rhode Island,George Washington,58,62,1,-4,2016-01-22
St. Peter's,Iona,58,64,1,-6,2016-01-22
Fairfield,Marist,88,76,0,12,2016-01-22
Canisius,Niagara,70,61,0,9,2016-01-22
Toledo,Northern Illinois,49,58,1,-9,2016-01-22
UIC,Northern Kentucky,69,82,1,-13,2016-01-22
Albany (NY),Stony Brook,63,69,1,-6,2016-01-22
Valparaiso,Wright State,62,73,1,-11,2016-01-22
Fresno State,Air Force,56,55,0,1,2016-01-23
Miami (OH),Akron,46,75,1,-29,2016-01-23
LSU,Alabama,72,70,0,2,2016-01-23
North Texas,Alabama-Birmingham,57,78,1,-21,2016-01-23
Alabama A&M,Alcorn State,58,63,1,-5,2016-01-23
Eastern Illinois,Austin Peay,87,86,0,1,2016-01-23
Oklahoma,Baylor,82,72,0,10,2016-01-23
Bucknell,Boston University,74,71,0,3,2016-01-23
Kent State,Bowling Green State,62,59,0,3,2016-01-23
Robert Morris,Bryant,65,54,0,11,2016-01-23
New Mexico State,Cal State Bakersfield,68,67,0,1,2016-01-23
Cal Poly,Cal State Fullerton,83,75,0,8,2016-01-23
Arizona,California,73,74,1,-1,2016-01-23
Long Beach State,UC-Riverside,72,74,1,-2,2016-01-23
Cal State Northridge,UCSB,61,74,1,-13,2016-01-23
Saint Francis (PA),Central Connecticut,79,64,0,15,2016-01-23
Ohio,Central Michigan,49,72,1,-23,2016-01-23
Coastal Carolina,Charleston Southern,78,63,0,15,2016-01-23
Western Kentucky,Charlotte,71,88,1,-17,2016-01-23
Utah Valley,Chicago State,82,76,0,6,2016-01-23
Delaware,College of Charleston,58,59,1,-1,2016-01-23
Georgetown,UConn,62,68,1,-6,2016-01-23
Columbia,Cornell,79,68,0,11,2016-01-23
Butler,Creighton,64,72,1,-8,2016-01-23
Harvard,Dartmouth,50,63,1,-13,2016-01-23
Citadel,ETSU,92,101,1,-9,2016-01-23
Tennessee Tech,Eastern Kentucky,89,83,0,6,2016-01-23
Ball State,Eastern Michigan,88,87,0,1,2016-01-23
James Madison,Elon,82,64,0,18,2016-01-23
Auburn,Florida,63,95,1,-32,2016-01-23
Pitt,Florida State,74,72,0,2,2016-01-23
Wofford,Furman,62,63,1,-1,2016-01-23
Arkansas,Georgia,73,76,1,-3,2016-01-23
Louisville,Georgia Tech,75,71,0,4,2016-01-23
Oakland,Green Bay,111,95,0,16,2016-01-23
Savannah State,Hampton,52,75,1,-23,2016-01-23
UC-Davis,Hawaii,62,78,1,-16,2016-01-23
South Florida,Houston,71,62,0,9,2016-01-23
Weber State,Idaho State,68,69,1,-1,2016-01-23
Northern Iowa,Illinois State,67,76,1,-9,2016-01-23
Abilene Christian,Incarnate Word,60,74,1,-14,2016-01-23
Northwestern,Indiana,57,89,1,-32,2016-01-23
IUPUI,Purdue-Fort Wayne,84,82,0,2,2016-01-23
Grambling,Jackson State,45,60,1,-15,2016-01-23
Texas,Kansas,67,76,1,-9,2016-01-23
Oklahoma State,Kansas State,73,89,1,-16,2016-01-23
Stetson,Kennesaw State,84,79,0,5,2016-01-23
Vanderbilt,Kentucky,57,76,1,-19,2016-01-23
Houston Baptist,Lamar,92,79,0,13,2016-01-23
High Point,Liberty,67,69,1,-2,2016-01-23
St. Francis (NY),LIU-Brooklyn,64,49,0,15,2016-01-23
Troy,Louisiana,65,88,1,-23,2016-01-23
South Alabama,Louisiana-Monroe,68,100,1,-32,2016-01-23
Drake,Loyola (IL),63,68,1,-5,2016-01-23
San Diego,Loyola Marymount,63,67,1,-4,2016-01-23
Bethune-Cookman,Maryland-Eastern Shore,72,74,1,-2,2016-01-23
Saint Louis,UMass,86,75,0,11,2016-01-23
Northwestern State,McNeese State,74,75,1,-1,2016-01-23
Wake Forest,Miami (FL),63,77,1,-14,2016-01-23
Maryland,Michigan State,65,74,1,-9,2016-01-23
Rice,Middle Tennessee,73,87,1,-14,2016-01-23
Detroit,Milwaukee,80,83,1,-3,2016-01-23
Illinois,Minnesota,76,71,0,5,2016-01-23
Ole Miss,Mississippi State,77,83,1,-6,2016-01-23
Grand Canyon,UMKC,85,78,0,7,2016-01-23
Eastern Washington,Montana,69,74,1,-5,2016-01-23
Idaho,Montana State,68,70,1,-2,2016-01-23
SIU-Edwardsville,Murray State,54,70,1,-16,2016-01-23
Michigan,Nebraska,81,68,0,13,2016-01-23
UNLV,Nevada,63,65,1,-2,2016-01-23
Central Arkansas,Nicholls State,94,83,0,11,2016-01-23
South Carolina State,Norfolk State,74,87,1,-13,2016-01-23
Presbyterian,UNC Asheville,55,67,1,-12,2016-01-23
Duke,NC State,88,78,0,10,2016-01-23
Towson,Northeastern,79,72,0,7,2016-01-23
Northern Colorado,Northern Arizona,84,79,0,5,2016-01-23
Boston College,Notre Dame,49,76,1,-27,2016-01-23
Marshall,Old Dominion,78,75,0,3,2016-01-23
Omaha,Oral Roberts,85,79,0,6,2016-01-23
UCLA,Oregon,72,86,1,-14,2016-01-23
Gonzaga,Pacific,71,61,0,10,2016-01-23
BYU,Pepperdine,65,71,1,-6,2016-01-23
Arkansas-Pine Bluff,Prairie View,45,44,0,1,2016-01-23
Portland State,Sacramento State,81,63,0,18,2016-01-23
Portland,Saint Mary's,74,89,1,-15,2016-01-23
Utah State,San Diego State,55,70,1,-15,2016-01-23
New Mexico,San Jose State,83,64,0,19,2016-01-23
Texas-Rio Grande Valley,Seattle,59,70,1,-11,2016-01-23
Jacksonville,USC Upstate,77,68,0,9,2016-01-23
South Dakota State,South Dakota,79,75,0,4,2016-01-23
Alabama State,Southern,69,73,1,-4,2016-01-23
Louisiana Tech,Southern Miss,70,59,0,11,2016-01-23
North Dakota,Southern Utah,88,72,0,16,2016-01-23
Arizona State,Stanford,73,75,1,-2,2016-01-23
Sam Houston State,Stephen F. Austin,64,76,1,-12,2016-01-23
South Carolina,Tennessee,69,78,1,-9,2016-01-23
Missouri,Texas A&M,53,66,1,-13,2016-01-23
New Orleans,Texas A&M-Corpus Christi,76,97,1,-21,2016-01-23
Little Rock,Texas-Arlington,68,62,0,6,2016-01-23
Iowa State,TCU,73,60,0,13,2016-01-23
Florida International,UTEP,79,69,0,10,2016-01-23
Florida Atlantic,UTSA,86,71,0,15,2016-01-23
Mississippi Valley State,Texas Southern,60,75,1,-15,2016-01-23
Arkansas State,Texas State,68,78,1,-10,2016-01-23
West Virginia,Texas Tech,80,76,0,4,2016-01-23
Colorado,Washington State,75,70,0,5,2016-01-23
North Dakota State,Western Illinois,65,52,0,13,2016-01-23
Buffalo,Western Michigan,71,91,1,-20,2016-01-23
Bradley,Wichita State,54,88,1,-34,2016-01-23
Boise State,Wyoming,81,71,0,10,2016-01-23
Seton Hall,Xavier,76,84,1,-8,2016-01-23
Tennessee State,Belmont,95,103,1,-8,2016-01-24
Siena,Canisius,99,78,0,21,2016-01-24
Tulane,Cincinnati,75,97,1,-22,2016-01-24
Holy Cross,Colgate,61,76,1,-15,2016-01-24
UNC Wilmington,Drexel,77,71,0,6,2016-01-24
Iona,Fairfield,91,98,1,-7,2016-01-24
Mount St. Mary's,Fairleigh Dickinson,87,72,0,15,2016-01-24
Dayton,Fordham,64,50,0,14,2016-01-24
William & Mary,Hofstra,63,91,1,-28,2016-01-24
Evansville,Indiana State,65,82,1,-17,2016-01-24
Purdue,Iowa,71,83,1,-12,2016-01-24
St. Joseph's,La Salle,69,48,0,21,2016-01-24
Florida Gulf Coast,Lipscomb,75,91,1,-16,2016-01-24
Winthrop,Longwood,82,68,0,14,2016-01-24
Binghamton,UMass-Lowell,64,57,0,7,2016-01-24
East Carolina,Memphis,84,83,0,1,2016-01-24
Southern Illinois,Missouri State,80,65,0,15,2016-01-24
Marist,Monmouth,72,83,1,-11,2016-01-24
Jacksonville State,Morehead State,78,74,0,4,2016-01-24
Hartford,New Hampshire,71,84,1,-13,2016-01-24
North Florida,NJIT,94,80,0,14,2016-01-24
Samford,UNC Greensboro,78,86,1,-8,2016-01-24
Valparaiso,Northern Kentucky,71,46,0,25,2016-01-24
USC,Oregon State,70,85,1,-15,2016-01-24
Bryn Athyn,Princeton,44,100,1,-56,2016-01-24
Gardner-Webb,Radford,59,69,1,-10,2016-01-24
Quinnipiac,Rider,52,75,1,-23,2016-01-24
UT-Martin,Southeast Missouri State,60,68,1,-8,2016-01-24
Marquette,St. John's (NY),78,73,0,5,2016-01-24
SMU,Temple,80,89,1,-9,2016-01-24
UCF,Tulsa,60,75,1,-15,2016-01-24
UMBC,Vermont,72,79,1,-7,2016-01-24
Providence,Villanova,82,76,0,6,2016-01-24
Syracuse,Virginia,65,73,1,-8,2016-01-24
St. Bonaventure,VCU,76,84,1,-8,2016-01-24
UNC,Virginia Tech,75,70,0,5,2016-01-24
Sacred Heart,Wagner,67,58,0,9,2016-01-24
Utah,Washington,80,75,0,5,2016-01-24
Mercer,Western Carolina,80,86,1,-6,2016-01-24
UIC,Wright State,66,80,1,-14,2016-01-24
Cleveland State,Youngstown State,55,70,1,-15,2016-01-24
Alabama State,Alcorn State,72,77,1,-5,2016-01-25
Georgia Southern,Appalachian State,101,100,0,1,2016-01-25
Lafayette,Bucknell,67,79,1,-12,2016-01-25
North Carolina A&T,Delaware State,55,57,1,-2,2016-01-25
Detroit,Green Bay,108,115,1,-7,2016-01-25
South Carolina State,Hampton,67,62,0,5,2016-01-25
Hillsdale,Houston Baptist,84,109,1,-25,2016-01-25
Kansas,Iowa State,72,85,1,-13,2016-01-25
Incarnate Word,McNeese State,76,79,1,-3,2016-01-25
Duke,Miami (FL),69,80,1,-11,2016-01-25
Oakland,Milwaukee,82,79,0,3,2016-01-25
Central Arkansas,New Orleans,83,94,1,-11,2016-01-25
Northwestern State,Nicholls State,88,80,0,8,2016-01-25
Savannah State,Norfolk State,73,92,1,-19,2016-01-25
Penn State,Ohio State,46,66,1,-20,2016-01-25
Mississippi Valley State,Prairie View,76,73,0,3,2016-01-25
Davidson,Richmond,78,70,0,8,2016-01-25
Abilene Christian,Sam Houston State,51,72,1,-21,2016-01-25
Alabama A&M,Southern,52,73,1,-21,2016-01-25
Lamar,Stephen F. Austin,52,86,1,-34,2016-01-25
Maine,Stony Brook,54,81,1,-27,2016-01-25
Arkansas-Pine Bluff,Texas Southern,49,78,1,-29,2016-01-25
Furman,VMI,68,56,0,12,2016-01-25
Northern Illinois,Akron,66,76,1,-10,2016-01-26
Tennessee,Alabama,57,63,1,-6,2016-01-26
Florida State,Boston College,72,62,0,10,2016-01-26
Ball State,Buffalo,64,76,1,-12,2016-01-26
Memphis,UCF,97,86,0,11,2016-01-26
La Salle,Duquesne,60,87,1,-27,2016-01-26
Wyoming,Fresno State,60,71,1,-11,2016-01-26
Creighton,Georgetown,73,74,1,-1,2016-01-26
Bethune-Cookman,Howard,68,70,1,-2,2016-01-26
Drake,Illinois State,64,76,1,-12,2016-01-26
Eastern Michigan,Kent State,58,73,1,-15,2016-01-26
Georgia,LSU,85,89,1,-4,2016-01-26
Central Michigan,Miami (OH),68,51,0,17,2016-01-26
San Diego State,Nevada,57,54,0,3,2016-01-26
Siena,Niagara,82,70,0,12,2016-01-26
Texas Tech,Oklahoma,67,91,1,-24,2016-01-26
Xavier,Providence,75,68,0,7,2016-01-26
Mississippi State,South Carolina,74,84,1,-10,2016-01-26
TCU,Texas,54,71,1,-17,2016-01-26
Southeastern Louisiana,Texas A&M-Corpus Christi,63,73,1,-10,2016-01-26
Ohio,Toledo,81,79,0,2,2016-01-26
South Alabama,Troy,66,58,0,8,2016-01-26
Florida,Vanderbilt,59,60,1,-1,2016-01-26
Virginia,Wake Forest,72,71,0,1,2016-01-26
Kansas State,West Virginia,55,70,1,-15,2016-01-26
Bowling Green State,Western Michigan,79,78,0,1,2016-01-26
Indiana,Wisconsin,79,82,1,-3,2016-01-26
UMass-Lowell,Albany (NY),63,75,1,-12,2016-01-27
Texas A&M,Arkansas,71,74,1,-3,2016-01-27
Boston University,Army,76,67,0,9,2016-01-27
UMBC,Binghamton,57,66,1,-9,2016-01-27
Northern Iowa,Bradley,68,50,0,18,2016-01-27
DePaul,Butler,53,67,1,-14,2016-01-27
UC-Irvine,Cal State Northridge,73,63,0,10,2016-01-27
Cal State Fullerton,UC-Davis,64,69,1,-5,2016-01-27
High Point,Campbell,73,63,0,10,2016-01-27
Pitt,Clemson,60,73,1,-13,2016-01-27
UNC Asheville,Coastal Carolina,66,68,1,-2,2016-01-27
Stanford,Colorado,75,91,1,-16,2016-01-27
San Jose State,Colorado State,66,74,1,-8,2016-01-27
North Carolina A&T,Coppin State,68,73,1,-5,2016-01-27
Saint Louis,Dayton,37,73,1,-36,2016-01-27
North Carolina Central,Delaware State,60,71,1,-11,2016-01-27
Temple,East Carolina,61,64,1,-3,2016-01-27
Murray State,Eastern Kentucky,75,71,0,4,2016-01-27
Jacksonville,Florida Gulf Coast,78,69,0,9,2016-01-27
Liberty,Gardner-Webb,69,55,0,14,2016-01-27
Maine,Hartford,105,100,0,5,2016-01-27
Loyola (MD),Holy Cross,71,54,0,17,2016-01-27
Tulsa,Houston,66,81,1,-15,2016-01-27
Missouri State,Indiana State,59,68,1,-9,2016-01-27
Missouri,Kentucky,54,88,1,-34,2016-01-27
Colgate,Lehigh,70,79,1,-9,2016-01-27
Sacred Heart,LIU-Brooklyn,84,92,1,-8,2016-01-27
Radford,Longwood,90,81,0,9,2016-01-27
Stetson,Marquette,60,74,1,-14,2016-01-27
Rutgers,Michigan,57,68,1,-11,2016-01-27
Purdue,Minnesota,68,64,0,4,2016-01-27
Auburn,Ole Miss,63,80,1,-17,2016-01-27
Austin Peay,Morehead State,65,75,1,-10,2016-01-27
American,Navy,63,58,0,5,2016-01-27
Boise State,UNLV,77,87,1,-10,2016-01-27
Vermont,New Hampshire,66,50,0,16,2016-01-27
Air Force,New Mexico,55,84,1,-29,2016-01-27
Lipscomb,NJIT,81,72,0,9,2016-01-27
Georgia Tech,NC State,90,83,0,7,2016-01-27
Baylor,Oklahoma State,69,65,0,4,2016-01-27
Fordham,Rhode Island,63,79,1,-16,2016-01-27
UMass,St. Joseph's,70,78,1,-8,2016-01-27
St. John's (NY),Seton Hall,60,79,1,-19,2016-01-27
Kennesaw State,USC Upstate,78,75,0,3,2016-01-27
South Florida,Tulane,73,60,0,13,2016-01-27
California,Utah,64,73,1,-9,2016-01-27
Louisville,Virginia Tech,91,83,0,8,2016-01-27
Loyola (IL),Wichita State,54,80,1,-26,2016-01-27
Charleston Southern,Winthrop,72,97,1,-25,2016-01-27
Oregon,Arizona,83,75,0,8,2016-01-28
Oregon State,Arizona State,68,86,1,-18,2016-01-28
Georgia Southern,Little Rock,67,80,1,-13,2016-01-28
Georgia State,Arkansas State,69,75,1,-6,2016-01-28
Loyola Marymount,BYU,62,87,1,-25,2016-01-28
UC-Riverside,Cal Poly,72,68,0,4,2016-01-28
Bryant,Central Connecticut,67,78,1,-11,2016-01-28
UNC Greensboro,Citadel,102,95,0,7,2016-01-28
Northeastern,College of Charleston,61,68,1,-7,2016-01-28
Cincinnati,UConn,58,57,0,1,2016-01-28
William & Mary,Delaware,94,79,0,15,2016-01-28
South Dakota,Denver,52,66,1,-14,2016-01-28
Towson,Drexel,77,70,0,7,2016-01-28
UT-Martin,Eastern Illinois,74,82,1,-8,2016-01-28
Portland State,Eastern Washington,83,112,1,-29,2016-01-28
Saint Francis (PA),Fairleigh Dickinson,82,86,1,-4,2016-01-28
Old Dominion,Florida Atlantic,78,66,0,12,2016-01-28
Charlotte,Florida International,72,69,0,3,2016-01-28
Western Carolina,Furman,60,62,1,-2,2016-01-28
Richmond,George Washington,98,90,0,8,2016-01-28
Santa Clara,Gonzaga,67,84,1,-17,2016-01-28
Cal State Bakersfield,Grand Canyon,64,70,1,-6,2016-01-28
Elon,Hofstra,64,66,1,-2,2016-01-28
Sacramento State,Idaho,65,63,0,2,2016-01-28
Southern Utah,Idaho State,68,87,1,-19,2016-01-28
Ohio State,Illinois,68,63,0,5,2016-01-28
Youngstown State,UIC,82,78,0,4,2016-01-28
Belmont,Jacksonville State,72,63,0,9,2016-01-28
UNC Wilmington,James Madison,78,73,0,5,2016-01-28
UCSB,Long Beach State,70,80,1,-10,2016-01-28
Texas State,Louisiana,54,80,1,-26,2016-01-28
Texas-Arlington,Louisiana-Monroe,88,99,1,-11,2016-01-28
UTSA,Louisiana Tech,75,85,1,-10,2016-01-28
Niagara,Marist,69,66,0,3,2016-01-28
Middle Tennessee,Marshall,66,82,1,-16,2016-01-28
Iowa,Maryland,68,74,1,-6,2016-01-28
VMI,Mercer,58,73,1,-15,2016-01-28
Robert Morris,Mount St. Mary's,49,70,1,-21,2016-01-28
Michigan State,Northwestern,76,45,0,31,2016-01-28
Purdue-Fort Wayne,Oral Roberts,68,63,0,5,2016-01-28
San Francisco,Portland,87,76,0,11,2016-01-28
Monmouth,Quinnipiac,66,51,0,15,2016-01-28
Rider,St. Peter's,76,45,0,31,2016-01-28
Pepperdine,San Diego,75,65,0,10,2016-01-28
Omaha,South Dakota State,76,87,1,-11,2016-01-28
Washington State,USC,71,81,1,-10,2016-01-28
Evansville,Southern Illinois,85,78,0,7,2016-01-28
Southeast Missouri State,SIU-Edwardsville,58,51,0,7,2016-01-28
UTEP,Southern Miss,58,71,1,-13,2016-01-28
Notre Dame,Syracuse,66,81,1,-15,2016-01-28
Tennessee State,Tennessee Tech,79,81,1,-2,2016-01-28
Appalachian State,Troy,75,71,0,4,2016-01-28
Washington,UCLA,86,84,0,2,2016-01-28
Seattle,Utah Valley,73,62,0,11,2016-01-28
Cleveland State,Valparaiso,52,77,1,-25,2016-01-28
St. Francis (NY),Wagner,61,64,1,-3,2016-01-28
Northern Arizona,Weber State,66,76,1,-10,2016-01-28
Alabama-Birmingham,Western Kentucky,62,69,1,-7,2016-01-28
ETSU,Wofford,73,87,1,-14,2016-01-28
Princeton,Brown,83,59,0,24,2016-01-29
Columbia,Dartmouth,77,60,0,17,2016-01-29
VCU,Davidson,79,69,0,10,2016-01-29
Northern Kentucky,Detroit,91,83,0,8,2016-01-29
Canisius,Fairfield,77,84,1,-7,2016-01-29
Cornell,Harvard,77,65,0,12,2016-01-29
Manhattan,Iona,56,70,1,-14,2016-01-29
Western Illinois,IUPUI,67,69,1,-2,2016-01-29
Green Bay,Milwaukee,94,95,1,-1,2016-01-29
Wright State,Oakland,63,89,1,-26,2016-01-29
Kent State,Ohio,61,72,1,-11,2016-01-29
Penn,Yale,58,81,1,-23,2016-01-29
Lamar,Abilene Christian,71,80,1,-9,2016-01-30
Prairie View,Alabama A&M,69,83,1,-14,2016-01-30
Texas Southern,Alabama State,75,72,0,3,2016-01-30
Oregon State,Arizona,63,80,1,-17,2016-01-30
Texas Tech,Arkansas,68,75,1,-7,2016-01-30
Georgia State,Little Rock,53,63,1,-10,2016-01-30
Grambling,Arkansas-Pine Bluff,59,63,1,-4,2016-01-30
Georgia Southern,Arkansas State,71,66,0,5,2016-01-30
Oklahoma State,Auburn,74,63,0,11,2016-01-30
Akron,Ball State,73,64,0,9,2016-01-30
Georgia,Baylor,73,83,1,-10,2016-01-30
Florida A&M,Bethune-Cookman,56,88,1,-32,2016-01-30
New Mexico,Boise State,88,83,0,5,2016-01-30
Pepperdine,BYU,77,88,1,-11,2016-01-30
Penn,Brown,83,89,1,-6,2016-01-30
Army,Bucknell,66,94,1,-28,2016-01-30
UC-Riverside,Cal State Fullerton,81,71,0,10,2016-01-30
Cal Poly,UC-Davis,52,66,1,-14,2016-01-30
UCSB,UC-Irvine,76,60,0,16,2016-01-30
St. Francis (NY),Central Connecticut,60,49,0,11,2016-01-30
Bowling Green State,Central Michigan,65,77,1,-12,2016-01-30
Gardner-Webb,Charleston Southern,68,59,0,9,2016-01-30
VMI,Citadel,75,78,1,-3,2016-01-30
Campbell,Coastal Carolina,68,97,1,-29,2016-01-30
American,Colgate,54,49,0,5,2016-01-30
Maryland-Eastern Shore,Coppin State,83,81,0,2,2016-01-30
Seton Hall,Creighton,75,65,0,10,2016-01-30
Cornell,Dartmouth,77,73,0,4,2016-01-30
La Salle,Dayton,44,59,1,-15,2016-01-30
South Carolina State,Delaware State,56,41,0,15,2016-01-30
South Dakota State,Denver,67,56,0,11,2016-01-30
Xavier,DePaul,86,65,0,21,2016-01-30
Bradley,Drake,70,80,1,-10,2016-01-30
Hofstra,Drexel,70,64,0,6,2016-01-30
Houston,East Carolina,97,93,0,4,2016-01-30
Morehead State,Eastern Kentucky,70,67,0,3,2016-01-30
Sacramento State,Eastern Washington,67,74,1,-7,2016-01-30
West Virginia,Florida,71,88,1,-17,2016-01-30
Charlotte,Florida Atlantic,77,82,1,-5,2016-01-30
Old Dominion,Florida International,64,60,0,4,2016-01-30
Clemson,Florida State,65,76,1,-11,2016-01-30
ETSU,Furman,70,74,1,-4,2016-01-30
Providence,Georgetown,73,69,0,4,2016-01-30
San Francisco,Gonzaga,48,86,1,-38,2016-01-30
Seattle,Grand Canyon,59,57,0,2,2016-01-30
Norfolk State,Hampton,76,86,1,-10,2016-01-30
Albany (NY),Hartford,86,60,0,26,2016-01-30
Columbia,Harvard,55,54,0,1,2016-01-30
Long Beach State,Hawaii,78,64,0,14,2016-01-30
Navy,Holy Cross,80,87,1,-7,2016-01-30
Sam Houston State,Houston Baptist,69,70,1,-1,2016-01-30
Portland State,Idaho,55,56,1,-1,2016-01-30
Northern Arizona,Idaho State,66,88,1,-22,2016-01-30
Cleveland State,UIC,70,72,1,-2,2016-01-30
Nicholls State,Incarnate Word,61,68,1,-7,2016-01-30
Minnesota,Indiana,68,74,1,-6,2016-01-30
Stetson,Jacksonville,60,75,1,-15,2016-01-30
Tennessee State,Jacksonville State,78,53,0,25,2016-01-30
Kentucky,Kansas,84,90,1,-6,2016-01-30
Ole Miss,Kansas State,64,69,1,-5,2016-01-30
NJIT,Kennesaw State,75,67,0,8,2016-01-30
USC Upstate,Lipscomb,92,91,0,1,2016-01-30
Fairleigh Dickinson,LIU-Brooklyn,88,85,0,3,2016-01-30
Texas-Arlington,Louisiana,75,90,1,-15,2016-01-30
Texas State,Louisiana-Monroe,59,72,1,-13,2016-01-30
Oklahoma,LSU,77,75,0,2,2016-01-30
Virginia,Louisville,63,47,0,16,2016-01-30
Indiana State,Loyola (IL),96,104,1,-8,2016-01-30
Lafayette,Loyola (MD),77,84,1,-7,2016-01-30
Binghamton,Maine,63,74,1,-11,2016-01-30
Butler,Marquette,69,75,1,-6,2016-01-30
Alabama-Birmingham,Marshall,81,78,0,3,2016-01-30
New Hampshire,UMBC,84,81,0,3,2016-01-30
Fordham,UMass,78,72,0,6,2016-01-30
UNC Greensboro,Mercer,67,81,1,-14,2016-01-30
Northern Illinois,Miami (OH),59,72,1,-13,2016-01-30
Jackson State,Mississippi Valley State,77,62,0,15,2016-01-30
Mississippi State,Missouri,76,62,0,14,2016-01-30
Chicago State,UMKC,64,78,1,-14,2016-01-30
Illinois State,Missouri State,81,84,1,-3,2016-01-30
St. Peter's,Monmouth,57,73,1,-16,2016-01-30
Montana,Montana State,80,72,0,8,2016-01-30
Howard,Morgan State,63,83,1,-20,2016-01-30
Wagner,Mount St. Mary's,73,63,0,10,2016-01-30
South Dakota,Omaha,83,96,1,-13,2016-01-30
San Diego State,UNLV,67,52,0,15,2016-01-30
Texas-Rio Grande Valley,New Mexico State,68,92,1,-24,2016-01-30
McNeese State,New Orleans,64,76,1,-12,2016-01-30
Boston College,UNC,62,89,1,-27,2016-01-30
Longwood,UNC Asheville,74,88,1,-14,2016-01-30
Savannah State,North Carolina A&T,62,63,1,-1,2016-01-30
Miami (FL),NC State,69,85,1,-16,2016-01-30
College of Charleston,UNC Wilmington,55,65,1,-10,2016-01-30
Florida Gulf Coast,North Florida,76,82,1,-6,2016-01-30
Elon,Northeastern,71,67,0,4,2016-01-30
North Dakota,Northern Colorado,70,71,1,-1,2016-01-30
Southeastern Louisiana,Northwestern State,76,91,1,-15,2016-01-30
Saint Mary's,Pacific,68,65,0,3,2016-01-30
Michigan,Penn State,79,72,0,7,2016-01-30
Santa Clara,Portland,90,84,0,6,2016-01-30
Liberty,Presbyterian,65,61,0,4,2016-01-30
Nebraska,Purdue,74,89,1,-15,2016-01-30
Niagara,Quinnipiac,68,82,1,-14,2016-01-30
St. Joseph's,Rhode Island,64,55,0,9,2016-01-30
North Texas,Rice,87,95,1,-8,2016-01-30
Bryant,Sacred Heart,71,72,1,-1,2016-01-30
Robert Morris,Saint Francis (PA),78,90,1,-12,2016-01-30
Duquesne,Saint Louis,78,67,0,11,2016-01-30
Chattanooga,Samford,63,56,0,7,2016-01-30
Loyola Marymount,San Diego,69,77,1,-8,2016-01-30
Air Force,San Jose State,54,75,1,-21,2016-01-30
Marist,Siena,66,77,1,-11,2016-01-30
Appalachian State,South Alabama,60,73,1,-13,2016-01-30
Alabama,South Carolina,64,78,1,-14,2016-01-30
Austin Peay,Southeast Missouri State,86,80,0,6,2016-01-30
Alcorn State,Southern,64,75,1,-11,2016-01-30
Washington,USC,88,98,1,-10,2016-01-30
Eastern Illinois,SIU-Edwardsville,60,46,0,14,2016-01-30
Memphis,SMU,68,80,1,-12,2016-01-30
UTSA,Southern Miss,70,86,1,-16,2016-01-30
Georgia Tech,Syracuse,57,60,1,-3,2016-01-30
Murray State,UT-Martin,59,63,1,-4,2016-01-30
Belmont,Tennessee Tech,79,89,1,-10,2016-01-30
Vanderbilt,Texas,58,72,1,-14,2016-01-30
Iowa State,Texas A&M,62,72,1,-10,2016-01-30
Stephen F. Austin,Texas A&M-Corpus Christi,66,61,0,5,2016-01-30
Tennessee,TCU,63,75,1,-12,2016-01-30
Buffalo,Toledo,73,68,0,5,2016-01-30
Delaware,Towson,97,101,1,-4,2016-01-30
Tulane,Tulsa,48,62,1,-14,2016-01-30
Washington State,UCLA,50,83,1,-33,2016-01-30
Stanford,Utah,74,96,1,-22,2016-01-30
Nevada,Utah State,89,84,0,5,2016-01-30
Cal State Bakersfield,Utah Valley,78,74,0,4,2016-01-30
Youngstown State,Valparaiso,68,97,1,-29,2016-01-30
Stony Brook,Vermont,72,61,0,11,2016-01-30
Southern Utah,Weber State,50,77,1,-27,2016-01-30
Middle Tennessee,Western Kentucky,66,64,0,2,2016-01-30
Eastern Michigan,Western Michigan,86,94,1,-8,2016-01-30
Radford,Winthrop,77,87,1,-10,2016-01-30
Western Carolina,Wofford,66,85,1,-19,2016-01-30
Colorado State,Wyoming,76,83,1,-7,2016-01-30
Princeton,Yale,75,79,1,-4,2016-01-30
Oregon,Arizona State,91,74,0,17,2016-01-31
Lehigh,Boston University,73,75,1,-2,2016-01-31
UConn,UCF,67,41,0,26,2016-01-31
California,Colorado,62,70,1,-8,2016-01-31
Wright State,Detroit,68,75,1,-7,2016-01-31
Wichita State,Evansville,78,65,0,13,2016-01-31
George Washington,George Mason,76,70,0,6,2016-01-31
Wisconsin,Illinois,63,55,0,8,2016-01-31
Northwestern,Iowa,71,85,1,-14,2016-01-31
Western Illinois,Purdue-Fort Wayne,67,88,1,-21,2016-01-31
North Dakota State,IUPUI,72,73,1,-1,2016-01-31
UTEP,Louisiana Tech,70,78,1,-8,2016-01-31
Rutgers,Michigan State,62,96,1,-34,2016-01-31
Southern Illinois,Northern Iowa,58,67,1,-9,2016-01-31
Wake Forest,Notre Dame,62,85,1,-23,2016-01-31
Maryland,Ohio State,66,61,0,5,2016-01-31
Virginia Tech,Pitt,71,90,1,-19,2016-01-31
Canisius,Rider,68,79,1,-11,2016-01-31
Temple,South Florida,70,63,0,7,2016-01-31
Richmond,St. Bonaventure,68,84,1,-16,2016-01-31
Villanova,St. John's (NY),68,53,0,15,2016-01-31
James Madison,William & Mary,62,68,1,-6,2016-01-31
Texas Southern,Alabama A&M,71,66,0,5,2016-02-01
Prairie View,Alabama State,77,83,1,-6,2016-02-01
Holy Cross,American,45,58,1,-13,2016-02-01
Jackson State,Arkansas-Pine Bluff,66,53,0,13,2016-02-01
Navy,Army,64,50,0,14,2016-02-01
Texas,Baylor,67,59,0,8,2016-02-01
Citadel,Chattanooga,85,125,1,-40,2016-02-01
Cheyney,Delaware State,70,86,1,-16,2016-02-01
St. Ambrose,Eastern Illinois,59,101,1,-42,2016-02-01
Quinnipiac,Fairfield,64,59,0,5,2016-02-01
North Carolina Central,Florida A&M,81,63,0,18,2016-02-01
NC State,Florida State,73,77,1,-4,2016-02-01
SMU,Houston,68,71,1,-3,2016-02-01
Florida Gulf Coast,Jacksonville,80,83,1,-3,2016-02-01
USC Upstate,Kennesaw State,62,75,1,-13,2016-02-01
Sam Houston State,Lamar,69,66,0,3,2016-02-01
NJIT,Lipscomb,90,78,0,12,2016-02-01
UNC,Louisville,65,71,1,-6,2016-02-01
Colgate,Loyola (MD),65,68,1,-3,2016-02-01
Howard,Maryland-Eastern Shore,67,85,1,-18,2016-02-01
Grambling,Mississippi Valley State,59,72,1,-13,2016-02-01
Coppin State,Morgan State,43,83,1,-40,2016-02-01
Nicholls State,New Orleans,53,74,1,-21,2016-02-01
Stetson,North Florida,86,82,0,4,2016-02-01
Oakland,Northern Kentucky,85,74,0,11,2016-02-01
Iona,St. Peter's,75,67,0,8,2016-02-01
Mercer,Samford,85,70,0,15,2016-02-01
Monmouth,Siena,93,87,0,6,2016-02-01
McNeese State,Southeastern Louisiana,80,82,1,-2,2016-02-01
Houston Baptist,Abilene Christian,72,79,1,-7,2016-02-02
Wyoming,Air Force,62,70,1,-8,2016-02-02
LSU,Auburn,80,68,0,12,2016-02-02
Savannah State,Bethune-Cookman,59,62,1,-3,2016-02-02
Utah State,Boise State,67,70,1,-3,2016-02-02
Ball State,Bowling Green State,72,64,0,8,2016-02-02
Georgetown,Butler,76,87,1,-11,2016-02-02
Kent State,Central Michigan,61,88,1,-27,2016-02-02
Providence,DePaul,70,77,1,-7,2016-02-02
Miami (OH),Eastern Michigan,69,94,1,-25,2016-02-02
South Carolina,Georgia,56,69,1,-13,2016-02-02
Duke,Georgia Tech,80,71,0,9,2016-02-02
Washington Adventist,Hampton,67,69,1,-2,2016-02-02
Texas A&M-Corpus Christi,Incarnate Word,65,70,1,-5,2016-02-02
Drake,Indiana State,56,63,1,-7,2016-02-02
West Virginia,Iowa State,81,76,0,5,2016-02-02
Winthrop,Liberty,77,88,1,-11,2016-02-02
Louisiana-Monroe,Louisiana,65,72,1,-7,2016-02-02
Rider,Manhattan,57,65,1,-8,2016-02-02
Rhode Island,UMass,56,61,1,-5,2016-02-02
Indiana,Michigan,80,67,0,13,2016-02-02
Alabama,Mississippi State,82,80,0,2,2016-02-02
Bradley,Missouri State,71,77,1,-6,2016-02-02
UNLV,New Mexico,83,87,1,-4,2016-02-02
Buffalo,Northern Illinois,90,78,0,12,2016-02-02
Central Arkansas,Northwestern State,75,91,1,-16,2016-02-02
Akron,Ohio,80,68,0,12,2016-02-02
TCU,Oklahoma,72,95,1,-23,2016-02-02
Colorado State,San Diego State,67,69,1,-2,2016-02-02
Menlo,San Francisco,68,100,1,-32,2016-02-02
Virginia Tech,Syracuse,60,68,1,-8,2016-02-02
Kentucky,Tennessee,77,84,1,-7,2016-02-02
Western Michigan,Toledo,62,89,1,-27,2016-02-02
Clemson,Wake Forest,76,62,0,14,2016-02-02
Bucknell,American,55,69,1,-14,2016-02-03
UC-Irvine,Cal Poly,78,72,0,6,2016-02-03
Cal State Northridge,UC-Riverside,73,71,0,2,2016-02-03
Arkansas,Florida,83,87,1,-4,2016-02-03
Davidson,George Washington,69,79,1,-10,2016-02-03
UMass-Lowell,Hartford,85,83,0,2,2016-02-03
Gardner-Webb,High Point,79,74,0,5,2016-02-03
Penn State,Iowa,49,73,1,-24,2016-02-03
Kansas State,Kansas,59,77,1,-18,2016-02-03
VCU,La Salle,88,70,0,18,2016-02-03
Army,Lafayette,84,81,0,3,2016-02-03
Loyola (MD),Lehigh,66,71,1,-5,2016-02-03
Campbell,Longwood,79,80,1,-1,2016-02-03
Illinois State,Loyola (IL),78,70,0,8,2016-02-03
Albany (NY),UMBC,79,73,0,6,2016-02-03
Notre Dame,Miami (FL),70,79,1,-9,2016-02-03
Ole Miss,Missouri,76,73,0,3,2016-02-03
Boston University,Navy,83,72,0,11,2016-02-03
Maryland,Nebraska,70,65,0,5,2016-02-03
Charleston Southern,UNC Asheville,55,63,1,-8,2016-02-03
Charlotte,North Carolina A&T,92,72,0,20,2016-02-03
Evansville,Northern Iowa,54,57,1,-3,2016-02-03
Coastal Carolina,Presbyterian,69,66,0,3,2016-02-03
George Mason,Richmond,78,74,0,4,2016-02-03
Illinois,Rutgers,110,101,0,9,2016-02-03
St. Bonaventure,St. Joseph's,83,73,0,10,2016-02-03
Fresno State,San Jose State,53,65,1,-12,2016-02-03
Marquette,Seton Hall,62,79,1,-17,2016-02-03
Binghamton,Stony Brook,51,76,1,-25,2016-02-03
Oklahoma State,Texas Tech,61,63,1,-2,2016-02-03
Maine,Vermont,68,85,1,-17,2016-02-03
Creighton,Villanova,58,83,1,-25,2016-02-03
Boston College,Virginia,47,61,1,-14,2016-02-03
Arizona State,Washington,83,95,1,-12,2016-02-03
Arizona,Washington State,79,64,0,15,2016-02-03
Omaha,Western Illinois,76,83,1,-7,2016-02-03
Southern Illinois,Wichita State,55,76,1,-21,2016-02-03
St. John's (NY),Xavier,83,90,1,-7,2016-02-03
Florida International,Alabama-Birmingham,69,74,1,-5,2016-02-04
Louisiana,Appalachian State,87,76,0,11,2016-02-04
Troy,Little Rock,49,72,1,-23,2016-02-04
South Alabama,Arkansas State,73,79,1,-6,2016-02-04
Morehead State,Belmont,67,73,1,-6,2016-02-04
Saint Mary's,BYU,59,70,1,-11,2016-02-04
UMKC,Cal State Bakersfield,66,77,1,-11,2016-02-04
UC-Davis,Cal State Fullerton,57,61,1,-4,2016-02-04
Hawaii,UCSB,76,64,0,12,2016-02-04
Wofford,Chattanooga,63,79,1,-16,2016-02-04
South Florida,Cincinnati,57,88,1,-31,2016-02-04
Detroit,Cleveland State,71,63,0,8,2016-02-04
Towson,College of Charleston,47,65,1,-18,2016-02-04
IUPUI,Denver,51,53,1,-2,2016-02-04
James Madison,Drexel,78,56,0,22,2016-02-04
Delaware,Elon,56,83,1,-27,2016-02-04
Texas-Arlington,Georgia Southern,73,82,1,-9,2016-02-04
Texas State,Georgia State,56,59,1,-3,2016-02-04
UNC Wilmington,Hofstra,70,67,0,3,2016-02-04
Mount St. Mary's,LIU-Brooklyn,74,77,1,-3,2016-02-04
Gonzaga,Loyola Marymount,92,63,0,29,2016-02-04
UConn,Memphis,77,57,0,20,2016-02-04
Florida Atlantic,Middle Tennessee,73,85,1,-12,2016-02-04
Grand Canyon,New Mexico State,50,70,1,-20,2016-02-04
Western Carolina,UNC Greensboro,58,75,1,-17,2016-02-04
Idaho State,North Dakota,60,76,1,-16,2016-02-04
Oral Roberts,North Dakota State,63,67,1,-4,2016-02-04
Southern Miss,North Texas,54,70,1,-16,2016-02-04
William & Mary,Northeastern,86,77,0,9,2016-02-04
Eastern Washington,Northern Arizona,84,73,0,11,2016-02-04
Weber State,Northern Colorado,64,54,0,10,2016-02-04
Green Bay,Northern Kentucky,85,78,0,7,2016-02-04
Minnesota,Northwestern,58,82,1,-24,2016-02-04
Colorado,Oregon,56,76,1,-20,2016-02-04
Utah,Oregon State,69,71,1,-2,2016-02-04
Portland,Pepperdine,73,70,0,3,2016-02-04
Montana State,Portland State,68,83,1,-15,2016-02-04
Marist,Quinnipiac,53,79,1,-26,2016-02-04
Louisiana Tech,Rice,90,78,0,12,2016-02-04
Central Connecticut,Robert Morris,65,60,0,5,2016-02-04
Montana,Sacramento State,79,83,1,-4,2016-02-04
St. Francis (NY),Sacred Heart,70,74,1,-4,2016-02-04
Bryant,Saint Francis (PA),57,63,1,-6,2016-02-04
Furman,Samford,67,65,0,2,2016-02-04
Pacific,San Diego,43,54,1,-11,2016-02-04
Chicago State,Seattle,56,59,1,-3,2016-02-04
Purdue-Fort Wayne,South Dakota,95,82,0,13,2016-02-04
Murray State,Southeast Missouri State,78,72,0,6,2016-02-04
UCLA,USC,61,80,1,-19,2016-02-04
Idaho,Southern Utah,68,44,0,24,2016-02-04
Tulsa,Temple,79,83,1,-4,2016-02-04
Austin Peay,UT-Martin,77,86,1,-9,2016-02-04
Eastern Kentucky,Tennessee State,97,81,0,16,2016-02-04
Marshall,UTEP,108,112,1,-4,2016-02-04
Utah Valley,Texas-Rio Grande Valley,88,77,0,11,2016-02-04
Western Kentucky,UTSA,83,71,0,12,2016-02-04
UCF,Tulane,70,62,0,8,2016-02-04
Texas A&M,Vanderbilt,60,77,1,-17,2016-02-04
ETSU,VMI,71,60,0,11,2016-02-04
Fairleigh Dickinson,Wagner,82,79,0,3,2016-02-04
Ohio State,Wisconsin,68,79,1,-11,2016-02-04
Milwaukee,Wright State,83,84,1,-1,2016-02-04
Oakland,Youngstown State,107,85,0,22,2016-02-04
Central Michigan,Akron,87,92,1,-5,2016-02-05
Cornell,Brown,80,86,1,-6,2016-02-05
Iona,Canisius,84,66,0,18,2016-02-05
Fairfield,Monmouth,67,91,1,-24,2016-02-05
Rider,Niagara,66,60,0,6,2016-02-05
Dartmouth,Penn,64,71,1,-7,2016-02-05
Harvard,Princeton,62,83,1,-21,2016-02-05
St. Peter's,Siena,52,69,1,-17,2016-02-05
Columbia,Yale,72,86,1,-14,2016-02-05
Boise State,Air Force,53,61,1,-8,2016-02-06
Missouri,Alabama,71,80,1,-9,2016-02-06
Florida Atlantic,Alabama-Birmingham,67,104,1,-37,2016-02-06
Vermont,Albany (NY),71,75,1,-4,2016-02-06
Louisiana-Monroe,Appalachian State,91,90,0,1,2016-02-06
Tennessee,Arkansas,67,85,1,-18,2016-02-06
South Alabama,Little Rock,43,74,1,-31,2016-02-06
Alabama A&M,Arkansas-Pine Bluff,71,66,0,5,2016-02-06
Troy,Arkansas State,71,70,0,1,2016-02-06
Loyola (MD),Army,100,99,0,1,2016-02-06
Western Michigan,Ball State,71,75,1,-4,2016-02-06
Eastern Kentucky,Belmont,88,78,0,10,2016-02-06
Delaware State,Bethune-Cookman,56,85,1,-29,2016-02-06
New Hampshire,Binghamton,59,55,0,4,2016-02-06
Indiana State,Bradley,58,63,1,-5,2016-02-06
Pacific,BYU,77,72,0,5,2016-02-06
Columbia,Brown,77,73,0,4,2016-02-06
Eastern Michigan,Buffalo,70,80,1,-10,2016-02-06
Hawaii,Cal Poly,75,60,0,15,2016-02-06
Chicago State,Cal State Bakersfield,48,71,1,-23,2016-02-06
Stanford,California,61,76,1,-15,2016-02-06
UC-Davis,UC-Riverside,50,49,0,1,2016-02-06
Cal State Fullerton,UCSB,68,81,1,-13,2016-02-06
UNC Asheville,Campbell,81,71,0,10,2016-02-06
New Orleans,Central Arkansas,77,112,1,-35,2016-02-06
Temple,UCF,62,60,0,2,2016-02-06
Longwood,Charleston Southern,78,76,0,2,2016-02-06
Old Dominion,Charlotte,74,69,0,5,2016-02-06
Furman,Chattanooga,54,62,1,-8,2016-02-06
Oakland,Cleveland State,67,57,0,10,2016-02-06
Drexel,College of Charleston,38,60,1,-22,2016-02-06
Nevada,Colorado State,67,76,1,-9,2016-02-06
DePaul,Creighton,66,88,1,-22,2016-02-06
Northern Iowa,Drake,82,66,0,16,2016-02-06
NC State,Duke,80,88,1,-8,2016-02-06
Davidson,Duquesne,93,82,0,11,2016-02-06
Southeast Missouri State,Eastern Illinois,69,78,1,-9,2016-02-06
Towson,Elon,81,77,0,4,2016-02-06
Missouri State,Evansville,64,83,1,-19,2016-02-06
North Florida,Florida Gulf Coast,65,81,1,-16,2016-02-06
St. Joseph's,Fordham,82,60,0,22,2016-02-06
UNLV,Fresno State,104,111,1,-7,2016-02-06
Presbyterian,Gardner-Webb,66,69,1,-3,2016-02-06
Dayton,George Mason,98,64,0,34,2016-02-06
Auburn,Georgia,55,65,1,-10,2016-02-06
Texas State,Georgia Southern,62,66,1,-4,2016-02-06
Texas-Arlington,Georgia State,90,69,0,21,2016-02-06
Southern,Grambling,79,66,0,13,2016-02-06
Liberty,High Point,80,76,0,4,2016-02-06
Bucknell,Holy Cross,77,52,0,25,2016-02-06
Stephen F. Austin,Houston Baptist,72,66,0,6,2016-02-06
Norfolk State,Howard,99,92,0,7,2016-02-06
Valparaiso,UIC,73,55,0,18,2016-02-06
Wichita State,Illinois State,53,58,1,-5,2016-02-06
Alcorn State,Jackson State,72,64,0,8,2016-02-06
Tennessee Tech,Jacksonville State,68,58,0,10,2016-02-06
Oklahoma,Kansas State,69,80,1,-11,2016-02-06
Toledo,Kent State,82,67,0,15,2016-02-06
Florida,Kentucky,61,80,1,-19,2016-02-06
Rhode Island,La Salle,79,62,0,17,2016-02-06
Boston University,Lafayette,89,82,0,7,2016-02-06
Incarnate Word,Lamar,74,71,0,3,2016-02-06
American,Lehigh,49,72,1,-23,2016-02-06
Cal State Northridge,Long Beach State,76,81,1,-5,2016-02-06
Mississippi State,LSU,77,88,1,-11,2016-02-06
Boston College,Louisville,47,79,1,-32,2016-02-06
Portland,Loyola Marymount,92,78,0,14,2016-02-06
UMBC,Maine,83,79,0,4,2016-02-06
Purdue,Maryland,61,72,1,-11,2016-02-06
Hampton,Maryland-Eastern Shore,70,73,1,-3,2016-02-06
Stony Brook,UMass-Lowell,91,73,0,18,2016-02-06
Cincinnati,Memphis,59,63,1,-4,2016-02-06
Citadel,Mercer,72,88,1,-16,2016-02-06
Bowling Green State,Miami (OH),51,55,1,-4,2016-02-06
Michigan State,Michigan,89,73,0,16,2016-02-06
Florida International,Middle Tennessee,66,67,1,-1,2016-02-06
Vanderbilt,Ole Miss,78,85,1,-7,2016-02-06
Alabama State,Mississippi Valley State,73,62,0,11,2016-02-06
Austin Peay,Murray State,76,73,0,3,2016-02-06
Colgate,Navy,58,55,0,3,2016-02-06
Rutgers,Nebraska,63,87,1,-24,2016-02-06
Denver,Omaha,75,72,0,3,2016-02-06
Utah Valley,New Mexico State,74,98,1,-24,2016-02-06
McNeese State,Nicholls State,56,71,1,-15,2016-02-06
Kennesaw State,NJIT,59,78,1,-19,2016-02-06
North Carolina A&T,North Carolina Central,67,63,0,4,2016-02-06
ETSU,UNC Greensboro,68,65,0,3,2016-02-06
Weber State,North Dakota,71,78,1,-7,2016-02-06
Purdue-Fort Wayne,North Dakota State,46,62,1,-16,2016-02-06
Louisiana Tech,North Texas,69,80,1,-11,2016-02-06
UNC Wilmington,Northeastern,90,73,0,17,2016-02-06
Idaho,Northern Arizona,70,72,1,-2,2016-02-06
Idaho State,Northern Colorado,90,57,0,33,2016-02-06
Milwaukee,Northern Kentucky,71,75,1,-4,2016-02-06
UNC,Notre Dame,76,80,1,-4,2016-02-06
Northern Illinois,Ohio,69,80,1,-11,2016-02-06
Iowa State,Oklahoma State,64,59,0,5,2016-02-06
Colorado,Oregon State,56,60,1,-4,2016-02-06
Indiana,Penn State,63,68,1,-5,2016-02-06
Harvard,Penn,57,67,1,-10,2016-02-06
Gonzaga,Pepperdine,69,66,0,3,2016-02-06
Virginia,Pitt,64,50,0,14,2016-02-06
Montana,Portland State,82,80,0,2,2016-02-06
Texas Southern,Prairie View,55,59,1,-4,2016-02-06
Dartmouth,Princeton,70,83,1,-13,2016-02-06
Villanova,Providence,72,60,0,12,2016-02-06
Coastal Carolina,Radford,72,60,0,12,2016-02-06
Southern Miss,Rice,65,72,1,-7,2016-02-06
UMass,Richmond,53,69,1,-16,2016-02-06
Bryant,Robert Morris,71,89,1,-18,2016-02-06
Montana State,Sacramento State,79,76,0,3,2016-02-06
LIU-Brooklyn,Sacred Heart,90,98,1,-8,2016-02-06
Central Connecticut,Saint Francis (PA),82,91,1,-9,2016-02-06
Wofford,Samford,78,75,0,3,2016-02-06
Saint Mary's,San Diego,60,43,0,17,2016-02-06
New Mexico,San Diego State,71,78,1,-7,2016-02-06
Santa Clara,San Francisco,86,89,1,-3,2016-02-06
Morgan State,Savannah State,49,57,1,-8,2016-02-06
UMKC,Seattle,55,65,1,-10,2016-02-06
Georgetown,Seton Hall,61,69,1,-8,2016-02-06
Coppin State,South Carolina State,83,88,1,-5,2016-02-06
Lipscomb,USC Upstate,78,65,0,13,2016-02-06
Oral Roberts,South Dakota,79,91,1,-12,2016-02-06
IUPUI,South Dakota State,58,80,1,-22,2016-02-06
Abilene Christian,Southeastern Louisiana,60,81,1,-21,2016-02-06
Loyola (IL),Southern Illinois,73,59,0,14,2016-02-06
UT-Martin,SIU-Edwardsville,79,62,0,17,2016-02-06
Eastern Washington,Southern Utah,81,67,0,14,2016-02-06
Fairleigh Dickinson,St. Francis (NY),71,85,1,-14,2016-02-06
Butler,St. John's (NY),89,56,0,33,2016-02-06
Jacksonville,Stetson,96,88,0,8,2016-02-06
Morehead State,Tennessee State,76,77,1,-1,2016-02-06
Texas Tech,Texas,59,69,1,-10,2016-02-06
South Carolina,Texas A&M,81,78,0,3,2016-02-06
Sam Houston State,Texas A&M-Corpus Christi,48,51,1,-3,2016-02-06
Kansas,TCU,75,56,0,19,2016-02-06
Western Kentucky,UTEP,89,93,1,-4,2016-02-06
Grand Canyon,Texas-Rio Grande Valley,64,58,0,6,2016-02-06
Marshall,UTSA,109,91,0,18,2016-02-06
George Washington,VCU,72,69,0,3,2016-02-06
Western Carolina,VMI,69,60,0,9,2016-02-06
Clemson,Virginia Tech,57,60,1,-3,2016-02-06
Mount St. Mary's,Wagner,51,72,1,-21,2016-02-06
Florida State,Wake Forest,91,71,0,20,2016-02-06
Arizona,Washington,77,72,0,5,2016-02-06
Arizona State,Washington State,67,55,0,12,2016-02-06
Baylor,West Virginia,69,80,1,-11,2016-02-06
Delaware,William & Mary,64,90,1,-26,2016-02-06
Green Bay,Wright State,60,79,1,-19,2016-02-06
Utah State,Wyoming,65,84,1,-19,2016-02-06
Marquette,Xavier,82,90,1,-8,2016-02-06
Cornell,Yale,52,83,1,-31,2016-02-06
Detroit,Youngstown State,94,92,0,2,2016-02-06
Rider,Canisius,61,67,1,-6,2016-02-07
East Carolina,UConn,67,85,1,-18,2016-02-07
Manhattan,Fairfield,70,80,1,-10,2016-02-07
Miami (FL),Georgia Tech,75,68,0,7,2016-02-07
Iowa,Illinois,77,65,0,12,2016-02-07
Hofstra,James Madison,95,98,1,-3,2016-02-07
Siena,Marist,73,79,1,-6,2016-02-07
Iona,Niagara,75,61,0,14,2016-02-07
Utah,Oregon,66,76,1,-10,2016-02-07
SMU,South Florida,92,58,0,34,2016-02-07
Saint Louis,St. Bonaventure,62,65,1,-3,2016-02-07
Houston,Tulsa,63,77,1,-14,2016-02-07
Alabama State,Arkansas-Pine Bluff,70,75,1,-5,2016-02-08
Colgate,Army,72,82,1,-10,2016-02-08
Albany (NY),Binghamton,69,56,0,13,2016-02-08
Samford,Citadel,95,86,0,9,2016-02-08
Notre Dame,Clemson,89,83,0,6,2016-02-08
Louisville,Duke,65,72,1,-7,2016-02-08
Delaware State,Florida A&M,95,96,1,-1,2016-02-08
UNC Greensboro,Furman,72,79,1,-7,2016-02-08
St. John's (NY),Georgetown,67,92,1,-25,2016-02-08
Alcorn State,Grambling,66,63,0,3,2016-02-08
Hampton,Howard,68,65,0,3,2016-02-08
Southern,Jackson State,80,81,1,-1,2016-02-08
Lehigh,Lafayette,87,72,0,15,2016-02-08
Abilene Christian,Lamar,71,67,0,4,2016-02-08
Norfolk State,Maryland-Eastern Shore,76,70,0,6,2016-02-08
Vermont,UMass-Lowell,93,100,1,-7,2016-02-08
Chattanooga,Mercer,72,66,0,6,2016-02-08
Alabama A&M,Mississippi Valley State,64,66,1,-2,2016-02-08
Maine,New Hampshire,75,88,1,-13,2016-02-08
Northern New Mexico,New Mexico State,54,85,1,-31,2016-02-08
Incarnate Word,Nicholls State,60,71,1,-11,2016-02-08
Texas,Oklahoma,60,63,1,-3,2016-02-08
Quinnipiac,St. Peter's,52,68,1,-16,2016-02-08
Coppin State,Savannah State,63,72,1,-9,2016-02-08
Morgan State,South Carolina State,78,82,1,-4,2016-02-08
Northwestern State,Stephen F. Austin,72,83,1,-11,2016-02-08
Hartford,Stony Brook,72,85,1,-13,2016-02-08
Houston Baptist,Texas A&M-Corpus Christi,76,83,1,-7,2016-02-08
Oklahoma State,TCU,56,63,1,-7,2016-02-08
VMI,Wofford,60,92,1,-32,2016-02-08
Ohio,Ball State,72,69,0,3,2016-02-09
UNC,Boston College,68,65,0,3,2016-02-09
Akron,Bowling Green State,83,68,0,15,2016-02-09
Toledo,Buffalo,71,69,0,2,2016-02-09
Southeastern Louisiana,Central Arkansas,72,88,1,-16,2016-02-09
Cincinnati,UCF,69,51,0,18,2016-02-09
Xavier,Creighton,56,70,1,-14,2016-02-09
Duquesne,Dayton,74,76,1,-2,2016-02-09
Villanova,DePaul,86,59,0,27,2016-02-09
Wichita State,Drake,74,48,0,26,2016-02-09
Central Michigan,Eastern Michigan,56,71,1,-15,2016-02-09
Ole Miss,Florida,72,77,1,-5,2016-02-09
Benedictine,Grand Canyon,71,95,1,-24,2016-02-09
West Virginia,Kansas,65,75,1,-10,2016-02-09
Northern Illinois,Kent State,74,75,1,-1,2016-02-09
Georgia,Kentucky,48,82,1,-34,2016-02-09
Monmouth,Marist,87,61,0,26,2016-02-09
Bowie State,Maryland,62,93,1,-31,2016-02-09
Pitt,Miami (FL),63,65,1,-2,2016-02-09
Arkansas,Mississippi State,46,78,1,-32,2016-02-09
Northwestern,Ohio State,63,71,1,-8,2016-02-09
Michigan State,Purdue,81,82,1,-1,2016-02-09
George Mason,Rhode Island,63,81,1,-18,2016-02-09
Auburn,Tennessee,45,71,1,-26,2016-02-09
Texas-Arlington,Texas State,65,53,0,12,2016-02-09
New Mexico,Utah State,72,80,1,-8,2016-02-09
Virginia Tech,Virginia,49,67,1,-18,2016-02-09
Miami (OH),Western Michigan,45,44,0,1,2016-02-09
Texas A&M,Alabama,62,63,1,-1,2016-02-10
Jacksonville State,Belmont,73,81,1,-8,2016-02-10
American,Boston University,51,71,1,-20,2016-02-10
Loyola (IL),Bradley,54,43,0,11,2016-02-10
Lehigh,Bucknell,80,65,0,15,2016-02-10
Cal State Fullerton,Cal State Northridge,67,75,1,-8,2016-02-10
Boise State,Colorado State,93,97,1,-4,2016-02-10
La Salle,Davidson,66,79,1,-13,2016-02-10
Tulane,East Carolina,100,92,0,8,2016-02-10
Austin Peay,Eastern Illinois,79,70,0,9,2016-02-10
St. Bonaventure,Fordham,76,72,0,4,2016-02-10
San Diego State,Fresno State,57,58,1,-1,2016-02-10
St. Joseph's,George Washington,84,66,0,18,2016-02-10
Wake Forest,Georgia Tech,66,71,1,-5,2016-02-10
Lafayette,Holy Cross,53,67,1,-14,2016-02-10
Memphis,Houston,90,98,1,-8,2016-02-10
Southern Illinois,Indiana State,85,78,0,7,2016-02-10
Baylor,Kansas State,82,72,0,10,2016-02-10
Navy,Loyola (MD),71,51,0,20,2016-02-10
Providence,Marquette,91,96,1,-5,2016-02-10
Michigan,Minnesota,82,74,0,8,2016-02-10
South Dakota State,Omaha,92,96,1,-4,2016-02-10
Air Force,Nevada,52,72,1,-20,2016-02-10
San Jose State,UNLV,61,64,1,-3,2016-02-10
Missouri State,Northern Iowa,69,83,1,-14,2016-02-10
Richmond,Saint Louis,67,53,0,14,2016-02-10
Butler,Seton Hall,81,75,0,6,2016-02-10
LSU,South Carolina,83,94,1,-11,2016-02-10
Tulsa,SMU,82,77,0,5,2016-02-10
Tennessee Tech,Tennessee State,55,85,1,-30,2016-02-10
Iowa State,Texas Tech,82,85,1,-3,2016-02-10
Washington,Utah,82,90,1,-8,2016-02-10
Missouri,Vanderbilt,71,86,1,-15,2016-02-10
Nebraska,Wisconsin,61,72,1,-11,2016-02-10
Fairleigh Dickinson,Bryant,91,77,0,14,2016-02-11
Oregon,California,63,83,1,-20,2016-02-11
UCSB,UC-Davis,72,66,0,6,2016-02-11
Gardner-Webb,Campbell,85,89,1,-4,2016-02-11
Presbyterian,Charleston Southern,63,77,1,-14,2016-02-11
Rice,Charlotte,73,102,1,-29,2016-02-11
High Point,Coastal Carolina,68,67,0,1,2016-02-11
James Madison,College of Charleston,56,52,0,4,2016-02-11
Washington State,Colorado,81,88,1,-7,2016-02-11
Drexel,Delaware,60,69,1,-9,2016-02-11
Western Illinois,Denver,63,60,0,3,2016-02-11
Green Bay,Detroit,86,85,0,1,2016-02-11
Samford,ETSU,90,94,1,-4,2016-02-11
North Dakota,Eastern Washington,85,95,1,-10,2016-02-11
Illinois State,Evansville,70,60,0,10,2016-02-11
UTSA,Florida Atlantic,73,79,1,-6,2016-02-11
UTEP,Florida International,84,74,0,10,2016-02-11
Citadel,Furman,75,95,1,-20,2016-02-11
Binghamton,Hartford,68,54,0,14,2016-02-11
UC-Irvine,Hawaii,52,74,1,-22,2016-02-11
Northern Colorado,Idaho,67,73,1,-6,2016-02-11
Portland State,Idaho State,71,88,1,-17,2016-02-11
Wright State,UIC,59,64,1,-5,2016-02-11
Iowa,Indiana,78,85,1,-7,2016-02-11
North Florida,Kennesaw State,91,101,1,-10,2016-02-11
Jacksonville,Lipscomb,92,93,1,-1,2016-02-11
Cal Poly,Long Beach State,70,73,1,-3,2016-02-11
Wagner,LIU-Brooklyn,69,82,1,-13,2016-02-11
Arkansas State,Louisiana,73,83,1,-10,2016-02-11
Little Rock,Louisiana-Monroe,82,86,1,-4,2016-02-11
Middle Tennessee,Louisiana Tech,63,73,1,-10,2016-02-11
UMass-Lowell,Maine,108,95,0,13,2016-02-11
Quinnipiac,Manhattan,77,84,1,-7,2016-02-11
Stony Brook,UMBC,75,52,0,23,2016-02-11
VCU,UMass,63,69,1,-6,2016-02-11
New Orleans,McNeese State,76,87,1,-11,2016-02-11
Southern Utah,Montana,53,86,1,-33,2016-02-11
Northern Arizona,Montana State,58,101,1,-43,2016-02-11
Eastern Kentucky,Morehead State,50,61,1,-11,2016-02-11
Sacred Heart,Mount St. Mary's,61,66,1,-5,2016-02-11
Albany (NY),New Hampshire,68,69,1,-1,2016-02-11
Stetson,NJIT,70,74,1,-4,2016-02-11
Radford,UNC Asheville,60,59,0,1,2016-02-11
Elon,UNC Wilmington,82,86,1,-4,2016-02-11
Milwaukee,Oakland,93,85,0,8,2016-02-11
North Texas,Old Dominion,47,67,1,-20,2016-02-11
IUPUI,Oral Roberts,56,77,1,-21,2016-02-11
Loyola Marymount,Pacific,77,72,0,5,2016-02-11
Gonzaga,Portland,92,66,0,26,2016-02-11
Saint Francis (PA),Robert Morris,68,57,0,11,2016-02-11
Pepperdine,Saint Mary's,69,63,0,6,2016-02-11
BYU,San Francisco,114,89,0,25,2016-02-11
San Diego,Santa Clara,71,74,1,-3,2016-02-11
Canisius,Siena,67,90,1,-23,2016-02-11
Georgia State,South Alabama,78,79,1,-1,2016-02-11
Florida Gulf Coast,USC Upstate,71,64,0,7,2016-02-11
North Dakota State,South Dakota,58,72,1,-14,2016-02-11
Murray State,SIU-Edwardsville,70,64,0,6,2016-02-11
Alabama-Birmingham,Southern Miss,80,77,0,3,2016-02-11
Central Connecticut,St. Francis (NY),67,74,1,-7,2016-02-11
Oregon State,Stanford,62,50,0,12,2016-02-11
Florida State,Syracuse,72,85,1,-13,2016-02-11
UConn,Temple,58,63,1,-5,2016-02-11
Southeast Missouri State,UT-Martin,64,77,1,-13,2016-02-11
Appalachian State,Texas State,68,69,1,-1,2016-02-11
Northeastern,Towson,47,44,0,3,2016-02-11
Georgia Southern,Troy,77,71,0,6,2016-02-11
Northern Kentucky,Valparaiso,52,64,1,-12,2016-02-11
UNC Greensboro,VMI,72,86,1,-14,2016-02-11
Sacramento State,Weber State,50,63,1,-13,2016-02-11
Chattanooga,Western Carolina,61,67,1,-6,2016-02-11
Hofstra,William & Mary,86,80,0,6,2016-02-11
Longwood,Winthrop,80,88,1,-8,2016-02-11
Mercer,Wofford,70,79,1,-9,2016-02-11
UCLA,Arizona,75,81,1,-6,2016-02-12
USC,Arizona State,67,74,1,-7,2016-02-12
Ohio,Buffalo,94,75,0,19,2016-02-12
Penn,Columbia,53,63,1,-10,2016-02-12
Princeton,Cornell,85,56,0,29,2016-02-12
Yale,Dartmouth,75,65,0,10,2016-02-12
Brown,Harvard,73,79,1,-6,2016-02-12
Central Arkansas,Incarnate Word,69,71,1,-2,2016-02-12
Dayton,Rhode Island,68,66,0,2,2016-02-12
Monmouth,Rider,79,78,0,1,2016-02-12
Niagara,St. Peter's,59,72,1,-13,2016-02-12
Grand Canyon,Seattle,71,60,0,11,2016-02-12
Alabama State,Alabama A&M,74,68,0,6,2016-02-13
Mississippi Valley State,Alcorn State,71,72,1,-1,2016-02-13
Army,American,65,59,0,6,2016-02-13
Vanderbilt,Auburn,86,57,0,29,2016-02-13
UT-Martin,Austin Peay,85,84,0,1,2016-02-13
Texas Tech,Baylor,84,66,0,18,2016-02-13
Wyoming,Boise State,71,94,1,-23,2016-02-13
Western Michigan,Bowling Green State,74,68,0,6,2016-02-13
Wagner,Bryant,79,55,0,24,2016-02-13
Xavier,Butler,74,57,0,17,2016-02-13
Utah Valley,Cal State Bakersfield,69,91,1,-22,2016-02-13
Oregon State,California,71,83,1,-12,2016-02-13
Long Beach State,UC-Davis,57,48,0,9,2016-02-13
Cal State Northridge,UC-Irvine,84,93,1,-9,2016-02-13
Cal Poly,UC-Riverside,86,78,0,8,2016-02-13
Ball State,Central Michigan,75,63,0,12,2016-02-13
North Texas,Charlotte,79,103,1,-24,2016-02-13
New Mexico State,Chicago State,69,55,0,14,2016-02-13
East Carolina,Cincinnati,60,75,1,-15,2016-02-13
Georgia Tech,Clemson,52,66,1,-14,2016-02-13
Gardner-Webb,Coastal Carolina,71,78,1,-7,2016-02-13
Bucknell,Colgate,81,91,1,-10,2016-02-13
Washington,Colorado,80,81,1,-1,2016-02-13
Princeton,Columbia,88,83,0,5,2016-02-13
Tulsa,UConn,73,75,1,-2,2016-02-13
Howard,Coppin State,66,90,1,-24,2016-02-13
Penn,Cornell,92,84,0,8,2016-02-13
Brown,Dartmouth,70,87,1,-17,2016-02-13
Hofstra,Delaware,77,66,0,11,2016-02-13
Maryland-Eastern Shore,Delaware State,71,75,1,-4,2016-02-13
Milwaukee,Detroit,66,80,1,-14,2016-02-13
Virginia,Duke,62,63,1,-1,2016-02-13
Chattanooga,ETSU,76,68,0,8,2016-02-13
SIU-Edwardsville,Eastern Illinois,72,64,0,8,2016-02-13
Tennessee State,Eastern Kentucky,79,78,0,1,2016-02-13
Kent State,Eastern Michigan,70,75,1,-5,2016-02-13
Northern Colorado,Eastern Washington,80,97,1,-17,2016-02-13
College of Charleston,Elon,66,62,0,4,2016-02-13
Robert Morris,Fairleigh Dickinson,72,70,0,2,2016-02-13
Alabama,Florida,61,55,0,6,2016-02-13
UTEP,Florida Atlantic,89,82,0,7,2016-02-13
UTSA,Florida International,65,79,1,-14,2016-02-13
Mercer,Furman,74,85,1,-11,2016-02-13
Davidson,George Mason,59,60,1,-1,2016-02-13
Yale,Harvard,67,55,0,12,2016-02-13
Cal State Fullerton,Hawaii,59,76,1,-17,2016-02-13
Charleston Southern,High Point,50,72,1,-22,2016-02-13
UCF,Houston,58,82,1,-24,2016-02-13
North Dakota,Idaho,64,65,1,-1,2016-02-13
Sacramento State,Idaho State,64,66,1,-2,2016-02-13
Northern Kentucky,UIC,77,79,1,-2,2016-02-13
Siena,Iona,81,78,0,3,2016-02-13
Texas,Iowa State,75,85,1,-10,2016-02-13
Denver,Purdue-Fort Wayne,84,88,1,-4,2016-02-13
Jacksonville,Kennesaw State,69,90,1,-21,2016-02-13
Navy,Lafayette,74,68,0,6,2016-02-13
North Florida,Lipscomb,87,94,1,-7,2016-02-13
Liberty,Longwood,69,68,0,1,2016-02-13
Little Rock,Louisiana,68,64,0,4,2016-02-13
Arkansas State,Louisiana-Monroe,73,78,1,-5,2016-02-13
Texas A&M,LSU,71,76,1,-5,2016-02-13
Alabama-Birmingham,Louisiana Tech,76,85,1,-9,2016-02-13
Boston University,Loyola (MD),73,65,0,8,2016-02-13
Manhattan,Marist,81,73,0,8,2016-02-13
Creighton,Marquette,65,62,0,3,2016-02-13
Wisconsin,Maryland,70,57,0,13,2016-02-13
Purdue,Michigan,56,61,1,-5,2016-02-13
Arkansas,Ole Miss,60,76,1,-16,2016-02-13
Georgia,Mississippi State,66,57,0,9,2016-02-13
Tennessee,Missouri,64,75,1,-11,2016-02-13
Texas-Rio Grande Valley,UMKC,58,75,1,-17,2016-02-13
Indiana State,Missouri State,85,89,1,-4,2016-02-13
Northern Arizona,Montana,67,85,1,-18,2016-02-13
Southern Utah,Montana State,73,80,1,-7,2016-02-13
Belmont,Morehead State,77,78,1,-1,2016-02-13
Saint Francis (PA),Mount St. Mary's,61,66,1,-5,2016-02-13
Southeast Missouri State,Murray State,56,83,1,-27,2016-02-13
Penn State,Nebraska,54,70,1,-16,2016-02-13
North Dakota State,Omaha,69,76,1,-7,2016-02-13
Fresno State,Nevada,72,77,1,-5,2016-02-13
Colorado State,UNLV,80,87,1,-7,2016-02-13
San Jose State,New Mexico,58,74,1,-16,2016-02-13
Florida Gulf Coast,NJIT,59,68,1,-9,2016-02-13
Morgan State,Norfolk State,73,79,1,-6,2016-02-13
Florida A&M,North Carolina A&T,68,75,1,-7,2016-02-13
Bethune-Cookman,North Carolina Central,66,90,1,-24,2016-02-13
Wake Forest,NC State,88,99,1,-11,2016-02-13
James Madison,UNC Wilmington,68,78,1,-10,2016-02-13
Drexel,Northeastern,60,70,1,-10,2016-02-13
Akron,Northern Illinois,79,80,1,-1,2016-02-13
Illinois,Northwestern,56,58,1,-2,2016-02-13
McNeese State,Northwestern State,78,87,1,-9,2016-02-13
Louisville,Notre Dame,66,71,1,-5,2016-02-13
Green Bay,Oakland,93,111,1,-18,2016-02-13
Kansas,Oklahoma,76,72,0,4,2016-02-13
Kansas State,Oklahoma State,55,58,1,-3,2016-02-13
Rice,Old Dominion,75,66,0,9,2016-02-13
Western Illinois,Oral Roberts,66,72,1,-6,2016-02-13
Pepperdine,Pacific,65,63,0,2,2016-02-13
Grambling,Prairie View,56,60,1,-4,2016-02-13
Campbell,Presbyterian,91,61,0,30,2016-02-13
Georgetown,Providence,72,75,1,-3,2016-02-13
Fairfield,Quinnipiac,84,80,0,4,2016-02-13
Winthrop,Radford,86,84,0,2,2016-02-13
Fordham,Richmond,67,71,1,-4,2016-02-13
Ohio State,Rutgers,79,69,0,10,2016-02-13
Central Connecticut,Sacred Heart,52,87,1,-35,2016-02-13
La Salle,St. Joseph's,62,88,1,-26,2016-02-13
Loyola Marymount,Saint Mary's,62,68,1,-6,2016-02-13
Houston Baptist,Sam Houston State,68,80,1,-12,2016-02-13
Air Force,San Diego State,61,70,1,-9,2016-02-13
San Diego,San Francisco,51,68,1,-17,2016-02-13
BYU,Santa Clara,96,62,0,34,2016-02-13
Georgia Southern,South Alabama,76,80,1,-4,2016-02-13
Kentucky,South Carolina,89,62,0,27,2016-02-13
Savannah State,South Carolina State,60,57,0,3,2016-02-13
Stetson,USC Upstate,83,85,1,-2,2016-02-13
South Dakota,South Dakota State,68,85,1,-17,2016-02-13
Nicholls State,Southeastern Louisiana,61,69,1,-8,2016-02-13
Arkansas-Pine Bluff,Southern,58,66,1,-8,2016-02-13
Drake,Southern Illinois,60,75,1,-15,2016-02-13
Gonzaga,SMU,60,69,1,-9,2016-02-13
Middle Tennessee,Southern Miss,76,54,0,22,2016-02-13
George Washington,St. Bonaventure,57,64,1,-7,2016-02-13
Oregon,Stanford,72,76,1,-4,2016-02-13
Texas A&M-Corpus Christi,Stephen F. Austin,58,70,1,-12,2016-02-13
Jacksonville State,Tennessee Tech,70,72,1,-2,2016-02-13
Appalachian State,Texas-Arlington,60,91,1,-31,2016-02-13
Jackson State,Texas Southern,60,76,1,-16,2016-02-13
Miami (OH),Toledo,49,93,1,-44,2016-02-13
William & Mary,Towson,82,99,1,-17,2016-02-13
Georgia State,Troy,53,54,1,-1,2016-02-13
Memphis,Tulane,87,94,1,-7,2016-02-13
Wright State,Valparaiso,61,59,0,2,2016-02-13
St. John's (NY),Villanova,63,73,1,-10,2016-02-13
Saint Louis,VCU,52,85,1,-33,2016-02-13
Portland State,Weber State,78,87,1,-9,2016-02-13
TCU,West Virginia,42,73,1,-31,2016-02-13
Samford,Western Carolina,71,76,1,-5,2016-02-13
Marshall,Western Kentucky,96,93,0,3,2016-02-13
Northern Iowa,Wichita State,53,50,0,3,2016-02-13
Citadel,Wofford,89,99,1,-10,2016-02-13
Cleveland State,Youngstown State,64,59,0,5,2016-02-13
Maine,Albany (NY),64,108,1,-44,2016-02-14
USC,Arizona,78,86,1,-8,2016-02-14
UCLA,Arizona State,78,65,0,13,2016-02-14
Syracuse,Boston College,75,61,0,14,2016-02-14
UMass,Duquesne,108,99,0,9,2016-02-14
Miami (FL),Florida State,67,65,0,2,2016-02-14
Bradley,Illinois State,60,75,1,-15,2016-02-14
Minnesota,Iowa,71,75,1,-4,2016-02-14
Evansville,Loyola (IL),74,73,0,1,2016-02-14
UMBC,UMass-Lowell,92,96,1,-4,2016-02-14
Indiana,Michigan State,69,88,1,-19,2016-02-14
Pitt,UNC,64,85,1,-21,2016-02-14
Niagara,Rider,59,77,1,-18,2016-02-14
Canisius,St. Peter's,57,61,1,-4,2016-02-14
New Hampshire,Stony Brook,58,59,1,-1,2016-02-14
South Florida,Temple,65,77,1,-12,2016-02-14
Washington State,Utah,47,88,1,-41,2016-02-14
Hartford,Vermont,81,92,1,-11,2016-02-14
Sam Houston State,Abilene Christian,84,71,0,13,2016-02-15
Arkansas-Pine Bluff,Alcorn State,60,79,1,-19,2016-02-15
Northwestern State,Central Arkansas,94,107,1,-13,2016-02-15
Delaware State,Coppin State,71,67,0,4,2016-02-15
Western Carolina,ETSU,77,83,1,-6,2016-02-15
Marist,Fairfield,73,76,1,-3,2016-02-15
Milwaukee,Green Bay,68,70,1,-2,2016-02-15
Morgan State,Hampton,79,87,1,-8,2016-02-15
Lamar,Houston Baptist,78,79,1,-1,2016-02-15
Quinnipiac,Iona,59,78,1,-19,2016-02-15
Oklahoma State,Kansas,67,94,1,-27,2016-02-15
Holy Cross,Lehigh,59,64,1,-5,2016-02-15
Southeastern Louisiana,McNeese State,79,76,0,3,2016-02-15
Manhattan,Monmouth,70,79,1,-9,2016-02-15
Texas A&M-Corpus Christi,New Orleans,65,57,0,8,2016-02-15
Bethune-Cookman,North Carolina A&T,83,77,0,6,2016-02-15
Florida A&M,North Carolina Central,74,79,1,-5,2016-02-15
Wofford,UNC Greensboro,61,65,1,-4,2016-02-15
Jackson State,Prairie View,80,66,0,14,2016-02-15
Mississippi Valley State,Southern,64,97,1,-33,2016-02-15
LIU-Brooklyn,St. Francis (NY),82,67,0,15,2016-02-15
Incarnate Word,Stephen F. Austin,46,84,1,-38,2016-02-15
Grambling,Texas Southern,72,79,1,-7,2016-02-15
NC State,Virginia,53,73,1,-20,2016-02-15
New Mexico State,Wichita State,41,71,1,-30,2016-02-15
Oakland,Wright State,89,73,0,16,2016-02-15
UNLV,Air Force,74,79,1,-5,2016-02-16
Buffalo,Akron,70,80,1,-10,2016-02-16
Iowa State,Baylor,91,100,1,-9,2016-02-16
Creighton,Butler,75,88,1,-13,2016-02-16
Allen,Campbell,66,110,1,-44,2016-02-16
Toledo,Central Michigan,69,77,1,-8,2016-02-16
Valparaiso,Cleveland State,66,43,0,23,2016-02-16
Richmond,Davidson,79,83,1,-4,2016-02-16
South Florida,East Carolina,69,52,0,17,2016-02-16
Florida,Georgia,57,53,0,4,2016-02-16
Maryland-Eastern Shore,Howard,74,77,1,-3,2016-02-16
Rutgers,Illinois,66,82,1,-16,2016-02-16
Western Michigan,Kent State,78,85,1,-7,2016-02-16
Ball State,Miami (OH),73,56,0,17,2016-02-16
Vanderbilt,Mississippi State,74,75,1,-1,2016-02-16
South Carolina,Missouri,67,72,1,-5,2016-02-16
St. Catharine,Morehead State,66,105,1,-39,2016-02-16
Bowling Green State,Northern Illinois,60,71,1,-11,2016-02-16
Detroit,Northern Kentucky,74,68,0,6,2016-02-16
Eastern Michigan,Ohio,64,86,1,-22,2016-02-16
Michigan,Ohio State,66,76,1,-10,2016-02-16
Wake Forest,Pitt,96,101,1,-5,2016-02-16
Northwestern,Purdue,61,71,1,-10,2016-02-16
Troy,South Alabama,61,54,0,7,2016-02-16
West Virginia,Texas,78,85,1,-7,2016-02-16
Ole Miss,Texas A&M,56,71,1,-15,2016-02-16
Kansas State,TCU,63,49,0,14,2016-02-16
Rhode Island,VCU,67,83,1,-16,2016-02-16
UIC,Youngstown State,91,92,1,-1,2016-02-16
Stony Brook,Albany (NY),70,82,1,-12,2016-02-17
Lafayette,American,59,60,1,-1,2016-02-17
Arizona State,Arizona,61,99,1,-38,2016-02-17
Auburn,Arkansas,90,86,0,4,2016-02-17
Holy Cross,Army,68,72,1,-4,2016-02-17
Colgate,Boston University,68,71,1,-3,2016-02-17
Loyola (MD),Bucknell,52,87,1,-35,2016-02-17
UC-Irvine,Cal State Fullerton,96,77,0,19,2016-02-17
Boston College,Clemson,54,65,1,-11,2016-02-17
Evansville,Drake,80,74,0,6,2016-02-17
George Washington,Duquesne,81,74,0,7,2016-02-17
Georgia Tech,Florida State,86,80,0,6,2016-02-17
UMass,Fordham,66,76,1,-10,2016-02-17
Saint Louis,George Mason,79,77,0,2,2016-02-17
Seton Hall,Georgetown,72,64,0,8,2016-02-17
UMBC,Hartford,65,88,1,-23,2016-02-17
Indiana State,Illinois State,50,78,1,-28,2016-02-17
Nebraska,Indiana,64,80,1,-16,2016-02-17
Omaha,IUPUI,76,88,1,-12,2016-02-17
St. Bonaventure,La Salle,64,71,1,-7,2016-02-17
Alabama,LSU,76,69,0,7,2016-02-17
Syracuse,Louisville,58,72,1,-14,2016-02-17
Northern Iowa,Loyola (IL),56,59,1,-3,2016-02-17
UCF,Memphis,56,73,1,-17,2016-02-17
Virginia Tech,Miami (FL),49,65,1,-16,2016-02-17
Lehigh,Navy,77,74,0,3,2016-02-17
UMass-Lowell,New Hampshire,69,80,1,-11,2016-02-17
Boise State,New Mexico,78,80,1,-2,2016-02-17
Duke,UNC,74,73,0,1,2016-02-17
Western Illinois,North Dakota State,54,63,1,-9,2016-02-17
Iowa,Penn State,75,79,1,-4,2016-02-17
Dayton,St. Joseph's,70,79,1,-9,2016-02-17
Manhattan,St. Peter's,69,70,1,-1,2016-02-17
Nevada,San Jose State,61,55,0,6,2016-02-17
York (NE),South Dakota,55,82,1,-27,2016-02-17
Colorado,USC,72,79,1,-7,2016-02-17
Bradley,Southern Illinois,59,71,1,-12,2016-02-17
DePaul,St. John's (NY),65,80,1,-15,2016-02-17
Villanova,Temple,83,67,0,16,2016-02-17
Oklahoma,Texas Tech,63,65,1,-2,2016-02-17
Houston,Tulane,82,69,0,13,2016-02-17
Colorado State,Utah State,59,72,1,-13,2016-02-17
Binghamton,Vermont,64,78,1,-14,2016-02-17
Fresno State,Wyoming,79,75,0,4,2016-02-17
Providence,Xavier,74,85,1,-11,2016-02-17
South Alabama,Appalachian State,75,71,0,4,2016-02-18
Sacred Heart,Bryant,74,57,0,17,2016-02-18
UC-Davis,Cal Poly,53,58,1,-5,2016-02-18
Hawaii,Cal State Northridge,69,63,0,6,2016-02-18
UCSB,UC-Riverside,65,55,0,10,2016-02-18
Fairfield,Canisius,74,71,0,3,2016-02-18
Mount St. Mary's,Central Connecticut,72,76,1,-4,2016-02-18
VMI,Chattanooga,59,85,1,-26,2016-02-18
ETSU,Citadel,67,51,0,16,2016-02-18
SMU,UConn,62,68,1,-6,2016-02-18
North Carolina Central,Coppin State,60,71,1,-11,2016-02-18
College of Charleston,Delaware,59,62,1,-3,2016-02-18
Elon,Drexel,81,76,0,5,2016-02-18
Belmont,Eastern Kentucky,86,78,0,8,2016-02-18
Wagner,Fairleigh Dickinson,94,74,0,20,2016-02-18
Lipscomb,Florida Gulf Coast,67,82,1,-15,2016-02-18
Charleston Southern,Gardner-Webb,76,84,1,-8,2016-02-18
Arkansas State,Georgia Southern,59,90,1,-31,2016-02-18
Little Rock,Georgia State,57,49,0,8,2016-02-18
Pacific,Gonzaga,68,90,1,-22,2016-02-18
UMKC,Grand Canyon,66,78,1,-12,2016-02-18
Towson,Hofstra,82,84,1,-2,2016-02-18
Abilene Christian,Houston Baptist,71,73,1,-2,2016-02-18
South Dakota State,Purdue-Fort Wayne,79,91,1,-12,2016-02-18
USC Upstate,Jacksonville,76,81,1,-5,2016-02-18
Northeastern,James Madison,95,94,0,1,2016-02-18
Tennessee,Kentucky,70,80,1,-10,2016-02-18
Radford,Liberty,69,67,0,2,2016-02-18
High Point,Longwood,88,80,0,8,2016-02-18
Santa Clara,Loyola Marymount,76,72,0,4,2016-02-18
Charlotte,Marshall,72,87,1,-15,2016-02-18
Western Carolina,Mercer,72,65,0,7,2016-02-18
Wisconsin,Michigan State,57,69,1,-12,2016-02-18
Maryland,Minnesota,63,68,1,-5,2016-02-18
Tennessee State,Morehead State,61,66,1,-5,2016-02-18
Cal State Bakersfield,New Mexico State,55,63,1,-8,2016-02-18
Marist,Niagara,72,76,1,-4,2016-02-18
NJIT,North Florida,71,107,1,-36,2016-02-18
Florida International,North Texas,75,77,1,-2,2016-02-18
Idaho State,Northern Arizona,68,81,1,-13,2016-02-18
San Francisco,Pepperdine,82,72,0,10,2016-02-18
Saint Mary's,Portland,74,72,0,2,2016-02-18
Idaho,Portland State,80,74,0,6,2016-02-18
UNC Asheville,Presbyterian,70,61,0,9,2016-02-18
St. Peter's,Quinnipiac,55,56,1,-1,2016-02-18
Florida Atlantic,Rice,85,90,1,-5,2016-02-18
LIU-Brooklyn,Robert Morris,67,74,1,-7,2016-02-18
Eastern Washington,Sacramento State,93,88,0,5,2016-02-18
St. Francis (NY),Saint Francis (PA),70,58,0,12,2016-02-18
UNC Greensboro,Samford,82,77,0,5,2016-02-18
BYU,San Diego,69,67,0,2,2016-02-18
SIU-Edwardsville,Southeast Missouri State,72,69,0,3,2016-02-18
Weber State,Southern Utah,87,83,0,4,2016-02-18
Kennesaw State,Stetson,92,82,0,10,2016-02-18
Eastern Illinois,UT-Martin,84,87,1,-3,2016-02-18
Louisiana,Texas-Arlington,83,84,1,-1,2016-02-18
Southern Miss,UTEP,73,78,1,-5,2016-02-18
Seattle,Texas-Rio Grande Valley,57,67,1,-10,2016-02-18
Louisiana Tech,UTSA,87,74,0,13,2016-02-18
Louisiana-Monroe,Texas State,76,57,0,19,2016-02-18
Cincinnati,Tulsa,68,70,1,-2,2016-02-18
Utah,UCLA,75,73,0,2,2016-02-18
Chicago State,Utah Valley,72,74,1,-2,2016-02-18
California,Washington,78,75,0,3,2016-02-18
Stanford,Washington State,72,56,0,16,2016-02-18
Old Dominion,Western Kentucky,59,56,0,3,2016-02-18
Missouri State,Wichita State,68,99,1,-31,2016-02-18
UNC Wilmington,William & Mary,69,87,1,-18,2016-02-18
Coastal Carolina,Winthrop,67,79,1,-12,2016-02-18
Northern Illinois,Ball State,59,63,1,-4,2016-02-19
Harvard,Columbia,76,90,1,-14,2016-02-19
Dartmouth,Cornell,78,66,0,12,2016-02-19
Detroit,UIC,83,72,0,11,2016-02-19
Akron,Kent State,76,85,1,-9,2016-02-19
Iona,Monmouth,83,67,0,16,2016-02-19
Denver,Oral Roberts,58,62,1,-4,2016-02-19
Brown,Penn,74,79,1,-5,2016-02-19
Yale,Princeton,63,75,1,-12,2016-02-19
Siena,Rider,84,64,0,20,2016-02-19
Oakland,Valparaiso,84,86,1,-2,2016-02-19
Richmond,VCU,74,87,1,-13,2016-02-19
New Mexico,Air Force,72,76,1,-4,2016-02-20
Mississippi State,Alabama,67,61,0,6,2016-02-20
Alcorn State,Alabama A&M,62,58,0,4,2016-02-20
Southern,Alabama State,68,77,1,-9,2016-02-20
Troy,Appalachian State,74,78,1,-4,2016-02-20
Missouri,Arkansas,72,84,1,-12,2016-02-20
Prairie View,Arkansas-Pine Bluff,57,55,0,2,2016-02-20
Ole Miss,Auburn,69,59,0,10,2016-02-20
Murray State,Austin Peay,76,60,0,16,2016-02-20
Tennessee Tech,Belmont,86,95,1,-9,2016-02-20
UMass-Lowell,Binghamton,77,81,1,-4,2016-02-20
Drake,Bradley,70,73,1,-3,2016-02-20
San Diego,BYU,33,91,1,-58,2016-02-20
Mount St. Mary's,Bryant,71,53,0,18,2016-02-20
Bowling Green State,Buffalo,74,88,1,-14,2016-02-20
Cal State Northridge,Cal Poly,75,71,0,4,2016-02-20
Hawaii,UC-Irvine,75,71,0,4,2016-02-20
UC-Davis,UCSB,55,62,1,-7,2016-02-20
Marist,Canisius,66,81,1,-15,2016-02-20
Wagner,Central Connecticut,83,57,0,26,2016-02-20
Campbell,Charleston Southern,74,72,0,2,2016-02-20
UNC Greensboro,Chattanooga,79,64,0,15,2016-02-20
UConn,Cincinnati,60,65,1,-5,2016-02-20
Western Carolina,Citadel,102,97,0,5,2016-02-20
UNC Wilmington,College of Charleston,59,55,0,4,2016-02-20
Wyoming,Colorado State,84,66,0,18,2016-02-20
Dartmouth,Columbia,54,73,1,-19,2016-02-20
Harvard,Cornell,76,74,0,2,2016-02-20
St. Joseph's,Davidson,93,99,1,-6,2016-02-20
St. Bonaventure,Dayton,79,72,0,7,2016-02-20
Norfolk State,Delaware State,64,67,1,-3,2016-02-20
Marquette,DePaul,73,60,0,13,2016-02-20
Toledo,Eastern Michigan,85,91,1,-6,2016-02-20
Southern Illinois,Evansville,71,83,1,-12,2016-02-20
Sacred Heart,Fairleigh Dickinson,91,86,0,5,2016-02-20
Bethune-Cookman,Florida A&M,55,54,0,1,2016-02-20
Kennesaw State,Florida Gulf Coast,63,68,1,-5,2016-02-20
Utah State,Fresno State,68,75,1,-7,2016-02-20
Longwood,Gardner-Webb,71,81,1,-10,2016-02-20
Xavier,Georgetown,88,70,0,18,2016-02-20
Little Rock,Georgia Southern,75,61,0,14,2016-02-20
Arkansas State,Georgia State,61,69,1,-8,2016-02-20
Notre Dame,Georgia Tech,62,63,1,-1,2016-02-20
Saint Mary's,Gonzaga,63,58,0,5,2016-02-20
Jackson State,Grambling,61,58,0,3,2016-02-20
Chicago State,Grand Canyon,52,67,1,-15,2016-02-20
Youngstown State,Green Bay,90,107,1,-17,2016-02-20
New Hampshire,Hartford,74,63,0,11,2016-02-20
Savannah State,Howard,66,56,0,10,2016-02-20
Purdue,Indiana,73,77,1,-4,2016-02-20
TCU,Iowa State,83,92,1,-9,2016-02-20
Omaha,Purdue-Fort Wayne,90,94,1,-4,2016-02-20
NJIT,Jacksonville,73,58,0,15,2016-02-20
Delaware,James Madison,50,75,1,-25,2016-02-20
Kansas,Kansas State,72,63,0,9,2016-02-20
Presbyterian,Liberty,79,73,0,6,2016-02-20
Cal State Fullerton,Long Beach State,57,70,1,-13,2016-02-20
Duke,Louisville,64,71,1,-7,2016-02-20
San Francisco,Loyola Marymount,87,100,1,-13,2016-02-20
Old Dominion,Marshall,65,82,1,-17,2016-02-20
Vermont,UMBC,99,54,0,45,2016-02-20
South Carolina State,Maryland-Eastern Shore,62,58,0,4,2016-02-20
Lamar,McNeese State,87,76,0,11,2016-02-20
ETSU,Mercer,77,74,0,3,2016-02-20
Cleveland State,Milwaukee,54,88,1,-34,2016-02-20
Texas Southern,Mississippi Valley State,98,67,0,31,2016-02-20
Montana State,Montana,78,87,1,-9,2016-02-20
North Carolina Central,Morgan State,73,59,0,14,2016-02-20
Army,Navy,80,78,0,2,2016-02-20
Ohio State,Nebraska,65,62,0,3,2016-02-20
Nevada,UNLV,91,102,1,-11,2016-02-20
Seattle,New Mexico State,57,70,1,-13,2016-02-20
Fairfield,Niagara,71,59,0,12,2016-02-20
Stephen F. Austin,Nicholls State,88,53,0,35,2016-02-20
Miami (FL),UNC,71,96,1,-25,2016-02-20
Clemson,NC State,74,77,1,-3,2016-02-20
Northern Colorado,North Dakota,73,74,1,-1,2016-02-20
IUPUI,North Dakota State,59,63,1,-4,2016-02-20
USC Upstate,North Florida,78,81,1,-3,2016-02-20
Florida Atlantic,North Texas,62,70,1,-8,2016-02-20
Weber State,Northern Arizona,77,74,0,3,2016-02-20
Illinois State,Northern Iowa,66,75,1,-9,2016-02-20
New Orleans,Northwestern State,102,99,0,3,2016-02-20
Miami (OH),Ohio,64,76,1,-12,2016-02-20
Texas Tech,Oklahoma State,71,61,0,10,2016-02-20
Oregon State,Oregon,81,91,1,-10,2016-02-20
Yale,Penn,79,58,0,21,2016-02-20
Santa Clara,Pepperdine,76,88,1,-12,2016-02-20
Pacific,Portland,67,80,1,-13,2016-02-20
Eastern Washington,Portland State,91,107,1,-16,2016-02-20
Brown,Princeton,66,77,1,-11,2016-02-20
High Point,Radford,75,72,0,3,2016-02-20
Duquesne,Rhode Island,74,77,1,-3,2016-02-20
Florida International,Rice,70,86,1,-16,2016-02-20
St. Francis (NY),Robert Morris,82,72,0,10,2016-02-20
Penn State,Rutgers,70,58,0,12,2016-02-20
Idaho,Sacramento State,65,68,1,-3,2016-02-20
LIU-Brooklyn,Saint Francis (PA),94,89,0,5,2016-02-20
Fordham,Saint Louis,68,76,1,-8,2016-02-20
Central Arkansas,Sam Houston State,75,105,1,-30,2016-02-20
VMI,Samford,67,73,1,-6,2016-02-20
Florida,South Carolina,69,73,1,-4,2016-02-20
Memphis,South Florida,71,80,1,-9,2016-02-20
Eastern Illinois,Southeast Missouri State,71,68,0,3,2016-02-20
Idaho State,Southern Utah,89,71,0,18,2016-02-20
Lipscomb,Stetson,77,74,0,3,2016-02-20
Pitt,Syracuse,66,52,0,14,2016-02-20
LSU,Tennessee,65,81,1,-16,2016-02-20
SIU-Edwardsville,UT-Martin,51,68,1,-17,2016-02-20
Jacksonville State,Tennessee State,46,61,1,-15,2016-02-20
Baylor,Texas,78,64,0,14,2016-02-20
Kentucky,Texas A&M,77,79,1,-2,2016-02-20
Incarnate Word,Texas A&M-Corpus Christi,69,90,1,-21,2016-02-20
Louisiana-Monroe,Texas-Arlington,64,61,0,3,2016-02-20
Louisiana Tech,UTEP,80,91,1,-11,2016-02-20
Cal State Bakersfield,Texas-Rio Grande Valley,70,57,0,13,2016-02-20
Southern Miss,UTSA,53,74,1,-21,2016-02-20
Louisiana,Texas State,57,61,1,-4,2016-02-20
Elon,Towson,56,67,1,-11,2016-02-20
Colorado,UCLA,53,77,1,-24,2016-02-20
UMKC,Utah Valley,70,79,1,-9,2016-02-20
Georgia,Vanderbilt,67,80,1,-13,2016-02-20
Butler,Villanova,67,77,1,-10,2016-02-20
Florida State,Virginia Tech,73,83,1,-10,2016-02-20
Stanford,Washington,53,64,1,-11,2016-02-20
Oklahoma,West Virginia,76,62,0,14,2016-02-20
South Dakota State,Western Illinois,87,67,0,20,2016-02-20
Charlotte,Western Kentucky,54,59,1,-5,2016-02-20
Central Michigan,Western Michigan,85,92,1,-7,2016-02-20
Drexel,William & Mary,74,69,0,5,2016-02-20
UNC Asheville,Winthrop,80,81,1,-1,2016-02-20
Furman,Wofford,73,77,1,-4,2016-02-20
Northern Kentucky,Wright State,64,67,1,-3,2016-02-20
Southeastern Louisiana,Abilene Christian,80,91,1,-11,2016-02-21
Boston University,Bucknell,59,80,1,-21,2016-02-21
Tulsa,UCF,75,67,0,8,2016-02-21
Loyola (MD),Colgate,90,93,1,-3,2016-02-21
La Salle,George Washington,50,90,1,-40,2016-02-21
Northeastern,Hofstra,60,65,1,-5,2016-02-21
American,Holy Cross,71,70,0,1,2016-02-21
Temple,Houston,69,66,0,3,2016-02-21
Oakland,UIC,74,63,0,11,2016-02-21
Wichita State,Indiana State,84,51,0,33,2016-02-21
Lafayette,Lehigh,61,73,1,-12,2016-02-21
Stony Brook,Maine,75,56,0,19,2016-02-21
Michigan,Maryland,82,86,1,-4,2016-02-21
George Mason,UMass,64,70,1,-6,2016-02-21
Alabama-Birmingham,Middle Tennessee,77,67,0,10,2016-02-21
Loyola (IL),Missouri State,75,62,0,13,2016-02-21
Manhattan,Quinnipiac,63,59,0,4,2016-02-21
Monmouth,St. Peter's,82,75,0,7,2016-02-21
San Diego State,San Jose State,78,56,0,22,2016-02-21
Denver,South Dakota,76,71,0,5,2016-02-21
Utah,USC,80,69,0,11,2016-02-21
East Carolina,SMU,63,74,1,-11,2016-02-21
Seton Hall,St. John's (NY),62,61,0,1,2016-02-21
Detroit,Valparaiso,74,90,1,-16,2016-02-21
Boston College,Wake Forest,48,74,1,-26,2016-02-21
California,Washington State,80,62,0,18,2016-02-21
Illinois,Wisconsin,60,69,1,-9,2016-02-21
Southern,Alabama A&M,66,78,1,-12,2016-02-22
Alcorn State,Alabama State,60,73,1,-13,2016-02-22
Texas Southern,Arkansas-Pine Bluff,54,52,0,2,2016-02-22
Hampton,Delaware State,82,72,0,10,2016-02-22
Cleveland State,Green Bay,61,78,1,-17,2016-02-22
Incarnate Word,Houston Baptist,97,91,0,6,2016-02-22
South Carolina State,Howard,71,63,0,8,2016-02-22
Texas,Kansas State,71,70,0,1,2016-02-22
Stephen F. Austin,Lamar,79,58,0,21,2016-02-22
Florida A&M,Maryland-Eastern Shore,81,80,0,1,2016-02-22
Central Arkansas,McNeese State,88,82,0,6,2016-02-22
Virginia,Miami (FL),61,64,1,-3,2016-02-22
Youngstown State,Milwaukee,51,87,1,-36,2016-02-22
Prairie View,Mississippi Valley State,63,61,0,2,2016-02-22
North Carolina A&T,Morgan State,51,72,1,-21,2016-02-22
Coppin State,Norfolk State,77,85,1,-8,2016-02-22
Nicholls State,Northwestern State,67,81,1,-14,2016-02-22
Iona,Siena,87,81,0,6,2016-02-22
Bethune-Cookman,Stetson,96,94,0,2,2016-02-22
Iowa State,West Virginia,87,97,1,-10,2016-02-22
LSU,Arkansas,65,85,1,-20,2016-02-23
Kansas,Baylor,66,60,0,6,2016-02-23
UNLV,Boise State,69,81,1,-12,2016-02-23
Virginia Tech,Boston College,71,56,0,15,2016-02-23
Army,Boston University,80,71,0,9,2016-02-23
Ohio,Bowling Green State,82,87,1,-5,2016-02-23
Evansville,Bradley,67,55,0,12,2016-02-23
Kent State,Buffalo,70,87,1,-17,2016-02-23
Northern Illinois,Central Michigan,64,76,1,-12,2016-02-23
New Mexico,Colorado State,69,86,1,-17,2016-02-23
Rhode Island,Davidson,54,65,1,-11,2016-02-23
Western Michigan,Eastern Michigan,62,73,1,-11,2016-02-23
Vanderbilt,Florida,87,74,0,13,2016-02-23
Georgia State,Georgia Southern,52,54,1,-2,2016-02-23
Clemson,Georgia Tech,73,75,1,-2,2016-02-23
Alabama,Kentucky,53,78,1,-25,2016-02-23
St. Peter's,Manhattan,61,40,0,21,2016-02-23
Rider,Marist,58,71,1,-13,2016-02-23
Akron,Miami (OH),64,77,1,-13,2016-02-23
Rutgers,Minnesota,61,83,1,-22,2016-02-23
Missouri,Ole Miss,76,85,1,-9,2016-02-23
Michigan State,Ohio State,81,62,0,19,2016-02-23
Dayton,Saint Louis,52,49,0,3,2016-02-23
Allen,Savannah State,72,83,1,-11,2016-02-23
Abilene Christian,Texas A&M-Corpus Christi,59,65,1,-6,2016-02-23
TCU,Texas Tech,79,83,1,-4,2016-02-23
Ball State,Toledo,67,77,1,-10,2016-02-23
Temple,Tulsa,55,74,1,-19,2016-02-23
Navy,American,65,72,1,-7,2016-02-24
Georgia,Auburn,81,84,1,-3,2016-02-24
Long Beach State,UC-Irvine,67,90,1,-23,2016-02-24
Houston,UCF,88,61,0,27,2016-02-24
Lehigh,Colgate,71,54,0,17,2016-02-24
Arizona,Colorado,72,75,1,-3,2016-02-24
Marquette,Creighton,66,61,0,5,2016-02-24
Siena,Fairfield,69,76,1,-7,2016-02-24
Air Force,Fresno State,63,64,1,-1,2016-02-24
VCU,George Mason,69,76,1,-7,2016-02-24
Florida A&M,Howard,53,63,1,-10,2016-02-24
Southern Illinois,Illinois State,50,73,1,-23,2016-02-24
Wisconsin,Iowa,67,59,0,8,2016-02-24
Fordham,La Salle,56,53,0,3,2016-02-24
Bucknell,Lafayette,86,83,0,3,2016-02-24
Wichita State,Loyola (IL),76,54,0,22,2016-02-24
Holy Cross,Loyola (MD),63,78,1,-15,2016-02-24
Hartford,Maine,82,74,0,8,2016-02-24
Binghamton,UMBC,79,80,1,-1,2016-02-24
St. Joseph's,UMass,74,57,0,17,2016-02-24
Albany (NY),UMass-Lowell,86,61,0,25,2016-02-24
Northwestern,Michigan,63,72,1,-9,2016-02-24
Drake,Missouri State,52,61,1,-9,2016-02-24
Norfolk State,Morgan State,72,89,1,-17,2016-02-24
Utah State,Nevada,68,73,1,-5,2016-02-24
UNC,NC State,80,68,0,12,2016-02-24
Indiana State,Northern Iowa,44,66,1,-22,2016-02-24
Oklahoma State,Oklahoma,49,71,1,-22,2016-02-24
Washington State,Oregon,62,76,1,-14,2016-02-24
Washington,Oregon State,81,82,1,-1,2016-02-24
Louisville,Pitt,67,60,0,7,2016-02-24
George Washington,Richmond,73,61,0,12,2016-02-24
Tennessee,South Carolina,58,84,1,-26,2016-02-24
New Orleans,Southeastern Louisiana,81,93,1,-12,2016-02-24
Duquesne,St. Bonaventure,76,80,1,-4,2016-02-24
Mississippi State,Texas A&M,66,68,1,-2,2016-02-24
East Carolina,Tulane,79,73,0,6,2016-02-24
New Hampshire,Vermont,67,73,1,-6,2016-02-24
Notre Dame,Wake Forest,69,58,0,11,2016-02-24
San Diego State,Wyoming,73,61,0,12,2016-02-24
Villanova,Xavier,83,90,1,-7,2016-02-24
Marshall,Alabama-Birmingham,91,95,1,-4,2016-02-25
Texas-Arlington,Little Rock,60,72,1,-12,2016-02-25
Texas State,Arkansas State,71,60,0,11,2016-02-25
Portland,BYU,81,99,1,-18,2016-02-25
Cal State Fullerton,Cal Poly,78,77,0,1,2016-02-25
UCSB,Cal State Northridge,78,63,0,15,2016-02-25
UCLA,California,63,75,1,-12,2016-02-25
Radford,Campbell,60,56,0,4,2016-02-25
Niagara,Canisius,60,65,1,-5,2016-02-25
UTSA,Charlotte,108,114,1,-6,2016-02-25
Northern Kentucky,Cleveland State,58,63,1,-5,2016-02-25
Charleston Southern,Coastal Carolina,60,68,1,-8,2016-02-25
St. John's (NY),DePaul,75,83,1,-8,2016-02-25
Delaware,Drexel,64,74,1,-10,2016-02-25
Florida State,Duke,65,80,1,-15,2016-02-25
Furman,ETSU,75,80,1,-5,2016-02-25
Murray State,Eastern Illinois,74,85,1,-11,2016-02-25
William & Mary,Elon,75,65,0,10,2016-02-25
Appalachian State,Georgia Southern,63,88,1,-25,2016-02-25
UC-Riverside,Hawaii,77,71,0,6,2016-02-25
Winthrop,High Point,85,87,1,-2,2016-02-25
Montana,Idaho State,90,77,0,13,2016-02-25
Indiana,Illinois,74,47,0,27,2016-02-25
South Dakota,IUPUI,85,82,0,3,2016-02-25
North Florida,Jacksonville,81,80,0,1,2016-02-25
Eastern Kentucky,Jacksonville State,76,54,0,22,2016-02-25
Kennesaw State,Lipscomb,73,57,0,16,2016-02-25
Central Connecticut,LIU-Brooklyn,74,80,1,-6,2016-02-25
Presbyterian,Longwood,74,73,0,1,2016-02-25
North Texas,Louisiana Tech,62,73,1,-11,2016-02-25
SMU,Memphis,69,62,0,7,2016-02-25
Western Kentucky,Middle Tennessee,78,72,0,6,2016-02-25
Fairleigh Dickinson,Mount St. Mary's,67,54,0,13,2016-02-25
Oral Roberts,Omaha,98,102,1,-4,2016-02-25
Liberty,UNC Asheville,56,73,1,-17,2016-02-25
Citadel,UNC Greensboro,63,92,1,-29,2016-02-25
Hofstra,UNC Wilmington,70,69,0,1,2016-02-25
Portland State,North Dakota,77,80,1,-3,2016-02-25
College of Charleston,Northeastern,57,58,1,-1,2016-02-25
Sacramento State,Northern Colorado,67,72,1,-5,2016-02-25
UTEP,Old Dominion,53,74,1,-21,2016-02-25
San Francisco,Pacific,70,79,1,-9,2016-02-25
Nebraska,Penn State,55,56,1,-1,2016-02-25
Robert Morris,Sacred Heart,73,63,0,10,2016-02-25
Santa Clara,Saint Mary's,50,75,1,-25,2016-02-25
Gonzaga,San Diego,82,60,0,22,2016-02-25
Providence,Seton Hall,52,70,1,-18,2016-02-25
Louisiana-Monroe,South Alabama,66,59,0,7,2016-02-25
NJIT,USC Upstate,71,72,1,-1,2016-02-25
North Dakota State,South Dakota State,59,71,1,-12,2016-02-25
UConn,South Florida,81,51,0,30,2016-02-25
Austin Peay,SIU-Edwardsville,80,75,0,5,2016-02-25
Rice,Southern Miss,76,74,0,2,2016-02-25
Bryant,St. Francis (NY),72,79,1,-7,2016-02-25
USC,Stanford,64,84,1,-20,2016-02-25
Florida Gulf Coast,Stetson,73,80,1,-7,2016-02-25
Tennessee State,UT-Martin,56,72,1,-16,2016-02-25
Morehead State,Tennessee Tech,69,59,0,10,2016-02-25
James Madison,Towson,67,69,1,-2,2016-02-25
Louisiana,Troy,73,63,0,10,2016-02-25
Arizona State,Utah,46,81,1,-35,2016-02-25
Mercer,VMI,82,91,1,-9,2016-02-25
Saint Francis (PA),Wagner,54,69,1,-15,2016-02-25
Montana State,Weber State,60,68,1,-8,2016-02-25
Wofford,Western Carolina,48,53,1,-5,2016-02-25
Purdue-Fort Wayne,Western Illinois,87,75,0,12,2016-02-25
Wright State,Youngstown State,87,81,0,6,2016-02-25
Bowling Green State,Akron,54,89,1,-35,2016-02-26
Dartmouth,Brown,83,84,1,-1,2016-02-26
UIC,Green Bay,69,85,1,-16,2016-02-26
Iona,Manhattan,86,73,0,13,2016-02-26
Quinnipiac,Marist,77,91,1,-14,2016-02-26
Valparaiso,Milwaukee,80,76,0,4,2016-02-26
Rider,Monmouth,58,79,1,-21,2016-02-26
Detroit,Oakland,97,108,1,-11,2016-02-26
Cornell,Penn,67,79,1,-12,2016-02-26
Columbia,Princeton,83,88,1,-5,2016-02-26
Harvard,Yale,50,59,1,-9,2016-02-26
New Orleans,Abilene Christian,84,87,1,-3,2016-02-27
Auburn,Alabama,57,65,1,-8,2016-02-27
Western Kentucky,Alabama-Birmingham,67,71,1,-4,2016-02-27
Hartford,Albany (NY),59,75,1,-16,2016-02-27
Southern,Alcorn State,56,70,1,-14,2016-02-27
Loyola (MD),American,66,67,1,-1,2016-02-27
Texas State,Little Rock,68,73,1,-5,2016-02-27
Texas-Arlington,Arkansas State,79,75,0,4,2016-02-27
Lehigh,Army,82,72,0,10,2016-02-27
Southeast Missouri State,Austin Peay,75,83,1,-8,2016-02-27
Eastern Michigan,Ball State,79,115,1,-36,2016-02-27
North Carolina Central,Bethune-Cookman,61,69,1,-8,2016-02-27
Maine,Binghamton,66,78,1,-12,2016-02-27
Georgia Tech,Boston College,76,71,0,5,2016-02-27
Holy Cross,Boston University,68,83,1,-15,2016-02-27
Gonzaga,BYU,71,68,0,3,2016-02-27
Harvard,Brown,61,52,0,9,2016-02-27
Grand Canyon,Cal State Bakersfield,62,77,1,-15,2016-02-27
UCSB,Cal State Fullerton,80,62,0,18,2016-02-27
UC-Irvine,UC-Davis,62,61,0,1,2016-02-27
Winthrop,Campbell,87,71,0,16,2016-02-27
Fairleigh Dickinson,Central Connecticut,81,75,0,6,2016-02-27
UTEP,Charlotte,78,88,1,-10,2016-02-27
Samford,Chattanooga,66,77,1,-11,2016-02-27
Wright State,Cleveland State,55,51,0,4,2016-02-27
Morgan State,Coppin State,74,72,0,2,2016-02-27
Rhode Island,Dayton,75,66,0,9,2016-02-27
Elon,Delaware,77,59,0,18,2016-02-27
North Dakota State,Denver,59,70,1,-11,2016-02-27
Loyola (IL),Drake,59,69,1,-10,2016-02-27
Northeastern,Drexel,61,59,0,2,2016-02-27
Richmond,Duquesne,83,67,0,16,2016-02-27
Cincinnati,East Carolina,65,56,0,9,2016-02-27
Wofford,ETSU,66,71,1,-5,2016-02-27
Northern Iowa,Evansville,54,52,0,2,2016-02-27
North Carolina A&T,Florida A&M,77,70,0,7,2016-02-27
Florida International,Florida Atlantic,71,63,0,8,2016-02-27
Notre Dame,Florida State,56,77,1,-21,2016-02-27
Davidson,Fordham,82,91,1,-9,2016-02-27
VCU,George Washington,69,65,0,4,2016-02-27
Butler,Georgetown,90,87,0,3,2016-02-27
Ole Miss,Georgia,66,80,1,-14,2016-02-27
Appalachian State,Georgia State,70,83,1,-13,2016-02-27
Arkansas-Pine Bluff,Grambling,53,51,0,2,2016-02-27
Howard,Hampton,67,68,1,-1,2016-02-27
Cal State Northridge,Hawaii,78,89,1,-11,2016-02-27
College of Charleston,Hofstra,63,72,1,-9,2016-02-27
Eastern Washington,Idaho,62,66,1,-4,2016-02-27
Montana State,Idaho State,69,76,1,-7,2016-02-27
Lamar,Incarnate Word,70,89,1,-19,2016-02-27
Bradley,Indiana State,58,77,1,-19,2016-02-27
Kansas State,Iowa State,61,80,1,-19,2016-02-27
Purdue-Fort Wayne,IUPUI,77,80,1,-3,2016-02-27
Mississippi Valley State,Jackson State,49,60,1,-11,2016-02-27
Morehead State,Jacksonville State,82,71,0,11,2016-02-27
William & Mary,James Madison,65,71,1,-6,2016-02-27
Texas Tech,Kansas,58,67,1,-9,2016-02-27
George Mason,La Salle,68,76,1,-8,2016-02-27
Colgate,Lafayette,77,79,1,-2,2016-02-27
Gardner-Webb,Liberty,81,86,1,-5,2016-02-27
UC-Riverside,Long Beach State,55,66,1,-11,2016-02-27
Bryant,LIU-Brooklyn,88,83,0,5,2016-02-27
Florida,LSU,91,96,1,-5,2016-02-27
Rice,Louisiana Tech,69,88,1,-19,2016-02-27
Pepperdine,Loyola Marymount,83,90,1,-7,2016-02-27
Villanova,Marquette,89,79,0,10,2016-02-27
Delaware State,Maryland-Eastern Shore,65,74,1,-9,2016-02-27
Nicholls State,McNeese State,69,71,1,-2,2016-02-27
Louisville,Miami (FL),65,73,1,-8,2016-02-27
Kent State,Miami (OH),65,74,1,-9,2016-02-27
Marshall,Middle Tennessee,74,83,1,-9,2016-02-27
South Carolina,Mississippi State,58,68,1,-10,2016-02-27
Texas A&M,Missouri,84,69,0,15,2016-02-27
New Mexico State,UMKC,62,61,0,1,2016-02-27
UT-Martin,Murray State,55,79,1,-24,2016-02-27
Bucknell,Navy,77,73,0,4,2016-02-27
Wyoming,UNLV,74,79,1,-5,2016-02-27
UMBC,New Hampshire,69,78,1,-9,2016-02-27
Fresno State,New Mexico,92,82,0,10,2016-02-27
Coastal Carolina,UNC Asheville,81,79,0,2,2016-02-27
Towson,UNC Wilmington,68,74,1,-6,2016-02-27
Sacramento State,North Dakota,71,97,1,-26,2016-02-27
Southern Utah,Northern Arizona,69,59,0,10,2016-02-27
Portland State,Northern Colorado,89,86,0,3,2016-02-27
Western Michigan,Northern Illinois,67,76,1,-9,2016-02-27
Rutgers,Northwestern,59,98,1,-39,2016-02-27
Buffalo,Ohio,96,103,1,-7,2016-02-27
West Virginia,Oklahoma State,70,56,0,14,2016-02-27
UTSA,Old Dominion,56,78,1,-22,2016-02-27
Columbia,Penn,93,65,0,28,2016-02-27
Alabama State,Prairie View,73,68,0,5,2016-02-27
High Point,Presbyterian,80,60,0,20,2016-02-27
Cornell,Princeton,60,74,1,-14,2016-02-27
DePaul,Providence,66,87,1,-21,2016-02-27
Maryland,Purdue,79,83,1,-4,2016-02-27
Longwood,Radford,92,81,0,11,2016-02-27
Saint Francis (PA),Sacred Heart,78,88,1,-10,2016-02-27
Fairfield,St. Peter's,68,72,1,-4,2016-02-27
Texas A&M-Corpus Christi,Sam Houston State,75,70,0,5,2016-02-27
Portland,San Diego,76,85,1,-9,2016-02-27
Boise State,San Diego State,66,63,0,3,2016-02-27
Saint Mary's,San Francisco,84,72,0,12,2016-02-27
Pacific,Santa Clara,65,69,1,-4,2016-02-27
South Carolina State,Savannah State,64,76,1,-12,2016-02-27
Utah Valley,Seattle,69,72,1,-3,2016-02-27
Louisiana,South Alabama,70,83,1,-13,2016-02-27
Oral Roberts,South Dakota State,65,73,1,-8,2016-02-27
Central Arkansas,Southeastern Louisiana,56,75,1,-19,2016-02-27
Missouri State,Southern Illinois,68,78,1,-10,2016-02-27
North Texas,Southern Miss,70,81,1,-11,2016-02-27
UMass,St. Bonaventure,83,85,1,-2,2016-02-27
Mount St. Mary's,St. Francis (NY),49,55,1,-6,2016-02-27
UCLA,Stanford,70,79,1,-9,2016-02-27
Houston Baptist,Stephen F. Austin,54,82,1,-28,2016-02-27
Vermont,Stony Brook,76,62,0,14,2016-02-27
NC State,Syracuse,66,75,1,-9,2016-02-27
UCF,Temple,61,63,1,-2,2016-02-27
Arkansas,Tennessee,75,65,0,10,2016-02-27
Eastern Kentucky,Tennessee Tech,82,92,1,-10,2016-02-27
Oklahoma,Texas,63,76,1,-13,2016-02-27
Baylor,TCU,86,71,0,15,2016-02-27
Alabama A&M,Texas Southern,54,77,1,-23,2016-02-27
Central Michigan,Toledo,76,74,0,2,2016-02-27
Louisiana-Monroe,Troy,66,51,0,15,2016-02-27
Arizona,Utah,64,70,1,-6,2016-02-27
San Jose State,Utah State,70,88,1,-18,2016-02-27
Kentucky,Vanderbilt,62,74,1,-12,2016-02-27
UNC,Virginia,74,79,1,-5,2016-02-27
Citadel,VMI,95,111,1,-16,2016-02-27
Robert Morris,Wagner,54,62,1,-8,2016-02-27
Montana,Weber State,54,60,1,-6,2016-02-27
Furman,Western Carolina,62,73,1,-11,2016-02-27
South Dakota,Western Illinois,76,90,1,-14,2016-02-27
Illinois State,Wichita State,58,74,1,-16,2016-02-27
Dartmouth,Yale,71,76,1,-5,2016-02-27
Northern Kentucky,Youngstown State,75,94,1,-19,2016-02-27
USC,California,65,87,1,-22,2016-02-28
Texas-Rio Grande Valley,Chicago State,89,79,0,10,2016-02-28
Arizona State,Colorado,69,79,1,-10,2016-02-28
Houston,UConn,75,68,0,7,2016-02-28
St. John's (NY),Creighton,59,100,1,-41,2016-02-28
Valparaiso,Green Bay,70,68,0,2,2016-02-28
Minnesota,Illinois,71,84,1,-13,2016-02-28
Canisius,Iona,78,86,1,-8,2016-02-28
Tulsa,Memphis,82,92,1,-10,2016-02-28
Penn State,Michigan State,57,88,1,-31,2016-02-28
UIC,Milwaukee,85,98,1,-13,2016-02-28
Niagara,Monmouth,68,77,1,-9,2016-02-28
Colorado State,Nevada,80,87,1,-7,2016-02-28
Mercer,UNC Greensboro,65,69,1,-4,2016-02-28
Iowa,Ohio State,64,68,1,-4,2016-02-28
Washington,Oregon,73,86,1,-13,2016-02-28
Washington State,Oregon State,49,69,1,-20,2016-02-28
Duke,Pitt,62,76,1,-14,2016-02-28
Manhattan,Rider,57,60,1,-3,2016-02-28
Saint Louis,St. Joseph's,63,77,1,-14,2016-02-28
Xavier,Seton Hall,81,90,1,-9,2016-02-28
Quinnipiac,Siena,65,80,1,-15,2016-02-28
Tulane,SMU,53,74,1,-21,2016-02-28
Belmont,Tennessee State,72,87,1,-15,2016-02-28
Virginia Tech,Wake Forest,81,74,0,7,2016-02-28
Michigan,Wisconsin,57,68,1,-11,2016-02-28
North Carolina A&T,Bethune-Cookman,52,62,1,-10,2016-02-29
Sam Houston State,Central Arkansas,83,73,0,10,2016-02-29
Mississippi Valley State,Grambling,58,57,0,1,2016-02-29
Delaware State,Hampton,65,79,1,-14,2016-02-29
Stephen F. Austin,Incarnate Word,84,58,0,26,2016-02-29
Oklahoma State,Iowa State,50,58,1,-8,2016-02-29
Arkansas-Pine Bluff,Jackson State,56,67,1,-11,2016-02-29
McNeese State,Lamar,77,74,0,3,2016-02-29
New Orleans,Nicholls State,76,80,1,-4,2016-02-29
Howard,Norfolk State,66,84,1,-18,2016-02-29
Syracuse,UNC,70,75,1,-5,2016-02-29
Savannah State,North Carolina Central,44,61,1,-17,2016-02-29
Alabama A&M,Prairie View,65,85,1,-20,2016-02-29
Northwestern State,Southeastern Louisiana,82,84,1,-2,2016-02-29
Kansas,Texas,86,56,0,30,2016-02-29
Alabama State,Texas Southern,86,96,1,-10,2016-02-29
Chattanooga,VMI,67,65,0,2,2016-02-29
Utah State,Air Force,78,65,0,13,2016-03-01
Ohio,Akron,76,91,1,-15,2016-03-01
Arkansas State,Little Rock,80,89,1,-9,2016-03-01
Texas A&M,Auburn,81,63,0,18,2016-03-01
Central Michigan,Ball State,65,57,0,8,2016-03-01
Miami (OH),Buffalo,67,59,0,8,2016-03-01
Virginia,Clemson,64,57,0,7,2016-03-01
Wake Forest,Duke,71,79,1,-8,2016-03-01
Northern Illinois,Eastern Michigan,71,75,1,-4,2016-03-01
Kentucky,Florida,88,79,0,9,2016-03-01
Kennesaw State,Florida Gulf Coast,64,74,1,-10,2016-03-01
George Mason,George Washington,52,74,1,-22,2016-03-01
Indiana,Iowa,81,78,0,3,2016-03-01
Lipscomb,Jacksonville,92,89,0,3,2016-03-01
Bowling Green State,Kent State,54,70,1,-16,2016-03-01
Missouri,LSU,71,80,1,-9,2016-03-01
Georgia Tech,Louisville,53,56,1,-3,2016-03-01
Holy Cross,Loyola (MD),72,67,0,5,2016-03-01
Georgetown,Marquette,87,88,1,-1,2016-03-01
Lafayette,Navy,70,78,1,-8,2016-03-01
Purdue,Nebraska,81,62,0,19,2016-03-01
San Diego State,New Mexico,83,56,0,27,2016-03-01
Stetson,NJIT,82,67,0,15,2016-03-01
USC Upstate,North Florida,69,92,1,-23,2016-03-01
Baylor,Oklahoma,71,73,1,-2,2016-03-01
Dayton,Richmond,85,84,0,1,2016-03-01
Grand Canyon,Saint Mary's,64,73,1,-9,2016-03-01
Texas State,Texas-Arlington,69,75,1,-6,2016-03-01
Tennessee,Vanderbilt,69,86,1,-17,2016-03-01
DePaul,Villanova,62,83,1,-21,2016-03-01
Toledo,Western Michigan,64,70,1,-6,2016-03-01
Arkansas,Alabama,62,61,0,1,2016-03-02
Hartford,Albany (NY),68,59,0,9,2016-03-02
Nevada,Boise State,57,76,1,-19,2016-03-02
Seton Hall,Butler,78,85,1,-7,2016-03-02
Long Beach State,Cal State Fullerton,75,73,0,2,2016-03-02
Tulane,UCF,65,73,1,-8,2016-03-02
Fordham,Duquesne,78,69,0,9,2016-03-02
Saint Francis (PA),Fairleigh Dickinson,72,74,1,-2,2016-03-02
Colorado State,Fresno State,73,87,1,-14,2016-03-02
TCU,Kansas State,54,79,1,-25,2016-03-02
Saint Louis,La Salle,68,76,1,-8,2016-03-02
Wisconsin,Minnesota,62,49,0,13,2016-03-02
Mississippi State,Ole Miss,78,86,1,-8,2016-03-02
Eastern Illinois,Murray State,62,78,1,-16,2016-03-02
Binghamton,New Hampshire,51,56,1,-5,2016-03-02
Boston College,NC State,72,73,1,-1,2016-03-02
Miami (FL),Notre Dame,68,50,0,18,2016-03-02
Creighton,Providence,66,70,1,-4,2016-03-02
Michigan State,Rutgers,97,66,0,31,2016-03-02
LIU-Brooklyn,Sacred Heart,84,76,0,8,2016-03-02
East Carolina,South Florida,52,39,0,13,2016-03-02
Oregon State,USC,70,81,1,-11,2016-03-02
St. Joseph's,St. Bonaventure,90,98,1,-8,2016-03-02
Mount St. Mary's,St. Francis (NY),60,51,0,9,2016-03-02
UMBC,Stony Brook,76,86,1,-10,2016-03-02
Austin Peay,Tennessee Tech,92,72,0,20,2016-03-02
Oregon,UCLA,76,68,0,8,2016-03-02
Maine,Vermont,82,99,1,-17,2016-03-02
Davidson,VCU,60,70,1,-10,2016-03-02
Pitt,Virginia Tech,61,65,1,-4,2016-03-02
Robert Morris,Wagner,50,59,1,-9,2016-03-02
Washington State,Washington,91,99,1,-8,2016-03-02
Texas Tech,West Virginia,68,90,1,-22,2016-03-02
San Jose State,Wyoming,78,81,1,-3,2016-03-02
Incarnate Word,Abilene Christian,74,70,0,4,2016-03-03
Grambling,Alabama A&M,65,58,0,7,2016-03-03
Jackson State,Alabama State,54,71,1,-17,2016-03-03
Prairie View,Alcorn State,64,81,1,-17,2016-03-03
Little Rock,Appalachian State,63,69,1,-6,2016-03-03
California,Arizona,61,64,1,-3,2016-03-03
Stanford,Arizona State,64,74,1,-10,2016-03-03
Colgate,Army,72,79,1,-7,2016-03-03
American,Boston University,69,64,0,5,2016-03-03
Holy Cross,Bucknell,77,72,0,5,2016-03-03
Hawaii,UC-Davis,67,65,0,2,2016-03-03
Cal Poly,UC-Irvine,62,72,1,-10,2016-03-03
UC-Riverside,UCSB,55,81,1,-26,2016-03-03
Niagara,Canisius,97,102,1,-5,2016-03-03
Nicholls State,Central Arkansas,68,64,0,4,2016-03-03
Coppin State,Delaware State,72,62,0,10,2016-03-03
Idaho State,Eastern Washington,75,71,0,4,2016-03-03
Middle Tennessee,Florida Atlantic,76,59,0,17,2016-03-03
Alabama-Birmingham,Florida International,77,60,0,17,2016-03-03
Campbell,Gardner-Webb,69,79,1,-10,2016-03-03
Cincinnati,Houston,56,69,1,-13,2016-03-03
Texas A&M-Corpus Christi,Houston Baptist,81,71,0,10,2016-03-03
Weber State,Idaho,58,62,1,-4,2016-03-03
Navy,Lehigh,63,65,1,-2,2016-03-03
Stetson,Lipscomb,96,75,0,21,2016-03-03
Charleston Southern,Longwood,69,75,1,-6,2016-03-03
Georgia State,Louisiana,72,69,0,3,2016-03-03
Georgia Southern,Louisiana-Monroe,76,83,1,-7,2016-03-03
Bradley,Loyola (IL),66,74,1,-8,2016-03-03
Marist,Manhattan,63,81,1,-18,2016-03-03
Louisiana Tech,Marshall,97,94,0,3,2016-03-03
Illinois,Maryland,55,81,1,-26,2016-03-03
Drake,Missouri State,67,69,1,-2,2016-03-03
North Dakota,Montana,46,71,1,-25,2016-03-03
Northern Colorado,Montana State,63,81,1,-18,2016-03-03
Murray State,Morehead State,66,75,1,-9,2016-03-03
Maryland-Eastern Shore,Morgan State,80,71,0,9,2016-03-03
Southeastern Louisiana,New Orleans,61,60,0,1,2016-03-03
Hampton,Norfolk State,63,83,1,-20,2016-03-03
North Carolina Central,North Carolina A&T,87,93,1,-6,2016-03-03
Florida Gulf Coast,North Florida,89,56,0,33,2016-03-03
Old Dominion,North Texas,76,70,0,6,2016-03-03
Stephen F. Austin,Northwestern State,95,55,0,40,2016-03-03
Northwestern,Penn State,71,61,0,10,2016-03-03
Northern Arizona,Portland State,81,89,1,-8,2016-03-03
Presbyterian,Radford,65,64,0,1,2016-03-03
UMass,Rhode Island,50,68,1,-18,2016-03-03
Charlotte,Rice,88,75,0,13,2016-03-03
Quinnipiac,Rider,57,60,1,-3,2016-03-03
Southern Utah,Sacramento State,63,69,1,-6,2016-03-03
Lamar,Sam Houston State,76,94,1,-18,2016-03-03
Florida A&M,Savannah State,40,52,1,-12,2016-03-03
Georgia,South Carolina,74,72,0,2,2016-03-03
Bethune-Cookman,South Carolina State,72,85,1,-13,2016-03-03
Texas Southern,Southern,79,84,1,-5,2016-03-03
UConn,SMU,54,80,1,-26,2016-03-03
Memphis,Temple,62,72,1,-10,2016-03-03
Austin Peay,Tennessee State,74,72,0,2,2016-03-03
South Alabama,Texas-Arlington,79,92,1,-13,2016-03-03
Troy,Texas State,57,78,1,-21,2016-03-03
Southern Miss,Western Kentucky,60,75,1,-15,2016-03-03
Kent State,Akron,60,74,1,-14,2016-03-04
Austin Peay,Belmont,97,96,0,1,2016-03-04
Buffalo,Bowling Green State,87,83,0,4,2016-03-04
Western Michigan,Central Michigan,91,82,0,9,2016-03-04
Gardner-Webb,Coastal Carolina,69,65,0,4,2016-03-04
Delaware,College of Charleston,63,67,1,-4,2016-03-04
Brown,Columbia,63,66,1,-3,2016-03-04
Yale,Cornell,88,64,0,24,2016-03-04
Penn,Dartmouth,64,72,1,-8,2016-03-04
Drexel,Elon,57,56,0,1,2016-03-04
Missouri State,Evansville,56,66,1,-10,2016-03-04
Princeton,Harvard,71,73,1,-2,2016-03-04
Longwood,High Point,78,89,1,-11,2016-03-04
Indiana State,Illinois State,65,57,0,8,2016-03-04
Canisius,Iona,55,73,1,-18,2016-03-04
San Diego,Loyola Marymount,61,64,1,-3,2016-03-04
Citadel,Mercer,69,71,1,-2,2016-03-04
Ohio,Miami (OH),67,65,0,2,2016-03-04
Rider,Monmouth,48,59,1,-11,2016-03-04
Liberty,UNC Asheville,49,80,1,-31,2016-03-04
Ball State,Northern Illinois,69,80,1,-11,2016-03-04
Southern Illinois,Northern Iowa,60,66,1,-6,2016-03-04
Texas,Oklahoma State,62,50,0,12,2016-03-04
VMI,Samford,85,92,1,-7,2016-03-04
Morehead State,UT-Martin,70,83,1,-13,2016-03-04
Eastern Michigan,Toledo,79,75,0,4,2016-03-04
Loyola (IL),Wichita State,58,66,1,-8,2016-03-04
Presbyterian,Winthrop,53,67,1,-14,2016-03-04
Texas A&M-Corpus Christi,Abilene Christian,74,69,0,5,2016-03-05
Jackson State,Alabama A&M,51,54,1,-3,2016-03-05
Grambling,Alabama State,58,59,1,-1,2016-03-05
Texas Southern,Alcorn State,76,66,0,10,2016-03-05
Arkansas State,Appalachian State,73,80,1,-7,2016-03-05
Stanford,Arizona,62,94,1,-32,2016-03-05
California,Arizona State,68,65,0,3,2016-03-05
South Carolina,Arkansas,76,61,0,15,2016-03-05
Mississippi Valley State,Arkansas-Pine Bluff,71,78,1,-7,2016-03-05
West Virginia,Baylor,69,58,0,11,2016-03-05
Clemson,Boston College,66,50,0,16,2016-03-05
Santa Clara,BYU,60,72,1,-12,2016-03-05
Marquette,Butler,74,95,1,-21,2016-03-05
Seattle,Cal State Bakersfield,71,93,1,-22,2016-03-05
UC-Davis,Cal State Northridge,87,83,0,4,2016-03-05
UC-Irvine,UC-Riverside,76,66,0,10,2016-03-05
Cal Poly,UCSB,50,69,1,-19,2016-03-05
McNeese State,Central Arkansas,85,77,0,8,2016-03-05
Samford,Chattanooga,54,59,1,-5,2016-03-05
UMKC,Chicago State,82,53,0,29,2016-03-05
Air Force,Colorado State,73,87,1,-14,2016-03-05
Yale,Columbia,71,55,0,16,2016-03-05
Brown,Cornell,71,75,1,-4,2016-03-05
Princeton,Dartmouth,84,65,0,19,2016-03-05
George Washington,Davidson,80,87,1,-7,2016-03-05
VCU,Dayton,67,68,1,-1,2016-03-05
Seton Hall,DePaul,80,66,0,14,2016-03-05
Youngstown State,Detroit,79,92,1,-13,2016-03-05
UNC,Duke,76,72,0,4,2016-03-05
Mercer,ETSU,65,81,1,-16,2016-03-05
Weber State,Eastern Washington,79,77,0,2,2016-03-05
Indiana State,Evansville,42,68,1,-26,2016-03-05
Mount St. Mary's,Fairleigh Dickinson,75,80,1,-5,2016-03-05
Alabama-Birmingham,Florida Atlantic,73,70,0,3,2016-03-05
Middle Tennessee,Florida International,61,58,0,3,2016-03-05
Syracuse,Florida State,73,78,1,-5,2016-03-05
Rhode Island,Fordham,61,64,1,-3,2016-03-05
UNC Greensboro,Furman,64,80,1,-16,2016-03-05
Richmond,George Mason,73,83,1,-10,2016-03-05
Alabama,Georgia,63,70,1,-7,2016-03-05
Pitt,Georgia Tech,59,63,1,-4,2016-03-05
Portland,Gonzaga,67,92,1,-25,2016-03-05
Cleveland State,Green Bay,53,65,1,-12,2016-03-05
Penn,Harvard,56,74,1,-18,2016-03-05
UNC Asheville,High Point,80,69,0,11,2016-03-05
Drexel,Hofstra,67,80,1,-13,2016-03-05
Idaho State,Idaho,68,82,1,-14,2016-03-05
Houston Baptist,Incarnate Word,86,97,1,-11,2016-03-05
South Dakota,Purdue-Fort Wayne,70,86,1,-16,2016-03-05
William & Mary,James Madison,79,64,0,15,2016-03-05
Iowa State,Kansas,78,85,1,-7,2016-03-05
LSU,Kentucky,77,94,1,-17,2016-03-05
Hawaii,Long Beach State,72,74,1,-2,2016-03-05
Georgia Southern,Louisiana,78,87,1,-9,2016-03-05
Georgia State,Louisiana-Monroe,78,91,1,-13,2016-03-05
Southern Miss,Marshall,106,108,1,-2,2016-03-05
La Salle,UMass,52,69,1,-17,2016-03-05
Iowa,Michigan,71,61,0,10,2016-03-05
Ohio State,Michigan State,76,91,1,-15,2016-03-05
Northern Kentucky,Milwaukee,69,86,1,-17,2016-03-05
Auburn,Mississippi State,66,79,1,-13,2016-03-05
Florida,Missouri,82,72,0,10,2016-03-05
Northern Colorado,Montana,78,72,0,6,2016-03-05
North Dakota,Montana State,82,89,1,-7,2016-03-05
New Mexico,Nevada,71,66,0,5,2016-03-05
Northwestern State,New Orleans,86,97,1,-11,2016-03-05
Southeastern Louisiana,Nicholls State,45,64,1,-19,2016-03-05
College of Charleston,UNC Wilmington,64,66,1,-2,2016-03-05
Charlotte,North Texas,77,80,1,-3,2016-03-05
NC State,Notre Dame,75,89,1,-14,2016-03-05
San Francisco,Pepperdine,86,90,1,-4,2016-03-05
Southern Utah,Portland State,86,88,1,-2,2016-03-05
Old Dominion,Rice,74,67,0,7,2016-03-05
Minnesota,Rutgers,52,75,1,-23,2016-03-05
Northern Arizona,Sacramento State,51,64,1,-13,2016-03-05
Duquesne,St. Joseph's,78,70,0,8,2016-03-05
St. Bonaventure,Saint Louis,76,67,0,9,2016-03-05
Loyola Marymount,Saint Mary's,48,60,1,-12,2016-03-05
Fairfield,St. Peter's,64,55,0,9,2016-03-05
Stephen F. Austin,Sam Houston State,85,64,0,21,2016-03-05
UNLV,San Diego State,56,92,1,-36,2016-03-05
Boise State,San Jose State,63,68,1,-5,2016-03-05
Manhattan,Siena,76,89,1,-13,2016-03-05
Oral Roberts,South Dakota State,70,73,1,-3,2016-03-05
Prairie View,Southern,79,71,0,8,2016-03-05
Oregon,USC,76,66,0,10,2016-03-05
Providence,St. John's (NY),90,76,0,14,2016-03-05
Ole Miss,Tennessee,83,60,0,23,2016-03-05
Austin Peay,UT-Martin,83,73,0,10,2016-03-05
Vanderbilt,Texas A&M,67,76,1,-9,2016-03-05
Troy,Texas-Arlington,55,90,1,-35,2016-03-05
Oklahoma,TCU,75,67,0,8,2016-03-05
UTSA,UTEP,74,81,1,-7,2016-03-05
New Mexico State,Texas-Rio Grande Valley,83,44,0,39,2016-03-05
South Alabama,Texas State,57,68,1,-11,2016-03-05
Kansas State,Texas Tech,71,80,1,-9,2016-03-05
Northeastern,Towson,71,60,0,11,2016-03-05
South Florida,Tulsa,74,84,1,-10,2016-03-05
Oregon State,UCLA,86,82,0,4,2016-03-05
Colorado,Utah,55,57,1,-2,2016-03-05
Fresno State,Utah State,86,85,0,1,2016-03-05
Grand Canyon,Utah Valley,86,79,0,7,2016-03-05
Georgetown,Villanova,71,84,1,-13,2016-03-05
Louisville,Virginia,46,68,1,-22,2016-03-05
Miami (FL),Virginia Tech,62,77,1,-15,2016-03-05
LIU-Brooklyn,Wagner,65,81,1,-16,2016-03-05
Louisiana Tech,Western Kentucky,90,96,1,-6,2016-03-05
Northern Iowa,Wichita State,57,52,0,5,2016-03-05
Gardner-Webb,Winthrop,69,82,1,-13,2016-03-05
Western Carolina,Wofford,88,83,0,5,2016-03-05
UIC,Wright State,43,74,1,-31,2016-03-05
Creighton,Xavier,93,98,1,-5,2016-03-05
Holy Cross,Army,60,38,0,22,2016-03-06
Western Carolina,Chattanooga,69,73,1,-4,2016-03-06
SMU,Cincinnati,54,61,1,-7,2016-03-06
UCF,UConn,46,67,1,-21,2016-03-06
Memphis,East Carolina,83,53,0,30,2016-03-06
Furman,ETSU,76,84,1,-8,2016-03-06
Northern Iowa,Evansville,56,54,0,2,2016-03-06
Stetson,Florida Gulf Coast,78,80,1,-2,2016-03-06
Milwaukee,Green Bay,61,70,1,-9,2016-03-06
William & Mary,Hofstra,67,70,1,-3,2016-03-06
Maryland,Indiana,62,80,1,-18,2016-03-06
Siena,Iona,70,81,1,-11,2016-03-06
North Dakota State,IUPUI,60,45,0,15,2016-03-06
American,Lehigh,62,78,1,-16,2016-03-06
Fairfield,Monmouth,63,76,1,-13,2016-03-06
Denver,Omaha,78,70,0,8,2016-03-06
Northeastern,UNC Wilmington,70,73,1,-3,2016-03-06
Nebraska,Northwestern,54,65,1,-11,2016-03-06
Illinois,Penn State,79,86,1,-7,2016-03-06
Wisconsin,Purdue,80,91,1,-11,2016-03-06
Temple,Tulane,64,56,0,8,2016-03-06
UNC Asheville,Winthrop,77,68,0,9,2016-03-06
Detroit,Wright State,72,82,1,-10,2016-03-06
Miami (OH),Ball State,49,47,0,2,2016-03-07
ETSU,Chattanooga,67,73,1,-6,2016-03-07
Toledo,Eastern Michigan,60,69,1,-9,2016-03-07
BYU,Gonzaga,84,88,1,-4,2016-03-07
UNC Wilmington,Hofstra,80,73,0,7,2016-03-07
North Dakota State,Purdue-Fort Wayne,69,68,0,1,2016-03-07
Bowling Green State,Kent State,70,69,0,1,2016-03-07
Iona,Monmouth,79,76,0,3,2016-03-07
Coppin State,North Carolina A&T,98,91,0,7,2016-03-07
Western Michigan,Northern Illinois,50,56,1,-6,2016-03-07
Wright State,Oakland,59,55,0,4,2016-03-07
Pepperdine,Saint Mary's,66,81,1,-15,2016-03-07
Delaware State,Savannah State,58,63,1,-5,2016-03-07
Denver,South Dakota State,53,54,1,-1,2016-03-07
Hartford,Stony Brook,64,80,1,-16,2016-03-07
Green Bay,Valparaiso,99,92,0,7,2016-03-07
New Hampshire,Vermont,56,63,1,-7,2016-03-07
Arkansas-Pine Bluff,Alabama A&M,53,61,1,-8,2016-03-08
Northern Arizona,Eastern Washington,52,74,1,-22,2016-03-08
UTSA,Florida Atlantic,58,82,1,-24,2016-03-08
Boston College,Florida State,66,88,1,-22,2016-03-08
Morgan State,Maryland-Eastern Shore,65,58,0,7,2016-03-08
Grambling,Mississippi Valley State,73,87,1,-14,2016-03-08
Sacramento State,Montana State,79,75,0,4,2016-03-08
Howard,North Carolina Central,66,68,1,-2,2016-03-08
Wake Forest,NC State,72,75,1,-3,2016-03-08
Southern Utah,North Dakota,80,85,1,-5,2016-03-08
Northern Colorado,Portland State,67,74,1,-7,2016-03-08
Penn,Princeton,71,72,1,-1,2016-03-08
Gonzaga,Saint Mary's,85,75,0,10,2016-03-08
North Dakota State,South Dakota State,59,67,1,-8,2016-03-08
Fairleigh Dickinson,Wagner,87,79,0,8,2016-03-08
Green Bay,Wright State,78,69,0,9,2016-03-08
Mississippi Valley State,Alcorn State,64,61,0,3,2016-03-09
Rice,Charlotte,69,79,1,-10,2016-03-09
Georgia Tech,Clemson,88,85,0,3,2016-03-09
Washington State,Colorado,56,80,1,-24,2016-03-09
San Jose State,Colorado State,61,80,1,-19,2016-03-09
NC State,Duke,89,92,1,-3,2016-03-09
La Salle,Duquesne,88,73,0,15,2016-03-09
Saint Louis,George Mason,83,78,0,5,2016-03-09
DePaul,Georgetown,53,70,1,-17,2016-03-09
Morgan State,Hampton,81,83,1,-2,2016-03-09
Minnesota,Illinois,52,85,1,-33,2016-03-09
Oklahoma State,Kansas State,71,75,1,-4,2016-03-09
Holy Cross,Lehigh,59,56,0,3,2016-03-09
St. John's (NY),Marquette,93,101,1,-8,2016-03-09
Nicholls State,McNeese State,94,90,0,4,2016-03-09
Rutgers,Nebraska,72,89,1,-17,2016-03-09
Air Force,UNLV,102,108,1,-6,2016-03-09
North Carolina Central,Norfolk State,47,66,1,-19,2016-03-09
Florida Atlantic,Old Dominion,46,72,1,-26,2016-03-09
Arizona State,Oregon State,66,75,1,-9,2016-03-09
Syracuse,Pitt,71,72,1,-1,2016-03-09
New Orleans,Southeastern Louisiana,74,84,1,-10,2016-03-09
UCLA,USC,71,95,1,-24,2016-03-09
Auburn,Tennessee,59,97,1,-38,2016-03-09
Florida International,UTEP,77,85,1,-8,2016-03-09
Alabama A&M,Texas Southern,69,77,1,-8,2016-03-09
TCU,Texas Tech,67,62,0,5,2016-03-09
Florida State,Virginia Tech,85,96,1,-11,2016-03-09
Stanford,Washington,68,91,1,-23,2016-03-09
North Texas,Western Kentucky,76,84,1,-8,2016-03-09
Utah State,Wyoming,88,70,0,18,2016-03-09
Eastern Michigan,Akron,63,65,1,-2,2016-03-10
Western Kentucky,Alabama-Birmingham,88,77,0,11,2016-03-10
Colorado,Arizona,78,82,1,-4,2016-03-10
Savannah State,Bethune-Cookman,57,50,0,7,2016-03-10
Colorado State,Boise State,88,81,0,7,2016-03-10
Miami (OH),Buffalo,81,94,1,-13,2016-03-10
Chicago State,Cal State Bakersfield,57,79,1,-22,2016-03-10
Oregon State,California,68,76,1,-8,2016-03-10
Cal Poly,UC-Irvine,64,84,1,-20,2016-03-10
UC-Davis,UCSB,61,87,1,-26,2016-03-10
Tulane,UCF,65,63,0,2,2016-03-10
Bowling Green State,Central Michigan,62,59,0,3,2016-03-10
La Salle,Davidson,63,78,1,-15,2016-03-10
South Florida,East Carolina,71,66,0,5,2016-03-10
Arkansas,Florida,61,68,1,-7,2016-03-10
Richmond,Fordham,70,55,0,15,2016-03-10
UNLV,Fresno State,82,95,1,-13,2016-03-10
Saint Louis,George Washington,65,73,1,-8,2016-03-10
Mississippi State,Georgia,69,79,1,-10,2016-03-10
South Alabama,Georgia Southern,67,61,0,6,2016-03-10
Texas State,Georgia State,63,61,0,2,2016-03-10
Cal State Fullerton,Hawaii,44,75,1,-31,2016-03-10
Southeastern Louisiana,Houston Baptist,68,73,1,-5,2016-03-10
Eastern Washington,Idaho,73,77,1,-4,2016-03-10
North Dakota,Idaho State,83,49,0,34,2016-03-10
Illinois,Iowa,68,66,0,2,2016-03-10
Prairie View,Jackson State,51,69,1,-18,2016-03-10
Kansas State,Kansas,63,85,1,-22,2016-03-10
UC-Riverside,Long Beach State,74,82,1,-8,2016-03-10
Old Dominion,Louisiana Tech,68,52,0,16,2016-03-10
UTEP,Marshall,85,87,1,-2,2016-03-10
Virginia Tech,Miami (FL),82,88,1,-6,2016-03-10
Northwestern,Michigan,70,72,1,-2,2016-03-10
Charlotte,Middle Tennessee,61,79,1,-18,2016-03-10
Alabama,Ole Miss,81,73,0,8,2016-03-10
Sacramento State,Montana,53,70,1,-17,2016-03-10
Nevada,New Mexico,64,62,0,2,2016-03-10
Pitt,UNC,71,88,1,-17,2016-03-10
Duke,Notre Dame,79,84,1,-5,2016-03-10
Northern Illinois,Ohio,62,79,1,-17,2016-03-10
Penn State,Ohio State,75,79,1,-4,2016-03-10
Iowa State,Oklahoma,76,79,1,-3,2016-03-10
Washington,Oregon,77,83,1,-6,2016-03-10
Butler,Providence,60,74,1,-14,2016-03-10
UMass,Rhode Island,67,62,0,5,2016-03-10
Nicholls State,Sam Houston State,59,60,1,-1,2016-03-10
Utah State,San Diego State,65,71,1,-6,2016-03-10
Texas-Rio Grande Valley,Seattle,52,75,1,-23,2016-03-10
Creighton,Seton Hall,73,81,1,-8,2016-03-10
Coppin State,South Carolina State,80,90,1,-10,2016-03-10
Alabama State,Southern,63,83,1,-20,2016-03-10
Baylor,Texas,75,61,0,14,2016-03-10
USC,Utah,72,80,1,-8,2016-03-10
UMKC,Utah Valley,80,78,0,2,2016-03-10
Tennessee,Vanderbilt,67,65,0,2,2016-03-10
Georgetown,Villanova,67,81,1,-14,2016-03-10
Georgia Tech,Virginia,52,72,1,-20,2016-03-10
Portland State,Weber State,74,78,1,-4,2016-03-10
TCU,West Virginia,66,86,1,-20,2016-03-10
Nebraska,Wisconsin,70,58,0,12,2016-03-10
Marquette,Xavier,72,90,1,-18,2016-03-10
Bowling Green State,Akron,66,80,1,-14,2016-03-11
Seattle,Cal State Bakersfield,47,72,1,-25,2016-03-11
Long Beach State,UC-Irvine,77,72,0,5,2016-03-11
UConn,Cincinnati,104,97,0,7,2016-03-11
Richmond,Dayton,54,69,1,-15,2016-03-11
Colorado State,Fresno State,56,64,1,-8,2016-03-11
Savannah State,Hampton,55,89,1,-34,2016-03-11
UCSB,Hawaii,76,88,1,-12,2016-03-11
Tulane,Houston,72,69,0,3,2016-03-11
Michigan,Indiana,72,69,0,3,2016-03-11
Mississippi Valley State,Jackson State,68,74,1,-6,2016-03-11
Baylor,Kansas,66,70,1,-4,2016-03-11
Alabama,Kentucky,59,85,1,-26,2016-03-11
South Alabama,Louisiana,68,90,1,-22,2016-03-11
Tennessee,LSU,75,84,1,-9,2016-03-11
Nebraska,Maryland,86,97,1,-11,2016-03-11
Ohio State,Michigan State,54,81,1,-27,2016-03-11
Marshall,Middle Tennessee,90,99,1,-9,2016-03-11
Idaho,Montana,72,81,1,-9,2016-03-11
UMKC,New Mexico State,64,78,1,-14,2016-03-11
South Carolina State,Norfolk State,67,65,0,2,2016-03-11
Notre Dame,UNC,47,78,1,-31,2016-03-11
Buffalo,Ohio,88,74,0,14,2016-03-11
Western Kentucky,Old Dominion,77,89,1,-12,2016-03-11
Arizona,Oregon,89,95,1,-6,2016-03-11
Illinois,Purdue,58,89,1,-31,2016-03-11
George Washington,St. Joseph's,80,86,1,-6,2016-03-11
Nevada,San Diego State,55,67,1,-12,2016-03-11
Georgia,South Carolina,65,64,0,1,2016-03-11
Davidson,St. Bonaventure,90,86,0,4,2016-03-11
Houston Baptist,Stephen F. Austin,68,104,1,-36,2016-03-11
South Florida,Temple,62,79,1,-17,2016-03-11
Florida,Texas A&M,66,72,1,-6,2016-03-11
Sam Houston State,Texas A&M-Corpus Christi,76,79,1,-3,2016-03-11
Texas State,Texas-Arlington,63,72,1,-9,2016-03-11
Southern,Texas Southern,81,73,0,8,2016-03-11
Memphis,Tulsa,89,67,0,22,2016-03-11
California,Utah,78,82,1,-4,2016-03-11
Providence,Villanova,68,76,1,-8,2016-03-11
Miami (FL),Virginia,68,73,1,-5,2016-03-11
UMass,VCU,70,85,1,-15,2016-03-11
North Dakota,Weber State,78,83,1,-5,2016-03-11
Oklahoma,West Virginia,67,69,1,-2,2016-03-11
Seton Hall,Xavier,87,83,0,4,2016-03-11
Buffalo,Akron,64,61,0,3,2016-03-12
Louisiana,Little Rock,65,72,1,-7,2016-03-12
St. Joseph's,Dayton,82,79,0,3,2016-03-12
South Carolina State,Hampton,69,81,1,-12,2016-03-12
Long Beach State,Hawaii,60,64,1,-4,2016-03-12
Southern,Jackson State,54,53,0,1,2016-03-12
West Virginia,Kansas,71,81,1,-10,2016-03-12
Georgia,Kentucky,80,93,1,-13,2016-03-12
Texas-Arlington,Louisiana-Monroe,71,82,1,-11,2016-03-12
Tulane,Memphis,54,74,1,-20,2016-03-12
Maryland,Michigan State,61,64,1,-3,2016-03-12
Old Dominion,Middle Tennessee,53,55,1,-2,2016-03-12
Cal State Bakersfield,New Mexico State,57,54,0,3,2016-03-12
Virginia,UNC,57,61,1,-4,2016-03-12
Utah,Oregon,57,88,1,-31,2016-03-12
Michigan,Purdue,59,76,1,-17,2016-03-12
Fresno State,San Diego State,68,63,0,5,2016-03-12
Texas A&M-Corpus Christi,Stephen F. Austin,60,82,1,-22,2016-03-12
Vermont,Stony Brook,74,80,1,-6,2016-03-12
UConn,Temple,77,62,0,15,2016-03-12
LSU,Texas A&M,38,71,1,-33,2016-03-12
Seton Hall,Villanova,69,67,0,2,2016-03-12
Davidson,VCU,54,76,1,-22,2016-03-12
Montana,Weber State,59,62,1,-3,2016-03-12
Louisiana-Monroe,Little Rock,50,70,1,-20,2016-03-13
Memphis,UConn,58,72,1,-14,2016-03-13
Purdue,Michigan State,62,66,1,-4,2016-03-13
Kentucky,Texas A&M,82,77,0,5,2016-03-13
St. Joseph's,VCU,87,74,0,13,2016-03-13
South Carolina State,Grand Canyon,74,78,1,-4,2016-03-14
Jackson State,Sam Houston State,81,77,0,4,2016-03-14
Mercer,Coastal Carolina,57,65,1,-8,2016-03-15
Alabama,Creighton,54,72,1,-18,2016-03-15
Fairleigh Dickinson,Florida Gulf Coast,65,96,1,-31,2016-03-15
Davidson,Florida State,74,84,1,-10,2016-03-15
Louisiana-Monroe,Furman,57,58,1,-1,2016-03-15
Florida,North Florida,97,68,0,29,2016-03-15
Akron,Ohio State,63,72,1,-9,2016-03-15
New Mexico State,Saint Mary's,56,58,1,-2,2016-03-15
Purdue-Fort Wayne,San Diego State,55,79,1,-24,2016-03-15
Morehead State,Siena,84,80,0,4,2016-03-15
High Point,South Carolina,66,88,1,-22,2016-03-15
Ball State,Tennessee State,78,73,0,5,2016-03-15
Texas Southern,Valparaiso,73,84,1,-11,2016-03-15
Wichita State,Vanderbilt,70,50,0,20,2016-03-15
Long Beach State,Washington,102,107,1,-5,2016-03-15
Alabama-Birmingham,BYU,79,97,1,-18,2016-03-16
UT-Martin,Central Michigan,76,73,0,3,2016-03-16
Norfolk State,Columbia,54,86,1,-32,2016-03-16
Omaha,Duquesne,112,120,1,-8,2016-03-16
Pepperdine,Eastern Washington,72,79,1,-7,2016-03-16
New Hampshire,Fairfield,77,62,0,15,2016-03-16
Boston University,Fordham,69,66,0,3,2016-03-16
Hofstra,George Washington,80,82,1,-2,2016-03-16
Belmont,Georgia,84,93,1,-9,2016-03-16
Houston,Georgia Tech,62,81,1,-19,2016-03-16
Southern,Holy Cross,55,59,1,-4,2016-03-16
Texas A&M-Corpus Christi,Louisiana,72,96,1,-24,2016-03-16
Tulsa,Michigan,62,67,1,-5,2016-03-16
Bucknell,Monmouth,80,90,1,-10,2016-03-16
Montana,Nevada,75,79,1,-4,2016-03-16
Army,NJIT,65,79,1,-14,2016-03-16
Houston Baptist,UNC Greensboro,65,69,1,-4,2016-03-16
UC-Irvine,North Dakota,89,86,0,3,2016-03-16
Albany (NY),Ohio,90,94,1,-4,2016-03-16
Texas-Arlington,Savannah State,75,59,0,16,2016-03-16
Idaho,Seattle,63,68,1,-5,2016-03-16
Wagner,St. Bonaventure,79,75,0,4,2016-03-16
Western Carolina,Vermont,74,79,1,-5,2016-03-16
Princeton,Virginia Tech,81,86,1,-5,2016-03-16
Wichita State,Arizona,65,55,0,10,2016-03-17
Yale,Baylor,79,75,0,4,2016-03-17
UConn,Colorado,74,67,0,7,2016-03-17
UNC Wilmington,Duke,85,93,1,-8,2016-03-17
Jackson State,Grand Canyon,54,64,1,-10,2016-03-17
Chattanooga,Indiana,74,99,1,-25,2016-03-17
Iona,Iowa State,81,94,1,-13,2016-03-17
Austin Peay,Kansas,79,105,1,-26,2016-03-17
Stony Brook,Kentucky,57,85,1,-28,2016-03-17
Buffalo,Miami (FL),72,79,1,-7,2016-03-17
Florida Gulf Coast,UNC,67,83,1,-16,2016-03-17
Little Rock,Purdue,85,83,0,2,2016-03-17
Gonzaga,Seton Hall,68,52,0,16,2016-03-17
Providence,USC,70,69,0,1,2016-03-17
Butler,Texas Tech,71,61,0,10,2016-03-17
Fresno State,Utah,69,80,1,-11,2016-03-17
Florida State,Valparaiso,69,81,1,-12,2016-03-17
Hampton,Virginia,45,81,1,-36,2016-03-17
Virginia Tech,BYU,77,80,1,-3,2016-03-18
Hawaii,California,77,66,0,11,2016-03-18
Syracuse,Dayton,70,51,0,19,2016-03-18
Temple,Iowa,70,72,1,-2,2016-03-18
South Dakota State,Maryland,74,79,1,-5,2016-03-18
Middle Tennessee,Michigan State,90,81,0,9,2016-03-18
Michigan,Notre Dame,63,70,1,-7,2016-03-18
Cal State Bakersfield,Oklahoma,68,82,1,-14,2016-03-18
Holy Cross,Oregon,52,91,1,-39,2016-03-18
VCU,Oregon State,75,67,0,8,2016-03-18
Cincinnati,St. Joseph's,76,78,1,-2,2016-03-18
Northern Iowa,Texas,75,72,0,3,2016-03-18
Green Bay,Texas A&M,65,92,1,-27,2016-03-18
UNC Asheville,Villanova,56,86,1,-30,2016-03-18
Stephen F. Austin,West Virginia,70,56,0,14,2016-03-18
Pitt,Wisconsin,43,47,1,-4,2016-03-18
Weber State,Xavier,53,71,1,-18,2016-03-18
New Hampshire,Coastal Carolina,62,71,1,-9,2016-03-19
Wagner,Creighton,54,87,1,-33,2016-03-19
Yale,Duke,64,71,1,-7,2016-03-19
Louisiana,Furman,80,72,0,8,2016-03-19
Little Rock,Iowa State,61,78,1,-17,2016-03-19
UConn,Kansas,61,73,1,-12,2016-03-19
Indiana,Kentucky,73,67,0,6,2016-03-19
Wichita State,Miami (FL),57,65,1,-8,2016-03-19
Providence,UNC,66,85,1,-19,2016-03-19
Gonzaga,Utah,82,59,0,23,2016-03-19
Butler,Virginia,69,77,1,-8,2016-03-19
UT-Martin,Ball State,80,83,1,-3,2016-03-20
Hawaii,Maryland,60,73,1,-13,2016-03-20
Stephen F. Austin,Notre Dame,75,76,1,-1,2016-03-20
Florida,Ohio State,74,66,0,8,2016-03-20
VCU,Oklahoma,81,85,1,-4,2016-03-20
St. Joseph's,Oregon,64,69,1,-5,2016-03-20
Georgia,Saint Mary's,65,77,1,-12,2016-03-20
Middle Tennessee,Syracuse,50,75,1,-25,2016-03-20
Northern Iowa,Texas A&M,88,92,1,-4,2016-03-20
Iowa,Villanova,68,87,1,-19,2016-03-20
Wisconsin,Xavier,66,63,0,3,2016-03-20
George Washington,Monmouth,87,71,0,16,2016-03-21
Duquesne,Morehead State,72,82,1,-10,2016-03-21
Eastern Washington,Nevada,70,85,1,-15,2016-03-21
Boston University,NJIT,72,83,1,-11,2016-03-21
UNC Greensboro,Ohio,67,72,1,-5,2016-03-21
Washington,San Diego State,78,93,1,-15,2016-03-21
Vermont,Seattle,73,54,0,19,2016-03-21
Georgia Tech,South Carolina,83,66,0,17,2016-03-21
Creighton,BYU,82,88,1,-6,2016-03-22
Saint Mary's,Valparaiso,44,60,1,-16,2016-03-22
Grand Canyon,Coastal Carolina,58,60,1,-2,2016-03-23
Ball State,Columbia,67,69,1,-2,2016-03-23
Florida,George Washington,77,82,1,-5,2016-03-23
UC-Irvine,Louisiana,67,66,0,1,2016-03-23
Vermont,Nevada,72,86,1,-14,2016-03-23
Morehead State,Ohio,77,72,0,5,2016-03-23
Georgia Tech,San Diego State,56,72,1,-16,2016-03-23
Maryland,Kansas,63,79,1,-16,2016-03-24
Texas-Arlington,NJIT,60,63,1,-3,2016-03-24
Texas A&M,Oklahoma,63,77,1,-14,2016-03-24
Duke,Oregon,68,82,1,-14,2016-03-24
Miami (FL),Villanova,69,92,1,-23,2016-03-24
Indiana,UNC,86,101,1,-15,2016-03-25
Wisconsin,Notre Dame,56,61,1,-5,2016-03-25
Gonzaga,Syracuse,60,63,1,-3,2016-03-25
Iowa State,Virginia,71,84,1,-13,2016-03-25
Villanova,Kansas,64,59,0,5,2016-03-26
Oklahoma,Oregon,80,68,0,12,2016-03-26
UC-Irvine,Coastal Carolina,66,47,0,19,2016-03-27
NJIT,Columbia,65,80,1,-15,2016-03-27
Notre Dame,UNC,74,88,1,-14,2016-03-27
Syracuse,Virginia,68,62,0,6,2016-03-27
Northern Illinois,UCSB,63,70,1,-7,2016-03-28
Louisiana Tech,ETSU,83,88,1,-5,2016-03-28
Nevada,Morehead State,83,86,1,-3,2016-03-28
Tennessee Tech,Old Dominion,59,75,1,-16,2016-03-28
Oakland,Towson,90,72,0,18,2016-03-28
UC-Irvine,Columbia,67,73,1,-6,2016-03-29
ETSU,Oakland,81,104,1,-23,2016-03-29
UCSB,Old Dominion,49,64,1,-15,2016-03-29
George Washington,San Diego State,65,46,0,19,2016-03-29
BYU,Valparaiso,70,72,1,-2,2016-03-29
Morehead State,Nevada,68,77,1,-9,2016-03-30
Old Dominion,Oakland,68,67,0,1,2016-03-30
George Washington,Valparaiso,76,60,0,16,2016-03-31
Morehead State,Nevada,82,85,1,-3,2016-04-01
Syracuse,UNC,66,83,1,-17,2016-04-02
Villanova,Oklahoma,95,51,0,44,2016-04-02
Villanova,UNC,77,74,0,3,2016-04-04
