Road,Home,Road_score,Home_score,Home_w,margin,Date
Spring Arbor,Eastern Michigan,60,92,1,-32,2017-11-10
Savannah State,Cincinnati,77,107,1,-30,2017-11-10
Trevecca Nazarene,Middle Tennessee,52,104,1,-52,2017-11-10
Webber,Stetson,89,98,1,-9,2017-11-10
Central Arkansas,Baylor,66,107,1,-41,2017-11-10
Millsaps,Jackson State,46,84,1,-38,2017-11-10
Wheelock,New Hampshire,39,95,1,-56,2017-11-10
Lamar,Tulsa,74,67,0,7,2017-11-10
Oglethorpe,Citadel,73,109,1,-36,2017-11-10
Siena Heights,Central Michigan,48,108,1,-60,2017-11-10
Walla Walla,Eastern Washington,61,82,1,-21,2017-11-10
Campbell,Penn State,75,86,1,-11,2017-11-10
Bridgewater (VA),James Madison,50,80,1,-30,2017-11-10
Memphis,Alabama,70,82,1,-12,2017-11-10
Alabama State,Mississippi State,68,96,1,-28,2017-11-10
Eureka,North Texas,65,122,1,-57,2017-11-10
Holy Cross,Sacred Heart,69,64,0,5,2017-11-10
Fairleigh Dickinson,Seton Hall,68,90,1,-22,2017-11-10
Detroit,Virginia Tech,79,111,1,-32,2017-11-10
Texas A&M,West Virginia,88,65,0,23,2017-11-10
Iona,Albany (NY),67,69,1,-2,2017-11-10
Morgan State,Binghamton,59,76,1,-17,2017-11-10
Maine,Boston College,65,85,1,-20,2017-11-10
Northeastern,Boston University,65,59,0,6,2017-11-10
Kennesaw State,Butler,64,82,1,-18,2017-11-10
Methodist,Charlotte,76,116,1,-40,2017-11-10
Western Carolina,Clemson,57,85,1,-28,2017-11-10
Piedmont,Coastal Carolina,50,102,1,-52,2017-11-10
Siena,College of Charleston,60,68,1,-8,2017-11-10
Colgate,UConn,58,70,1,-12,2017-11-10
Charleston Southern,Davidson,62,110,1,-48,2017-11-10
Ball State,Dayton,77,78,1,-1,2017-11-10
Cairn,Delaware State,50,71,1,-21,2017-11-10
Bowling Green State,Drexel,78,69,0,9,2017-11-10
Elon,Duke,68,97,1,-29,2017-11-10
Florida Memorial,Florida International,47,70,1,-23,2017-11-10
Miami (OH),Fordham,55,54,0,1,2017-11-10
Bob Jones University,Furman,48,101,1,-53,2017-11-10
Lafayette,George Mason,65,67,1,-2,2017-11-10
Howard,George Washington,75,84,1,-9,2017-11-10
Bryant,Georgia,54,79,1,-25,2017-11-10
Carver Bible,Georgia State,50,90,1,-40,2017-11-10
MIT,Harvard,64,73,1,-9,2017-11-10
Army,Hofstra,74,77,1,-3,2017-11-10
Indiana State,Indiana,90,69,0,21,2017-11-10
Utah Valley,Kentucky,63,73,1,-10,2017-11-10
Clarks Summit,Liberty,42,87,1,-45,2017-11-10
Emory,Lipscomb,83,98,1,-15,2017-11-10
Texas-Tyler,Louisiana Tech,71,112,1,-41,2017-11-10
UMass-Lowell,UMass,69,74,1,-5,2017-11-10
Northern Iowa,UNC,69,86,1,-17,2017-11-10
VMI,NC State,67,102,1,-35,2017-11-10
ETSU,Northern Kentucky,63,81,1,-18,2017-11-10
Purdue-Fort Wayne,Oakland,71,85,1,-14,2017-11-10
Robert Morris,Ohio State,64,95,1,-31,2017-11-10
Towson,Old Dominion,54,57,1,-3,2017-11-10
Houston Baptist,Providence,55,84,1,-29,2017-11-10
Georgia Southwestern,Radford,63,72,1,-9,2017-11-10
UNC Asheville,Rhode Island,60,84,1,-24,2017-11-10
Delaware,Richmond,76,63,0,13,2017-11-10
CCNY,Rutgers,38,94,1,-56,2017-11-10
Missouri Baptist University,Southeast Missouri State,69,81,1,-12,2017-11-10
New Orleans,St. John's (NY),61,77,1,-16,2017-11-10
Cal Poly,Stanford,62,78,1,-16,2017-11-10
Maryland,Stony Brook,76,61,0,15,2017-11-10
Cornell,Syracuse,45,77,1,-32,2017-11-10
Presbyterian,Tennessee,53,88,1,-35,2017-11-10
UNC Greensboro,Virginia,48,60,1,-12,2017-11-10
Grambling,VCU,65,94,1,-29,2017-11-10
Georgia Southern,Wake Forest,85,83,0,2,2017-11-10
Southern Illinois,Winthrop,81,66,0,15,2017-11-10
South Carolina State,Wisconsin,50,85,1,-35,2017-11-10
South Carolina,Wofford,73,52,0,21,2017-11-10
Morehead State,Xavier,49,101,1,-52,2017-11-10
Hillsdale,Abilene Christian,68,86,1,-18,2017-11-10
Jacksonville,Alabama-Birmingham,67,96,1,-29,2017-11-10
Northern Arizona,Arizona,67,101,1,-34,2017-11-10
Samford,Arkansas,56,95,1,-39,2017-11-10
Norfolk State,Auburn,74,102,1,-28,2017-11-10
Johnson University,Bethune-Cookman,66,108,1,-42,2017-11-10
Mercer,UCF,79,88,1,-9,2017-11-10
Northern Colorado,Colorado,51,66,1,-15,2017-11-10
Arkansas State,Evansville,63,77,1,-14,2017-11-10
UC-Santa Cruz,Fresno State,65,96,1,-31,2017-11-10
Central Connecticut,Hartford,84,85,1,-1,2017-11-10
William & Mary,High Point,66,100,1,-34,2017-11-10
McNeese State,Houston,53,81,1,-28,2017-11-10
Southern,Illinois,55,102,1,-47,2017-11-10
North Carolina Central,UIC,55,65,1,-10,2017-11-10
Southwestern,Incarnate Word,71,87,1,-16,2017-11-10
Tennessee Wesleyan,Jacksonville State,42,100,1,-58,2017-11-10
Alcorn State,LSU,59,99,1,-40,2017-11-10
Wright State,Loyola (IL),80,84,1,-4,2017-11-10
UT-Martin,Marshall,91,102,1,-11,2017-11-10
Valley Forge,Maryland-Eastern Shore,69,95,1,-26,2017-11-10
Gardner-Webb,Miami (FL),45,77,1,-32,2017-11-10
North Florida,Michigan State,66,98,1,-32,2017-11-10
Wisconsin-La Crosse,Milwaukee,73,83,1,-10,2017-11-10
USC Upstate,Minnesota,77,92,1,-15,2017-11-10
Louisiana,Ole Miss,76,94,1,-18,2017-11-10
Bucknell,Monmouth,78,79,1,-1,2017-11-10
Omaha,Montana State,80,89,1,-9,2017-11-10
Brescia,Murray State,61,118,1,-57,2017-11-10
Greensboro,North Carolina A&T,80,104,1,-24,2017-11-10
Loyola (MD),Northwestern,75,79,1,-4,2017-11-10
Pepperdine,Oklahoma State,47,78,1,-31,2017-11-10
Avila,Oral Roberts,72,86,1,-14,2017-11-10
SIU-Edwardsville,Purdue,74,105,1,-31,2017-11-10
Eastern Kentucky,Rice,73,72,0,1,2017-11-10
Hampton,Rider,75,90,1,-15,2017-11-10
Seattle,Saint Louis,46,62,1,-16,2017-11-10
Florida Atlantic,South Florida,59,60,1,-1,2017-11-10
Centenary (LA),Southeastern Louisiana,67,99,1,-32,2017-11-10
UMBC,SMU,67,78,1,-11,2017-11-10
Southern-New Orleans,Southern Miss,69,79,1,-10,2017-11-10
Niagara,St. Bonaventure,77,75,0,2,2017-11-10
Midway,Tennessee Tech,56,94,1,-38,2017-11-10
Northwestern State,Texas,59,105,1,-46,2017-11-10
Our Lady of the Lake,Texas A&M-Corpus Christi,68,69,1,-1,2017-11-10
Nicholls State,Texas-Rio Grande Valley,111,106,0,5,2017-11-10
LIU-Brooklyn,Tulane,96,102,1,-6,2017-11-10
North Park,Valparaiso,46,88,1,-42,2017-11-10
Columbia,Villanova,60,75,1,-15,2017-11-10
Missouri State,Western Kentucky,85,80,0,5,2017-11-10
UMKC,Wichita State,57,109,1,-52,2017-11-10
Sacramento State,Colorado State,61,72,1,-11,2017-11-10
Yale,Creighton,76,92,1,-16,2017-11-10
Texas Southern,Gonzaga,69,97,1,-28,2017-11-10
Florida A&M,Grand Canyon,51,67,1,-16,2017-11-10
Chicago State,Iowa,62,95,1,-33,2017-11-10
Tennessee State,Kansas,56,92,1,-36,2017-11-10
American,Kansas State,45,83,1,-38,2017-11-10
Mount St. Mary's,Marquette,59,80,1,-21,2017-11-10
Iowa State,Missouri,59,74,1,-15,2017-11-10
Whitworth,Montana,60,72,1,-12,2017-11-10
Pitt,Navy,62,71,1,-9,2017-11-10
East Central,New Mexico State,55,81,1,-26,2017-11-10
Troy,North Dakota,80,83,1,-3,2017-11-10
UC-Irvine,South Dakota State,54,65,1,-11,2017-11-10
Louisiana-Monroe,TCU,73,83,1,-10,2017-11-10
Louisiana College,UTEP,50,100,1,-50,2017-11-10
South Alabama,Texas Tech,50,75,1,-25,2017-11-10
Austin Peay,Vanderbilt,54,73,1,-19,2017-11-10
Utah State,Weber State,59,65,1,-6,2017-11-10
Chattanooga,Wyoming,65,74,1,-9,2017-11-10
Idaho State,Arizona State,74,94,1,-20,2017-11-10
Eastern Oregon,Boise State,65,104,1,-39,2017-11-10
Whittier,Cal State Bakersfield,66,88,1,-22,2017-11-10
Life Pacific,Cal State Northridge,50,76,1,-26,2017-11-10
Idaho,Nevada,64,88,1,-24,2017-11-10
Southern Utah,Oregon State,82,99,1,-17,2017-11-10
San Diego Christian,San Diego State,52,91,1,-39,2017-11-10
Antelope Valley,San Jose State,45,97,1,-52,2017-11-10
La Verne,Santa Clara,70,120,1,-50,2017-11-10
Cal State Fullerton,USC,42,84,1,-42,2017-11-10
Prairie View,Utah,62,83,1,-21,2017-11-10
Belmont,Washington,82,86,1,-4,2017-11-10
UC-Riverside,California,74,66,0,8,2017-11-10
Arkansas-Pine Bluff,Hawaii,70,82,1,-12,2017-11-10
Coppin State,Oregon,54,70,1,-16,2017-11-10
Long Beach State,San Francisco,83,71,0,12,2017-11-10
Georgia Tech,UCLA,60,63,1,-3,2017-11-10
Canisius,Buffalo,75,80,1,-5,2017-11-11
Penn,Fairfield,72,80,1,-8,2017-11-11
Illinois State,Florida Gulf Coast,87,98,1,-11,2017-11-11
IUPUI,Bradley,53,68,1,-15,2017-11-11
Alabama A&M,Ohio,53,61,1,-8,2017-11-11
Dartmouth,Quinnipiac,77,78,1,-1,2017-11-11
Siena Heights,Western Michigan,72,103,1,-31,2017-11-11
Toccoa Falls,Appalachian State,34,135,1,-101,2017-11-11
Johnson & Wales (RI),Brown,78,106,1,-28,2017-11-11
Coe,Drake,54,101,1,-47,2017-11-11
St. Peter's,La Salle,40,61,1,-21,2017-11-11
Stephen F. Austin,Longwood,74,61,0,13,2017-11-11
Ouachita,Little Rock,81,79,0,2,2017-11-11
North Dakota State,UCSB,66,85,1,-19,2017-11-11
Notre Dame,DePaul,72,58,0,14,2017-11-11
St. Francis (NY),Duquesne,70,80,1,-10,2017-11-11
Wagner,NJIT,60,49,0,11,2017-11-11
Cleveland State,Akron,57,67,1,-10,2017-11-11
Utah Valley,Duke,69,99,1,-30,2017-11-11
Peace,Elon,53,96,1,-43,2017-11-11
Lehigh,Marist,84,76,0,8,2017-11-11
North Florida,Michigan,66,86,1,-20,2017-11-11
North Carolina Wesleyan,UNC Wilmington,81,105,1,-24,2017-11-11
Johnson University,Presbyterian,87,107,1,-20,2017-11-11
Texas-Tyler,Sam Houston State,51,91,1,-40,2017-11-11
Mayville State,South Dakota,59,87,1,-28,2017-11-11
St. Joseph's,Toledo,87,98,1,-11,2017-11-11
Eastern Illinois,Nebraska,68,72,1,-4,2017-11-11
Saint Francis (PA),Saint Mary's,68,85,1,-17,2017-11-11
Loyola Marymount,Texas-Arlington,80,85,1,-5,2017-11-11
Saint Mary's (MN),Western Illinois,68,109,1,-41,2017-11-11
Mississippi Valley State,BYU,61,91,1,-30,2017-11-11
Youngstown State,Kent State,78,111,1,-33,2017-11-11
Northern New Mexico,New Mexico,76,147,1,-71,2017-11-11
Florida A&M,UNLV,66,108,1,-42,2017-11-11
Portland State,Portland,80,75,0,5,2017-11-11
Jacksonville,Georgetown,57,73,1,-16,2017-11-12
South Carolina State,Boston College,52,91,1,-39,2017-11-12
Massachusetts-Boston,UMass-Lowell,63,102,1,-39,2017-11-12
Wilmington (OH),Northern Kentucky,65,93,1,-28,2017-11-12
Monmouth,Seton Hall,65,75,1,-10,2017-11-12
North Carolina A&T,Clemson,63,87,1,-24,2017-11-12
Michigan-Dearborn,Eastern Michigan,73,97,1,-24,2017-11-12
UMass,Harvard,67,70,1,-3,2017-11-12
George Mason,Louisville,61,72,1,-11,2017-11-12
Toccoa Falls,Mercer,43,110,1,-67,2017-11-12
Radford,Ohio State,72,82,1,-10,2017-11-12
Central Connecticut,Rutgers,67,71,1,-4,2017-11-12
Washington & Lee,Wofford,66,103,1,-37,2017-11-12
Bridgewater (VA),Appalachian State,57,95,1,-38,2017-11-12
Vermont,Kentucky,69,73,1,-4,2017-11-12
Eureka,Loyola (IL),69,96,1,-27,2017-11-12
Omaha,Oklahoma,89,108,1,-19,2017-11-12
Allen,USC Upstate,66,85,1,-19,2017-11-12
Mary,South Dakota State,54,78,1,-24,2017-11-12
Texas State,Air Force,57,65,1,-8,2017-11-12
Southern Utah,Boise State,69,90,1,-21,2017-11-12
Cal Poly,California,82,85,1,-3,2017-11-12
Gordon,Hartford,63,80,1,-17,2017-11-12
Alabama State,Iowa,58,92,1,-34,2017-11-12
Defiance,Purdue-Fort Wayne,59,114,1,-55,2017-11-12
Navy,Miami (FL),55,89,1,-34,2017-11-12
Charleston Southern,NC State,56,78,1,-22,2017-11-12
Wentworth,Northeastern,49,83,1,-34,2017-11-12
Chicago State,Purdue,42,111,1,-69,2017-11-12
Louisiana-Monroe,SMU,65,83,1,-18,2017-11-12
East Central,UTSA,59,92,1,-33,2017-11-12
Texas Southern,Washington State,84,86,1,-2,2017-11-12
University of the Ozarks,Central Arkansas,51,99,1,-48,2017-11-12
Coppin State,East Carolina,50,76,1,-26,2017-11-12
Bluefield College (VA),Hampton,68,85,1,-17,2017-11-12
Morehead State,Lipscomb,70,77,1,-7,2017-11-12
Haskell Indian Nations Institute,UMKC,59,110,1,-51,2017-11-12
LeTourneau,Northwestern State,99,84,0,15,2017-11-12
Fairleigh Dickinson,Penn State,57,81,1,-24,2017-11-12
San Diego,San Jose State,81,64,0,17,2017-11-12
UMBC,Arizona,78,103,1,-25,2017-11-12
Bucknell,Arkansas,73,101,1,-28,2017-11-12
Princeton,Butler,75,85,1,-10,2017-11-12
UC-Irvine,Denver,83,69,0,14,2017-11-12
UT-Martin,Illinois,74,77,1,-3,2017-11-12
Maryland-Eastern Shore,Maryland,43,96,1,-53,2017-11-12
Yale,Wisconsin,61,89,1,-28,2017-11-12
Troy,Arkansas-Pine Bluff,81,57,0,24,2017-11-12
Alcorn State,Creighton,72,109,1,-37,2017-11-12
Stetson,Florida International,70,64,0,6,2017-11-12
Puget Sound,Seattle,70,121,1,-51,2017-11-12
Citadel,Virginia Tech,93,132,1,-39,2017-11-12
Howard,Indiana,77,86,1,-9,2017-11-12
Eastern Washington,Washington,69,79,1,-10,2017-11-12
North Dakota,Hawaii,78,81,1,-3,2017-11-12
Pacific,Stanford,80,89,1,-9,2017-11-12
North Carolina Central,Evansville,55,68,1,-13,2017-11-13
Jacksonville State,Richmond,94,61,0,33,2017-11-13
Eastern Kentucky,Ole Miss,75,85,1,-10,2017-11-13
Minnesota,Providence,86,74,0,12,2017-11-13
Vanderbilt,Belmont,60,69,1,-9,2017-11-13
Albany (NY),Boston University,88,74,0,14,2017-11-13
South Dakota,Bowling Green State,88,79,0,9,2017-11-13
Columbia International,Campbell,44,108,1,-64,2017-11-13
Western Carolina,Cincinnati,51,102,1,-51,2017-11-13
Binghamton,Cornell,84,94,1,-10,2017-11-13
Michigan-Dearborn,Detroit,82,105,1,-23,2017-11-13
Arcadia,Drexel,81,95,1,-14,2017-11-13
Gardner-Webb,Florida,74,116,1,-42,2017-11-13
LIU-Brooklyn,Fordham,68,81,1,-13,2017-11-13
Cal State Bakersfield,Georgia Southern,53,77,1,-24,2017-11-13
Kennesaw State,Hofstra,57,75,1,-18,2017-11-13
Anderson (SC),IUPUI,43,75,1,-32,2017-11-13
Old Dominion,James Madison,69,53,0,16,2017-11-13
Southeast Missouri State,Louisiana Tech,95,96,1,-1,2017-11-13
Southern,Marshall,74,83,1,-9,2017-11-13
Central Michigan,Michigan,65,72,1,-7,2017-11-13
Lynchburg,Norfolk State,83,80,0,3,2017-11-13
Lees-McRae,UNC Asheville,60,92,1,-32,2017-11-13
Mount St. Mary's,Notre Dame,62,88,1,-26,2017-11-13
New Orleans,Oakland,68,87,1,-19,2017-11-13
La Salle,Penn,75,71,0,4,2017-11-13
Montana,Pitt,83,78,0,5,2017-11-13
Brown,Quinnipiac,79,72,0,7,2017-11-13
ETSU,Savannah State,76,61,0,15,2017-11-13
Florida Gulf Coast,Siena,86,53,0,33,2017-11-13
Morgan State,South Florida,63,53,0,10,2017-11-13
Frostburg State,Towson,45,89,1,-44,2017-11-13
Austin Peay,Virginia,49,93,1,-44,2017-11-13
North Florida,VCU,85,95,1,-10,2017-11-13
Chattanooga,Alabama-Birmingham,47,89,1,-42,2017-11-13
Abilene Christian,Arkansas State,69,83,1,-14,2017-11-13
Texas A&M-Corpus Christi,Baylor,46,70,1,-24,2017-11-13
Delaware State,DePaul,57,81,1,-24,2017-11-13
St. Joseph's,UIC,86,82,0,4,2017-11-13
Trinity (TX),Incarnate Word,57,93,1,-36,2017-11-13
Milwaukee,Iowa State,74,56,0,18,2017-11-13
Ecclesia,McNeese State,54,101,1,-47,2017-11-13
Middle Tennessee,Murray State,72,67,0,5,2017-11-13
North Texas,Nebraska,67,86,1,-19,2017-11-13
Embry-Riddle Aeronautical University,Northern Arizona,82,70,0,12,2017-11-13
Alcorn State,Northern Iowa,45,73,1,-28,2017-11-13
St. Peter's,Northwestern,66,75,1,-9,2017-11-13
Charlotte,Oklahoma State,65,83,1,-18,2017-11-13
Rockhurst,Saint Louis,50,74,1,-24,2017-11-13
Alabama A&M,Samford,68,87,1,-19,2017-11-13
Mobile,South Alabama,49,71,1,-22,2017-11-13
Western Michigan,South Carolina,60,78,1,-18,2017-11-13
Reinhardt,Tennessee State,53,92,1,-39,2017-11-13
Bethune-Cookman,Texas-Rio Grande Valley,74,92,1,-18,2017-11-13
Southeastern Louisiana,Tulane,66,89,1,-23,2017-11-13
Oral Roberts,Tulsa,71,90,1,-19,2017-11-13
Trinity Christian,Valparaiso,46,83,1,-37,2017-11-13
Rider,Xavier,75,101,1,-26,2017-11-13
Robert Morris,Grand Canyon,61,75,1,-14,2017-11-13
Wagner,Missouri,55,99,1,-44,2017-11-13
Arkansas-Pine Bluff,North Dakota,71,80,1,-9,2017-11-13
UC-Davis,Northern Colorado,72,59,0,13,2017-11-13
Prairie View,Oregon,67,100,1,-33,2017-11-13
Tennessee Tech,TCU,63,100,1,-37,2017-11-13
Mississippi Valley State,Utah,51,91,1,-40,2017-11-13
Montana State,Utah State,73,81,1,-8,2017-11-13
College of Charleston,Wichita State,63,81,1,-18,2017-11-13
Cal State Northridge,Fresno State,73,89,1,-16,2017-11-13
George Fox,Idaho,62,101,1,-39,2017-11-13
New Mexico State,Saint Mary's,74,92,1,-18,2017-11-13
Saint Francis (PA),San Francisco,63,75,1,-12,2017-11-13
Troy,Hawaii,67,72,1,-5,2017-11-13
Rhode Island,Nevada,81,88,1,-7,2017-11-13
Wyoming,Oregon State,75,66,0,9,2017-11-13
North Dakota State,USC,65,75,1,-10,2017-11-13
Central Connecticut,St. John's (NY),55,80,1,-25,2017-11-14
Nicholls State,Villanova,77,113,1,-36,2017-11-14
Canisius,Air Force,79,93,1,-14,2017-11-14
John Jay,Army,43,92,1,-49,2017-11-14
Sacred Heart,Boston College,53,73,1,-20,2017-11-14
Stony Brook,UConn,64,72,1,-8,2017-11-14
Emerson,Dartmouth,43,78,1,-35,2017-11-14
UNC Wilmington,Davidson,81,108,1,-27,2017-11-14
VMI,Duquesne,61,77,1,-16,2017-11-14
Loyola (MD),Fairfield,52,64,1,-12,2017-11-14
George Washington,Florida State,67,87,1,-20,2017-11-14
Elon,Furman,67,76,1,-9,2017-11-14
USC Upstate,Georgia,65,74,1,-9,2017-11-14
Monmouth,Lehigh,80,72,0,8,2017-11-14
Columbia,Longwood,87,77,0,10,2017-11-14
Jackson State,Mercer,58,86,1,-28,2017-11-14
Wright State,Miami (OH),67,73,1,-6,2017-11-14
Duke,Michigan State,88,81,0,7,2017-11-14
Lafayette,NJIT,80,96,1,-16,2017-11-14
Bryant,NC State,72,95,1,-23,2017-11-14
Cleveland State,Rutgers,38,70,1,-32,2017-11-14
Hardin-Simmons,Sam Houston State,56,72,1,-16,2017-11-14
Iona,Syracuse,62,71,1,-9,2017-11-14
High Point,Tennessee,53,84,1,-31,2017-11-14
Ohio Northern,Toledo,62,72,1,-10,2017-11-14
Liberty,Wake Forest,79,66,0,13,2017-11-14
South Carolina State,Yale,54,86,1,-32,2017-11-14
Franciscan,Youngstown State,46,134,1,-88,2017-11-14
Lipscomb,Alabama,64,86,1,-22,2017-11-14
Delaware,Bradley,53,61,1,-8,2017-11-14
Silver Lake,Chicago State,53,101,1,-48,2017-11-14
Arlington Baptist,Houston Baptist,67,108,1,-41,2017-11-14
UMKC,Kansas State,51,72,1,-21,2017-11-14
Coastal Carolina,Lamar,60,66,1,-6,2017-11-14
Louisiana College,Louisiana,58,113,1,-55,2017-11-14
Purdue,Marquette,86,71,0,15,2017-11-14
Little Rock,Memphis,62,70,1,-8,2017-11-14
Green Bay,Northern Illinois,65,85,1,-20,2017-11-14
Georgia State,Rice,75,54,0,21,2017-11-14
Alabama State,South Dakota State,63,94,1,-31,2017-11-14
New Hampshire,Texas,60,78,1,-18,2017-11-14
Maine,Texas Tech,44,83,1,-39,2017-11-14
San Diego State,Arizona State,68,90,1,-22,2017-11-14
Denver,Colorado,62,89,1,-27,2017-11-14
Winthrop,Colorado State,76,80,1,-4,2017-11-14
Howard,Gonzaga,69,106,1,-37,2017-11-14
Utah Valley,Idaho State,84,71,0,13,2017-11-14
Kentucky,Kansas,61,65,1,-4,2017-11-14
Omaha,New Mexico,71,103,1,-32,2017-11-14
West Coast Baptist,Weber State,45,110,1,-65,2017-11-14
Chapman,UC-Irvine,52,91,1,-39,2017-11-14
San Francisco State,Long Beach State,70,95,1,-25,2017-11-14
Cal Lutheran,Pepperdine,82,107,1,-25,2017-11-14
Walla Walla,Portland,52,89,1,-37,2017-11-14
Notre Dame (CA),Sacramento State,53,74,1,-21,2017-11-14
Willamette,Portland State,60,111,1,-51,2017-11-14
Eastern Washington,Stanford,67,61,0,6,2017-11-14
Middle Georgia State,Savannah State,80,114,1,-34,2017-11-15
Southern,Missouri State,58,86,1,-28,2017-11-15
Indiana,Seton Hall,68,84,1,-16,2017-11-15
Jacksonville State,Buffalo,76,81,1,-5,2017-11-15
Gardner-Webb,UCF,65,68,1,-3,2017-11-15
Columbia International,Charleston Southern,58,98,1,-40,2017-11-15
Radford,East Carolina,73,66,0,7,2017-11-15
Fairleigh Dickinson-Florham,Fairleigh Dickinson,49,111,1,-62,2017-11-15
Mount St. Mary's,Georgetown,68,102,1,-34,2017-11-15
Delaware State,Purdue-Fort Wayne,71,85,1,-14,2017-11-15
New Rochelle,LIU-Brooklyn,68,104,1,-36,2017-11-15
St. Francis (NY),Manhattan,79,80,1,-1,2017-11-15
Marist,UMass-Lowell,73,76,1,-3,2017-11-15
Citadel,North Carolina A&T,73,92,1,-19,2017-11-15
North Carolina Wesleyan,UNC Greensboro,48,82,1,-34,2017-11-15
Montana,Penn State,57,70,1,-13,2017-11-15
Navy,Penn,45,66,1,-21,2017-11-15
UCSB,Pitt,62,70,1,-8,2017-11-15
BYU,Princeton,65,56,0,9,2017-11-15
Hartford,Rider,53,89,1,-36,2017-11-15
American,West Virginia,64,98,1,-34,2017-11-15
Hiwassee,Western Carolina,57,76,1,-19,2017-11-15
Hampton,William & Mary,76,83,1,-7,2017-11-15
Oakland City,Austin Peay,50,109,1,-59,2017-11-15
Butler,Maryland,65,79,1,-14,2017-11-15
Niagara,Minnesota,81,107,1,-26,2017-11-15
Bucknell,UNC,81,93,1,-12,2017-11-15
Wartburg,Northern Iowa,43,72,1,-29,2017-11-15
Ball State,Oklahoma,69,108,1,-39,2017-11-15
Valparaiso,SIU-Edwardsville,94,69,0,25,2017-11-15
Northwestern State,SMU,35,81,1,-46,2017-11-15
St. Edward's,Stephen F. Austin,66,89,1,-23,2017-11-15
South Florida,Stetson,75,72,0,3,2017-11-15
North Carolina Central,UT-Martin,57,74,1,-17,2017-11-15
Texas-Rio Grande Valley,Texas A&M-Corpus Christi,82,75,0,7,2017-11-15
UTSA,Texas State,79,78,0,1,2017-11-15
Eastern Illinois,Western Illinois,54,56,1,-2,2017-11-15
Kentucky Wesleyan,Western Kentucky,53,83,1,-30,2017-11-15
Creighton,Northwestern,92,88,0,4,2017-11-15
South Dakota,TCU,71,76,1,-5,2017-11-15
Mississippi Valley State,Utah State,47,83,1,-36,2017-11-15
Seattle,Washington State,59,75,1,-16,2017-11-15
Holy Names,Cal Poly,47,76,1,-29,2017-11-15
UC-Riverside,Loyola Marymount,64,76,1,-12,2017-11-15
Montana Western,Montana State,81,109,1,-28,2017-11-15
Prairie View,UNLV,63,98,1,-35,2017-11-15
UC-Davis,Pacific,62,58,0,4,2017-11-15
Cal State Fullerton,Saint Mary's,57,76,1,-19,2017-11-15
Robert Morris,San Diego,53,65,1,-12,2017-11-15
Nevada,Santa Clara,93,63,0,30,2017-11-15
Central Arkansas,UCLA,101,106,1,-5,2017-11-15
Edward Waters,Florida Atlantic,59,91,1,-32,2017-11-16
Auburn,Indiana State,83,64,0,19,2017-11-16
Illinois State,South Carolina,69,65,0,4,2017-11-16
Old Dominion,Temple,65,76,1,-11,2017-11-16
Boise State,UTEP,58,56,0,2,2017-11-16
Iowa State,Appalachian State,104,98,0,6,2017-11-16
Clemson,Ohio,81,76,0,5,2017-11-16
Nebraska,St. John's (NY),56,79,1,-23,2017-11-16
Hiwassee,Chattanooga,46,94,1,-48,2017-11-16
Coppin State,Cincinnati,54,97,1,-43,2017-11-16
Cornell,Colgate,61,72,1,-11,2017-11-16
Johnson & Wales,Denver,59,91,1,-32,2017-11-16
Kentucky State,Eastern Kentucky,66,97,1,-31,2017-11-16
Arkansas State,Eastern Michigan,59,76,1,-17,2017-11-16
North Florida,Florida,68,108,1,-40,2017-11-16
Binghamton,George Mason,57,69,1,-12,2017-11-16
Bluefield State,Georgia Southern,52,120,1,-68,2017-11-16
Dayton,Hofstra,69,72,1,-3,2017-11-16
Harvard,Holy Cross,69,73,1,-4,2017-11-16
Piedmont,Kennesaw State,54,77,1,-23,2017-11-16
Ohio Christian,Kent State,45,90,1,-45,2017-11-16
South Alabama,La Salle,73,81,1,-8,2017-11-16
Central Pennsylvania College,UMBC,62,93,1,-31,2017-11-16
Florida A&M,Miami (FL),59,90,1,-31,2017-11-16
Southern Miss,Michigan,47,61,1,-14,2017-11-16
Belmont,Middle Tennessee,69,63,0,6,2017-11-16
Marshall,Morehead State,83,86,1,-3,2017-11-16
Lincoln (PA),Morgan State,60,72,1,-12,2017-11-16
Presbyterian,NC State,68,86,1,-18,2017-11-16
Chicago State,Notre Dame,66,105,1,-39,2017-11-16
Texas Southern,Ohio State,64,82,1,-18,2017-11-16
Virginia Tech,Saint Louis,71,77,1,-6,2017-11-16
Boyce,Tennessee Tech,48,106,1,-58,2017-11-16
Howard Payne,Abilene Christian,62,112,1,-50,2017-11-16
LeMoyne-Owen,Alabama-Birmingham,57,81,1,-24,2017-11-16
Southeast Missouri State,Evansville,50,66,1,-16,2017-11-16
Delaware State,UIC,55,95,1,-40,2017-11-16
Grambling,Iowa,74,85,1,-11,2017-11-16
Jarvis Christian,Lamar,66,103,1,-37,2017-11-16
Southeastern Louisiana,Louisiana-Monroe,75,86,1,-11,2017-11-16
Samford,LSU,86,105,1,-19,2017-11-16
Loyola (IL),UMKC,66,56,0,10,2017-11-16
Bethune-Cookman,North Texas,78,90,1,-12,2017-11-16
St. Francis (IL),Northern Illinois,60,70,1,-10,2017-11-16
Oral Roberts,Oklahoma State,48,91,1,-43,2017-11-16
San Jose State,Southern Utah,69,81,1,-12,2017-11-16
LeTourneau,Stephen F. Austin,68,91,1,-23,2017-11-16
Brewton-Parker,Troy,71,106,1,-35,2017-11-16
Missouri,Utah,59,77,1,-18,2017-11-16
Tulsa,Western Michigan,81,74,0,7,2017-11-16
Xavier,Wisconsin,80,70,0,10,2017-11-16
Wofford,California,65,79,1,-14,2017-11-16
Providence,Washington,77,70,0,7,2017-11-16
Cal State Bakersfield,Arizona,59,91,1,-32,2017-11-16
South Carolina,UTEP,80,56,0,24,2017-11-17
Auburn,Temple,74,88,1,-14,2017-11-17
Bradley,Vermont,64,65,1,-1,2017-11-17
Mercer,Liberty,63,48,0,15,2017-11-17
Illinois State,Boise State,64,82,1,-18,2017-11-17
Indiana State,Old Dominion,44,62,1,-18,2017-11-17
Tulane,Colorado State,80,53,0,27,2017-11-17
Houston,Drexel,80,84,1,-4,2017-11-17
Coastal Carolina,UTSA,83,69,0,14,2017-11-17
Virginia,VCU,76,67,0,9,2017-11-17
Northern Kentucky,James Madison,87,78,0,9,2017-11-17
Savannah State,Louisiana,82,115,1,-33,2017-11-17
Virginia Tech,Washington,103,79,0,24,2017-11-17
Appalachian State,Western Michigan,67,86,1,-19,2017-11-17
Quinnipiac,Colorado,69,70,1,-1,2017-11-17
Florida International,Elon,87,95,1,-8,2017-11-17
Fordham,Florida State,43,67,1,-24,2017-11-17
Northeastern,Stanford,59,73,1,-14,2017-11-17
Alabama A&M,Alabama,67,104,1,-37,2017-11-17
Yale,Albany (NY),72,80,1,-8,2017-11-17
Stony Brook,Ball State,76,87,1,-11,2017-11-17
Coppin State,Cleveland State,56,80,1,-24,2017-11-17
Ohio,Dayton,65,79,1,-14,2017-11-17
Wesley,Delaware,78,93,1,-15,2017-11-17
Southern,Duke,61,78,1,-17,2017-11-17
Central Connecticut,East Carolina,79,68,0,11,2017-11-17
McMurry,Incarnate Word,49,88,1,-39,2017-11-17
ETSU,Kentucky,61,78,1,-17,2017-11-17
Siena,Lehigh,90,91,1,-1,2017-11-17
Omaha,Louisville,78,87,1,-9,2017-11-17
Towson,Loyola (MD),95,72,0,23,2017-11-17
Georgia State,Ole Miss,72,77,1,-5,2017-11-17
Warren Wilson,North Carolina Central,76,101,1,-25,2017-11-17
Ferrum,UNC Greensboro,43,95,1,-52,2017-11-17
Rice,Northwestern State,87,65,0,22,2017-11-17
Columbia,Penn State,65,79,1,-14,2017-11-17
Providence,Saint Louis,90,63,0,27,2017-11-17
Iowa State,Tulsa,80,78,0,2,2017-11-17
Northern Arizona,Arizona State,62,97,1,-35,2017-11-17
Fresno State,Arkansas,75,83,1,-8,2017-11-17
Wake Forest,Drake,74,77,1,-3,2017-11-17
IUPUI,Eastern Illinois,79,80,1,-1,2017-11-17
Lakeland,Green Bay,27,98,1,-71,2017-11-17
DePaul,Illinois,73,82,1,-9,2017-11-17
Weber State,Iona,72,80,1,-8,2017-11-17
South Dakota State,Kansas,64,98,1,-34,2017-11-17
LIU-Brooklyn,Miami (OH),74,78,1,-4,2017-11-17
North Dakota State,Missouri State,57,54,0,3,2017-11-17
Spring Hill,Nicholls State,83,127,1,-44,2017-11-17
UCSB,Texas A&M,65,84,1,-19,2017-11-17
UNC Asheville,Vanderbilt,76,79,1,-3,2017-11-17
Lafayette,Villanova,57,104,1,-47,2017-11-17
Alcorn State,Baylor,61,78,1,-17,2017-11-17
Clemson,Hofstra,78,59,0,19,2017-11-17
UC-Irvine,Kansas State,49,71,1,-22,2017-11-17
Concordia-St. Paul,Milwaukee,69,55,0,14,2017-11-17
New Mexico,New Mexico State,56,75,1,-19,2017-11-17
South Carolina State,UCLA,68,96,1,-28,2017-11-17
Eastern Washington,UNLV,76,91,1,-15,2017-11-17
Northern Colorado,Pepperdine,84,82,0,2,2017-11-17
McNeese State,San Diego State,52,83,1,-31,2017-11-17
Sacramento State,San Francisco,56,69,1,-13,2017-11-17
Alabama State,Oregon,56,114,1,-58,2017-11-17
Penn St. - Brandywine,Penn,40,99,1,-59,2017-11-18
Bradley,UTSA,71,69,0,2,2017-11-18
Texas Tech,Boston College,75,64,0,11,2017-11-18
Maryland-Eastern Shore,Georgetown,57,83,1,-26,2017-11-18
Houston,Liberty,68,66,0,2,2017-11-18
Chicago State,Northern Iowa,44,82,1,-38,2017-11-18
Eureka,Central Michigan,68,103,1,-35,2017-11-18
Harvard,Manhattan,69,73,1,-4,2017-11-18
SIU-Edwardsville,Stetson,80,76,0,4,2017-11-18
Presbyterian,VMI,58,78,1,-20,2017-11-18
Bob Jones University,Wofford,65,96,1,-31,2017-11-18
Furman,Butler,65,82,1,-17,2017-11-18
William & Mary,UCF,64,75,1,-11,2017-11-18
Seattle,Detroit,102,71,0,31,2017-11-18
Howard,Eastern Michigan,66,76,1,-10,2017-11-18
Kean,Fairleigh Dickinson,55,94,1,-39,2017-11-18
Hampton,George Washington,57,65,1,-8,2017-11-18
Citadel,High Point,79,77,0,2,2017-11-18
La Salle,Northwestern,74,82,1,-8,2017-11-18
Charleston Southern,USC Upstate,82,72,0,10,2017-11-18
American,Wagner,70,71,1,-1,2017-11-18
Quinnipiac,Wake Forest,55,72,1,-17,2017-11-18
James Madison,Weber State,65,73,1,-8,2017-11-18
Warren Wilson,Gardner-Webb,81,119,1,-38,2017-11-18
Saint Francis (PA),Longwood,83,56,0,27,2017-11-18
Houston Baptist,Belmont,88,93,1,-5,2017-11-18
Navy,Bryant,79,71,0,8,2017-11-18
Elon,Concordia-St. Paul,84,62,0,22,2017-11-18
Binghamton,Evansville,61,66,1,-5,2017-11-18
Purdue-Fort Wayne,UIC,67,51,0,16,2017-11-18
Florida A&M,Mississippi State,48,79,1,-31,2017-11-18
North Florida,Mount St. Mary's,81,84,1,-3,2017-11-18
NJIT,Seton Hall,53,82,1,-29,2017-11-18
Jackson State,St. Bonaventure,58,72,1,-14,2017-11-18
Middle Tennessee,Tennessee State,75,65,0,10,2017-11-18
Idaho State,Washington State,62,83,1,-21,2017-11-18
Central Pennsylvania College,Winthrop,65,106,1,-41,2017-11-18
Bethesda University (CA),Cal State Fullerton,35,77,1,-42,2017-11-18
Vermont,Coastal Carolina,80,67,0,13,2017-11-18
South Alabama,Maine,68,46,0,22,2017-11-18
Howard Payne,Stephen F. Austin,64,118,1,-54,2017-11-18
Lipscomb,Texas,57,80,1,-23,2017-11-18
Texas-Rio Grande Valley,Texas State,58,75,1,-17,2017-11-18
UC-Davis,Utah Valley,71,80,1,-9,2017-11-18
Florida Gulf Coast,Bowling Green State,80,83,1,-3,2017-11-18
Mercer,Drexel,78,59,0,19,2017-11-18
Cal State Northridge,George Mason,73,78,1,-5,2017-11-18
North Carolina A&T,Jacksonville,90,82,0,8,2017-11-18
Hartford,LIU-Brooklyn,84,86,1,-2,2017-11-18
Florida International,Milwaukee,51,66,1,-15,2017-11-18
UT-Martin,Akron,59,76,1,-17,2017-11-18
Portland State,UC-Riverside,94,82,0,12,2017-11-18
Youngstown State,Canisius,84,104,1,-20,2017-11-18
College of Charleston,Charlotte,81,72,0,9,2017-11-18
Army,Marist,94,73,0,21,2017-11-18
Campbell,UNC Wilmington,84,88,1,-4,2017-11-18
Fairfield,Purdue,64,106,1,-42,2017-11-18
St. Peter's,Sacred Heart,70,61,0,9,2017-11-18
Princeton,St. Joseph's,58,71,1,-13,2017-11-18
Texas Southern,Syracuse,67,80,1,-13,2017-11-18
Kennesaw State,Tennessee Tech,68,82,1,-14,2017-11-18
Oakland,Toledo,74,87,1,-13,2017-11-18
Morgan State,West Virginia,48,111,1,-63,2017-11-18
Murray State,Wright State,80,61,0,19,2017-11-18
Colorado,Drake,86,81,0,5,2017-11-18
Northern Kentucky,Iona,85,72,0,13,2017-11-18
Montana State,Louisiana Tech,58,71,1,-13,2017-11-18
Bucknell,Maryland,78,80,1,-2,2017-11-18
Grambling,South Dakota,55,84,1,-29,2017-11-18
Illinois-Springfield,Southern Illinois,64,69,1,-5,2017-11-18
Arkansas-Pine Bluff,SMU,37,72,1,-35,2017-11-18
Calvary,Western Illinois,25,102,1,-77,2017-11-18
Texas-Arlington,BYU,89,75,0,14,2017-11-18
Little Rock,Grand Canyon,51,76,1,-25,2017-11-18
Utah State,Gonzaga,66,79,1,-13,2017-11-18
Sam Houston State,Idaho,54,63,1,-9,2017-11-18
Nevada,Pacific,89,74,0,15,2017-11-18
Norfolk State,San Diego,62,71,1,-9,2017-11-18
Cal Poly,Santa Clara,63,59,0,4,2017-11-18
Long Beach State,Oregon State,81,89,1,-8,2017-11-18
UTEP,Appalachian State,72,76,1,-4,2017-11-19
James Madison,UTSA,77,90,1,-13,2017-11-19
Quinnipiac,Liberty,72,84,1,-12,2017-11-19
Sacred Heart,Maine,69,68,0,1,2017-11-19
Niagara,UMass,76,101,1,-25,2017-11-19
Coppin State,Rutgers,39,64,1,-25,2017-11-19
Texas A&M-Corpus Christi,Georgia,65,68,1,-3,2017-11-19
Cornell,UMass-Lowell,78,98,1,-20,2017-11-19
Indiana State,Ohio,94,96,1,-2,2017-11-19
Holy Cross,Rhode Island,66,88,1,-22,2017-11-19
Brown,St. Francis (NY),74,77,1,-3,2017-11-19
Monmouth,Virginia,53,73,1,-20,2017-11-19
UC-Irvine,Arizona State,78,99,1,-21,2017-11-19
Seattle,Belmont,77,90,1,-13,2017-11-19
Weber State,Bradley,64,70,1,-6,2017-11-19
Alcorn State,Central Arkansas,76,102,1,-26,2017-11-19
UMBC,Colgate,88,93,1,-5,2017-11-19
Concordia-St. Paul,Florida International,67,77,1,-10,2017-11-19
Bethune-Cookman,Georgia Tech,62,65,1,-3,2017-11-19
Eastern,Lehigh,70,95,1,-25,2017-11-19
North Dakota,Nebraska,70,92,1,-22,2017-11-19
Northeastern,Ohio State,55,80,1,-25,2017-11-19
Houston,Wake Forest,78,73,0,5,2017-11-19
South Carolina,Western Michigan,79,66,0,13,2017-11-19
North Florida,Wofford,83,86,1,-3,2017-11-19
Curry,Yale,42,107,1,-65,2017-11-19
UNC Asheville,Austin Peay,82,79,0,3,2017-11-19
Old Dominion,Dayton,75,67,0,8,2017-11-19
Mississippi Valley State,Kent State,67,80,1,-13,2017-11-19
Boston College,La Salle,82,61,0,21,2017-11-19
Samford,Loyola (IL),67,88,1,-21,2017-11-19
Houston Baptist,Detroit,109,116,1,-7,2017-11-19
Cal State Bakersfield,Lamar,85,73,0,12,2017-11-19
Stony Brook,Michigan State,71,93,1,-22,2017-11-19
Elon,Milwaukee,71,72,1,-1,2017-11-19
Western Carolina,Minnesota,64,92,1,-28,2017-11-19
Southern,North Carolina Central,67,80,1,-13,2017-11-19
Southeastern Louisiana,Valparaiso,50,83,1,-33,2017-11-19
Robert Morris,Duquesne,66,59,0,7,2017-11-19
Colorado State,Florida State,73,90,1,-17,2017-11-19
Marshall,Illinois,74,91,1,-17,2017-11-19
Coastal Carolina,Iona,89,84,0,5,2017-11-19
Texas Tech,Northwestern,85,49,0,36,2017-11-19
Illinois State,Tulsa,84,68,0,16,2017-11-19
Boston University,UConn,66,85,1,-19,2017-11-19
Drexel,Drake,88,90,1,-2,2017-11-19
New Hampshire,Florida,63,70,1,-7,2017-11-19
South Florida,Indiana,53,70,1,-17,2017-11-19
McNeese State,Loyola Marymount,86,92,1,-6,2017-11-19
Nicholls State,Western Kentucky,86,100,1,-14,2017-11-19
Tulane,Fordham,63,55,0,8,2017-11-19
Auburn,Hofstra,89,78,0,11,2017-11-19
Boise State,Iowa State,64,75,1,-11,2017-11-19
Mercer,Colorado,70,79,1,-9,2017-11-19
Oregon Tech,Portland,59,86,1,-27,2017-11-19
South Alabama,St. Peter's,54,49,0,5,2017-11-19
Saint Mary's,San Jose State,79,61,0,18,2017-11-19
USC,Vanderbilt,93,89,0,4,2017-11-19
Northern Kentucky,Vermont,64,66,1,-2,2017-11-19
Temple,Clemson,67,60,0,7,2017-11-19
Ball State,Oregon,71,95,1,-24,2017-11-19
Hartford,Miami (OH),68,58,0,10,2017-11-19
UMKC,Manhattan,74,63,0,11,2017-11-20
Toccoa Falls,Charleston Southern,36,107,1,-71,2017-11-20
Louisiana,Iowa,80,71,0,9,2017-11-20
Missouri State,Georgia Southern,73,74,1,-1,2017-11-20
Eastern Kentucky,Prairie View,70,80,1,-10,2017-11-20
Marquette,VCU,94,83,0,11,2017-11-20
South Dakota State,Wyoming,65,77,1,-12,2017-11-20
Wichita State,California,92,82,0,10,2017-11-20
Eastern Washington,Georgia State,50,68,1,-18,2017-11-20
Penn,Northern Illinois,93,80,0,13,2017-11-20
Alabama-Birmingham,Richmond,50,63,1,-13,2017-11-20
Jacksonville State,Savannah State,86,71,0,15,2017-11-20
Molloy,St. John's (NY),43,71,1,-28,2017-11-20
SUNY-Oneonta,Albany (NY),77,102,1,-25,2017-11-20
Lake Erie,Bowling Green State,106,109,1,-3,2017-11-20
Siena,Bucknell,92,115,1,-23,2017-11-20
Cincinnati,Buffalo,73,67,0,6,2017-11-20
Johnson & Wales (NC),Campbell,53,98,1,-45,2017-11-20
Presbyterian,Charlotte,74,83,1,-9,2017-11-20
Alabama State,Chattanooga,50,67,1,-17,2017-11-20
UCLA,Creighton,89,100,1,-11,2017-11-20
Furman,Duke,63,92,1,-29,2017-11-20
Cleveland State,East Carolina,69,72,1,-3,2017-11-20
Delaware State,ETSU,57,81,1,-24,2017-11-20
Albany State (GA),Florida A&M,59,77,1,-18,2017-11-20
Rider,George Washington,67,65,0,2,2017-11-20
Webber,Jacksonville,70,88,1,-18,2017-11-20
Jackson State,Maryland,45,76,1,-31,2017-11-20
Delaware,UNC Greensboro,66,79,1,-13,2017-11-20
Texas A&M,Oklahoma State,72,55,0,17,2017-11-20
Paine,USC Upstate,59,79,1,-20,2017-11-20
Maryland-Eastern Shore,St. Bonaventure,48,96,1,-48,2017-11-20
Ave Maria,Stetson,53,87,1,-34,2017-11-20
Oakland,Syracuse,50,74,1,-24,2017-11-20
Florida Atlantic,Towson,52,76,1,-24,2017-11-20
Long Beach State,West Virginia,62,91,1,-29,2017-11-20
Tiffin,Wright State,49,73,1,-24,2017-11-20
Lipscomb,Abilene Christian,75,67,0,8,2017-11-20
Howard,Arkansas State,78,92,1,-14,2017-11-20
Northern Arizona,Kansas State,58,80,1,-22,2017-11-20
Troy,Kentucky,62,70,1,-8,2017-11-20
Green Bay,Mississippi State,68,77,1,-9,2017-11-20
Emporia State,Missouri,62,67,1,-5,2017-11-20
Oral Roberts,Montana,64,69,1,-5,2017-11-20
Texas-Rio Grande Valley,North Texas,75,63,0,12,2017-11-20
Mount Marty,South Dakota,54,93,1,-39,2017-11-20
Blue Mountain College,Southern Miss,46,90,1,-44,2017-11-20
Eastern Oregon,Utah Valley,52,97,1,-45,2017-11-20
Hampton,Xavier,60,96,1,-36,2017-11-20
Arkansas-Pine Bluff,Air Force,47,57,1,-10,2017-11-20
Notre Dame,Chaminade,83,56,0,27,2017-11-20
Norfolk State,Grand Canyon,60,85,1,-25,2017-11-20
Penn State,Pitt,85,54,0,31,2017-11-20
Omaha,TCU,66,99,1,-33,2017-11-20
Baylor,Wisconsin,70,65,0,5,2017-11-20
Rice,UNLV,68,95,1,-27,2017-11-20
UCSB,Pepperdine,92,84,0,8,2017-11-20
Utah State,Portland State,79,83,1,-4,2017-11-20
Little Rock,San Diego,52,66,1,-14,2017-11-20
Eastern Illinois,San Diego State,63,94,1,-31,2017-11-20
Michigan,LSU,75,77,1,-2,2017-11-20
UNC,Stanford,96,72,0,24,2017-11-20
Ole Miss,Utah,74,83,1,-9,2017-11-21
Manhattan,Missouri State,65,69,1,-4,2017-11-21
Mars Hill,Winthrop,49,104,1,-55,2017-11-21
Montana State,Binghamton,74,64,0,10,2017-11-21
Iowa,South Dakota State,72,80,1,-8,2017-11-21
Northern Illinois,Florida Atlantic,67,77,1,-10,2017-11-21
Marquette,Wichita State,66,80,1,-14,2017-11-21
Louisiana,Wyoming,61,70,1,-9,2017-11-21
Southeast Missouri State,Cal State Northridge,74,59,0,15,2017-11-21
Pitt,Oklahoma State,67,73,1,-6,2017-11-21
VCU,California,83,69,0,14,2017-11-21
Brevard,Gardner-Webb,70,93,1,-23,2017-11-21
Delaware,North Carolina Wesleyan,88,70,0,18,2017-11-21
Savannah State,Alabama State,101,97,0,4,2017-11-21
Alabama-Birmingham,Buffalo,91,96,1,-5,2017-11-21
UMKC,Georgia Southern,75,78,1,-3,2017-11-21
Trinity Baptist,Citadel,66,116,1,-50,2017-11-21
Louisiana Tech,George Mason,77,64,0,13,2017-11-21
Penn State,Texas A&M,87,98,1,-11,2017-11-21
Columbia,Army,78,88,1,-10,2017-11-21
Grambling,Bethune-Cookman,78,87,1,-9,2017-11-21
Coppin State,Central Connecticut,71,74,1,-3,2017-11-21
Jacksonville State,Chattanooga,77,75,0,2,2017-11-21
Richmond,Cincinnati,48,75,1,-27,2017-11-21
Morehead State,IUPUI,61,67,1,-6,2017-11-21
Southeastern Louisiana,Kent State,70,66,0,4,2017-11-21
Southern Illinois,Louisville,42,84,1,-42,2017-11-21
Goucher,Loyola (MD),45,97,1,-52,2017-11-21
Western Carolina,UMass,76,85,1,-9,2017-11-21
Florida Gulf Coast,Middle Tennessee,72,85,1,-13,2017-11-21
Goldey-Beacom,Morgan State,67,82,1,-15,2017-11-21
York (PA),Mount St. Mary's,80,91,1,-11,2017-11-21
American,New Hampshire,74,70,0,4,2017-11-21
Mid-Atlantic Christian,North Carolina A&T,76,115,1,-39,2017-11-21
Longwood,UNC Greensboro,40,71,1,-31,2017-11-21
Edward Waters,North Florida,77,101,1,-24,2017-11-21
Bryant,Rutgers,54,83,1,-29,2017-11-21
Franciscan,Saint Francis (PA),54,96,1,-42,2017-11-21
Central Arkansas,South Carolina State,73,64,0,9,2017-11-21
Penn,Towson,71,79,1,-8,2017-11-21
Wisconsin,UCLA,70,72,1,-2,2017-11-21
Ohio Valley,VMI,66,81,1,-15,2017-11-21
Houston Baptist,Virginia Tech,73,99,1,-26,2017-11-21
Staten Island,Wagner,64,107,1,-43,2017-11-21
Shenandoah,William & Mary,54,103,1,-49,2017-11-21
Westminster,Youngstown State,83,91,1,-8,2017-11-21
Michigan,Chaminade,102,64,0,38,2017-11-21
East-West,Chicago State,65,113,1,-48,2017-11-21
Fresno State,Evansville,57,59,1,-2,2017-11-21
Methodist,High Point,63,99,1,-36,2017-11-21
Texas Southern,Kansas,71,114,1,-43,2017-11-21
Northwestern State,Louisiana-Monroe,76,61,0,15,2017-11-21
Mississippi Valley State,Loyola (IL),50,63,1,-13,2017-11-21
New Orleans,Memphis,52,63,1,-11,2017-11-21
Alabama A&M,Minnesota,57,100,1,-43,2017-11-21
Northland,North Dakota,48,79,1,-31,2017-11-21
Canisius,Tennessee State,52,60,1,-8,2017-11-21
Samford,Valparaiso,67,88,1,-21,2017-11-21
Pacific,Air Force,83,71,0,12,2017-11-21
Texas-Arlington,Alabama,76,77,1,-1,2017-11-21
Niagara,BYU,88,95,1,-7,2017-11-21
Tennessee Tech,New Mexico,104,96,0,8,2017-11-21
Northern New Mexico,Northern Colorado,60,99,1,-39,2017-11-21
Montana,UCSB,73,80,1,-7,2017-11-21
Baylor,Creighton,65,59,0,6,2017-11-21
Notre Dame,LSU,92,53,0,39,2017-11-21
Davidson,Nevada,68,81,1,-13,2017-11-21
Oral Roberts,Pepperdine,76,80,1,-4,2017-11-21
UC-Davis,Sacramento State,64,47,0,17,2017-11-21
Sonoma State,San Francisco,55,78,1,-23,2017-11-21
Benedictine,Southern Utah,68,85,1,-17,2017-11-21
Northern Illinois,Manhattan,70,68,0,2,2017-11-22
Iowa,Alabama-Birmingham,95,85,0,10,2017-11-22
Cal State Northridge,Binghamton,65,70,1,-5,2017-11-22
Tennessee,Purdue,78,75,0,3,2017-11-22
Yale,Alcorn State,87,73,0,14,2017-11-22
Florida Atlantic,Missouri State,60,71,1,-11,2017-11-22
Mitchell,Sacred Heart,60,84,1,-24,2017-11-22
South Dakota State,Buffalo,94,80,0,14,2017-11-22
California,Chaminade,72,96,1,-24,2017-11-22
Eastern Kentucky,Eastern Washington,62,83,1,-21,2017-11-22
Holy Cross,Fairleigh Dickinson,76,87,1,-11,2017-11-22
Kennesaw State,Florida State,79,98,1,-19,2017-11-22
Boston University,Maine,78,69,0,9,2017-11-22
Western Kentucky,Villanova,58,66,1,-8,2017-11-22
St. Andrews,Coastal Carolina,34,70,1,-36,2017-11-22
Longwood,Delaware,57,65,1,-8,2017-11-22
LIU-Brooklyn,UMass-Lowell,66,74,1,-8,2017-11-22
Southeast Missouri State,Montana State,82,88,1,-6,2017-11-22
Washington College,Navy,45,110,1,-65,2017-11-22
Bethel (TN),Austin Peay,58,90,1,-32,2017-11-22
Colgate,Boston College,79,83,1,-4,2017-11-22
College of Charleston,Cal Poly,68,73,1,-5,2017-11-22
Prairie View,Georgia State,71,56,0,15,2017-11-22
Appalachian State,James Madison,99,105,1,-6,2017-11-22
Champion Baptist,McNeese State,48,85,1,-37,2017-11-22
Kean,NJIT,63,116,1,-53,2017-11-22
Missouri-St. Louis,Indiana State,58,75,1,-17,2017-11-22
VCU,Michigan,60,68,1,-8,2017-11-22
Penn,UMKC,68,65,0,3,2017-11-22
Louisiana,Richmond,82,76,0,6,2017-11-22
Sam Houston State,Central Michigan,60,71,1,-11,2017-11-22
Fresno State,George Mason,79,73,0,6,2017-11-22
La Salle,Miami (FL),46,57,1,-11,2017-11-22
Brown,Stony Brook,64,77,1,-13,2017-11-22
Wofford,Texas Tech,56,79,1,-23,2017-11-22
Ball State,Bucknell,83,87,1,-4,2017-11-22
Wyoming,Cincinnati,53,78,1,-25,2017-11-22
Albany (NY),Dartmouth,91,73,0,18,2017-11-22
Troy,ETSU,73,65,0,8,2017-11-22
Radford,Elon,74,77,1,-3,2017-11-22
Towson,Georgia Southern,70,67,0,3,2017-11-22
Texas-Rio Grande Valley,Georgia Tech,68,78,1,-10,2017-11-22
Augustana (IL),Illinois,62,96,1,-34,2017-11-22
Arkansas State,Indiana,70,87,1,-17,2017-11-22
Monmouth,UNC Asheville,51,62,1,-11,2017-11-22
Arizona,NC State,84,90,1,-6,2017-11-22
Lafayette,Princeton,46,60,1,-14,2017-11-22
Belmont,Providence,65,66,1,-1,2017-11-22
Howard,South Florida,52,75,1,-23,2017-11-22
Toledo,Syracuse,64,72,1,-8,2017-11-22
Maine-Fort Kent,Vermont,54,90,1,-36,2017-11-22
Missouri S&T,Bradley,47,79,1,-32,2017-11-22
Loyola Marymount,Incarnate Word,91,87,0,4,2017-11-22
Purdue-Fort Wayne,Kentucky,67,86,1,-19,2017-11-22
Southern-New Orleans,Lamar,67,105,1,-38,2017-11-22
Marquette,LSU,94,84,0,10,2017-11-22
Evansville,Louisiana Tech,61,63,1,-2,2017-11-22
North Carolina Central,Marshall,84,92,1,-8,2017-11-22
Stephen F. Austin,Mississippi State,75,80,1,-5,2017-11-22
Florida A&M,North Dakota State,66,80,1,-14,2017-11-22
Rogers State,North Texas,74,86,1,-12,2017-11-22
Detroit,Saint Louis,72,70,0,2,2017-11-22
Stetson,South Alabama,81,77,0,4,2017-11-22
UT-Martin,Southern,66,69,1,-3,2017-11-22
Western Illinois,SIU-Edwardsville,69,67,0,2,2017-11-22
Miami (OH),Tulane,59,80,1,-21,2017-11-22
Santa Clara,Idaho,59,69,1,-10,2017-11-22
Quincy,Illinois State,57,86,1,-29,2017-11-22
Colorado State,New Mexico State,76,89,1,-13,2017-11-22
SMU,Northern Iowa,58,61,1,-3,2017-11-22
Texas State,Arkansas-Pine Bluff,71,54,0,17,2017-11-22
Western New Mexico,UC-Riverside,57,75,1,-18,2017-11-22
Wichita State,Notre Dame,66,67,1,-1,2017-11-22
Ole Miss,Rice,79,62,0,17,2017-11-22
Idaho State,San Jose State,54,62,1,-8,2017-11-22
Lehigh,USC,63,88,1,-25,2017-11-22
Cal State Bakersfield,Alaska-Anchorage,59,39,0,20,2017-11-22
Utah,UNLV,58,85,1,-27,2017-11-23
Missouri,Long Beach State,95,58,0,37,2017-11-23
Chicago State,UMBC,73,84,1,-11,2017-11-23
Villanova,Tennessee,85,76,0,9,2017-11-23
Portland,UNC,78,102,1,-24,2017-11-23
Hampton,Northern Arizona,76,66,0,10,2017-11-23
St. John's (NY),Oregon State,82,77,0,5,2017-11-23
Nicholls State,Presbyterian,76,64,0,12,2017-11-23
NC State,Northern Iowa,60,64,1,-4,2017-11-23
Portland State,Duke,81,99,1,-18,2017-11-23
Saint Mary's,Harvard,89,71,0,18,2017-11-23
Virginia,Vanderbilt,68,42,0,26,2017-11-23
Xavier,George Washington,83,64,0,19,2017-11-23
Arkansas,Oklahoma,92,83,0,9,2017-11-23
UCF,Nebraska,68,59,0,9,2017-11-23
Rhode Island,Seton Hall,75,74,0,1,2017-11-23
St. Joseph's,Washington State,71,75,1,-4,2017-11-23
Kansas State,Arizona State,90,92,1,-2,2017-11-23
Western Kentucky,Purdue,77,73,0,4,2017-11-23
Butler,Texas,48,61,1,-13,2017-11-23
West Virginia,Marist,84,78,0,6,2017-11-23
UConn,Oregon,71,63,0,8,2017-11-23
College of Charleston,Sam Houston State,59,49,0,10,2017-11-23
Arizona,SMU,60,66,1,-6,2017-11-23
Georgia,Cal State Fullerton,64,57,0,7,2017-11-23
UC-Irvine,Rider,82,90,1,-8,2017-11-23
Florida,Stanford,108,87,0,21,2017-11-23
Santa Clara,Alaska-Anchorage,73,78,1,-5,2017-11-23
Michigan State,DePaul,73,51,0,22,2017-11-23
Gonzaga,Ohio State,86,59,0,27,2017-11-23
San Diego State,Sacramento State,89,52,0,37,2017-11-24
Missouri,St. John's (NY),90,82,0,8,2017-11-24
Presbyterian,Chicago State,75,73,0,2,2017-11-24
UMass,Minnesota,51,69,1,-18,2017-11-24
Tennessee Tech,Omaha,86,85,0,1,2017-11-24
Villanova,Northern Iowa,64,50,0,14,2017-11-24
Arkansas State,South Florida,61,72,1,-11,2017-11-24
Furman,New Hampshire,78,64,0,14,2017-11-24
Long Beach State,Oregon State,74,69,0,5,2017-11-24
East Carolina,Rutgers,47,61,1,-14,2017-11-24
Saint Mary's,Washington State,79,84,1,-5,2017-11-24
BYU,Alabama,59,71,1,-12,2017-11-24
Northern Arizona,UC-Irvine,71,77,1,-6,2017-11-24
Abilene Christian,Campbell,85,80,0,5,2017-11-24
Maryland-Eastern Shore,Jackson State,66,63,0,3,2017-11-24
Nicholls State,UMBC,88,89,1,-1,2017-11-24
Tennessee,NC State,67,58,0,9,2017-11-24
Southeastern Louisiana,Samford,77,71,0,6,2017-11-24
UNC,Arkansas,87,68,0,19,2017-11-24
Portland State,Butler,69,71,1,-2,2017-11-24
Texas Southern,Clemson,77,84,1,-7,2017-11-24
Bryant,Hartford,78,73,0,5,2017-11-24
Spring Hill,New Orleans,67,74,1,-7,2017-11-24
Utah State,Northeastern,71,67,0,4,2017-11-24
Oral Roberts,Penn State,48,86,1,-38,2017-11-24
Seattle,Washington,84,89,1,-5,2017-11-24
Toledo,Cornell,77,80,1,-3,2017-11-24
Jacksonville,Fairfield,92,84,0,8,2017-11-24
North Texas,Georgia Tech,49,63,1,-14,2017-11-24
Eastern Michigan,Indiana,67,87,1,-20,2017-11-24
Alabama A&M,Niagara,74,96,1,-22,2017-11-24
Harvard,St. Joseph's,77,71,0,6,2017-11-24
Navy,St. Francis (NY),85,76,0,9,2017-11-24
Xavier,Arizona State,86,102,1,-16,2017-11-24
Central Connecticut,Cleveland State,74,73,0,1,2017-11-24
Loyola (IL),UNC Wilmington,102,78,0,24,2017-11-24
Bowling Green State,USC Upstate,83,74,0,9,2017-11-24
Duke,Texas,85,78,0,7,2017-11-24
UCF,West Virginia,45,83,1,-38,2017-11-24
Portland,Oklahoma,71,93,1,-22,2017-11-24
Norfolk State,Robert Morris,53,75,1,-22,2017-11-24
Southern Miss,South Dakota,71,84,1,-13,2017-11-24
Winthrop,Auburn,85,119,1,-34,2017-11-24
High Point,Charlotte,67,70,1,-3,2017-11-24
Denver,Florida Gulf Coast,71,79,1,-8,2017-11-24
Florida A&M,Green Bay,50,57,1,-7,2017-11-24
North Carolina Central,Illinois,73,86,1,-13,2017-11-24
Valparaiso,Kent State,77,67,0,10,2017-11-24
Saint Francis (PA),Louisville,72,84,1,-12,2017-11-24
Nebraska,Marist,84,59,0,25,2017-11-24
Mount St. Mary's,Ohio,77,96,1,-19,2017-11-24
Virginia,Rhode Island,70,55,0,15,2017-11-24
Georgia,San Diego State,68,75,1,-7,2017-11-24
Western Carolina,Texas-Arlington,65,89,1,-24,2017-11-24
New Mexico,TCU,67,69,1,-2,2017-11-24
UNC Greensboro,Wake Forest,75,81,1,-6,2017-11-24
SMU,Western Kentucky,61,63,1,-2,2017-11-24
Gardner-Webb,Wright State,47,67,1,-20,2017-11-24
Fontbonne,Eastern Illinois,44,96,1,-52,2017-11-24
Citadel,Florida State,78,113,1,-35,2017-11-24
Oakland,Kansas,59,102,1,-43,2017-11-24
George Washington,Kansas State,59,67,1,-8,2017-11-24
Evangel,Missouri State,48,80,1,-32,2017-11-24
Sacred Heart,Northwestern,50,81,1,-31,2017-11-24
Texas A&M-Corpus Christi,UTSA,58,72,1,-14,2017-11-24
Eastern Washington,Utah,69,85,1,-16,2017-11-24
Cal Poly,Central Michigan,53,56,1,-3,2017-11-24
Northwestern State,Colorado State,60,72,1,-12,2017-11-24
Oregon,DePaul,89,79,0,10,2017-11-24
St. Bonaventure,Maryland,63,61,0,2,2017-11-24
Youngstown State,Northern Colorado,67,80,1,-13,2017-11-24
Stanford,Ohio State,71,79,1,-8,2017-11-24
Arkansas-Pine Bluff,Pacific,69,78,1,-9,2017-11-24
Arizona,Purdue,64,89,1,-25,2017-11-24
Cal State Fullerton,Sacramento State,68,63,0,5,2017-11-24
Vanderbilt,Seton Hall,59,72,1,-13,2017-11-24
Pepperdine,Texas A&M,65,81,1,-16,2017-11-24
Milwaukee,Wisconsin,49,71,1,-22,2017-11-24
Prairie View,UCSB,66,69,1,-3,2017-11-24
Hampton,Rider,80,94,1,-14,2017-11-24
Idaho,Cal State Bakersfield,62,64,1,-2,2017-11-24
Texas State,Canisius,62,68,1,-6,2017-11-24
Florida,Gonzaga,111,105,0,6,2017-11-24
UConn,Michigan State,57,77,1,-20,2017-11-25
Nevada,Hawaii,67,54,0,13,2017-11-25
Jackson State,Omaha,75,73,0,2,2017-11-25
Central Arkansas,Tulsa,72,92,1,-20,2017-11-25
LIU-Brooklyn,Brown,86,94,1,-8,2017-11-25
Albany (NY),Holy Cross,78,62,0,16,2017-11-25
Ball State,Indiana State,93,85,0,8,2017-11-25
Utah State,New Hampshire,77,63,0,14,2017-11-25
Maryland-Eastern Shore,Tennessee Tech,60,90,1,-30,2017-11-25
Morehead State,Virginia Tech,63,96,1,-33,2017-11-25
Georgia Southern,Bradley,57,62,1,-5,2017-11-25
Bowling Green State,Campbell,78,72,0,6,2017-11-25
Columbia,Colgate,71,77,1,-6,2017-11-25
Siena Heights,Detroit,69,131,1,-62,2017-11-25
Gardner-Webb,Fairfield,64,75,1,-11,2017-11-25
Toccoa Falls,Liberty,50,96,1,-46,2017-11-25
BYU,UMass,68,66,0,2,2017-11-25
Southeastern Louisiana,Mississippi Valley State,73,59,0,14,2017-11-25
Lehigh,Pitt,68,80,1,-12,2017-11-25
Hofstra,Siena,76,85,1,-9,2017-11-25
Northwood (MI),Western Michigan,59,88,1,-29,2017-11-25
Vermont,Yale,79,73,0,6,2017-11-25
Utah Valley,North Dakota,83,75,0,8,2017-11-25
Furman,Northeastern,78,67,0,11,2017-11-25
Savannah State,Texas Tech,69,103,1,-34,2017-11-25
VMI,American,64,69,1,-5,2017-11-25
Robert Morris,Little Rock,78,64,0,14,2017-11-25
Florida College,Bethune-Cookman,67,95,1,-28,2017-11-25
SIU-Edwardsville,Creighton,66,103,1,-37,2017-11-25
Georgian Court,Delaware State,55,68,1,-13,2017-11-25
Purdue-Fort Wayne,ETSU,73,83,1,-10,2017-11-25
New Mexico,Maryland,65,80,1,-15,2017-11-25
Southern-New Orleans,McNeese State,79,103,1,-24,2017-11-25
North Florida,Miami (FL),65,86,1,-21,2017-11-25
Drexel,NJIT,53,65,1,-12,2017-11-25
James Madison,Radford,68,69,1,-1,2017-11-25
Sam Houston State,Santa Clara,73,59,0,14,2017-11-25
Denver,St. Francis (NY),60,50,0,10,2017-11-25
Alabama A&M,Western Carolina,72,82,1,-10,2017-11-25
Asbury,Eastern Kentucky,71,99,1,-28,2017-11-25
Loyola (IL),Kent State,75,60,0,15,2017-11-25
Alabama,Minnesota,84,89,1,-5,2017-11-25
Abilene Christian,USC Upstate,78,88,1,-10,2017-11-25
Jacksonville,Wright State,44,68,1,-24,2017-11-25
Southern Miss,Youngstown State,71,64,0,7,2017-11-25
College of Charleston,Alaska-Anchorage,55,46,0,9,2017-11-25
Concordia (AL),Alcorn State,56,103,1,-47,2017-11-25
Northern Kentucky,Memphis,74,76,1,-2,2017-11-25
Georgetown,Richmond,82,76,0,6,2017-11-25
Davidson,Appalachian State,62,78,1,-16,2017-11-25
Tennessee Wesleyan,Chattanooga,60,95,1,-35,2017-11-25
Akron,Dayton,60,73,1,-13,2017-11-25
Navy,Florida Gulf Coast,54,70,1,-16,2017-11-25
Tennessee State,Kennesaw State,77,74,0,3,2017-11-25
Penn,Monmouth,101,96,0,5,2017-11-25
Valparaiso,UNC Wilmington,79,70,0,9,2017-11-25
St. Thomas (TX),Rice,59,70,1,-11,2017-11-25
Northern Colorado,South Dakota,63,62,0,1,2017-11-25
TCU,St. Bonaventure,89,79,0,10,2017-11-25
Niagara,Texas-Arlington,90,95,1,-5,2017-11-25
Old Dominion,William & Mary,77,79,1,-2,2017-11-25
Incarnate Word,Houston,58,97,1,-39,2017-11-25
Western Illinois,Iowa State,45,70,1,-25,2017-11-25
Southern Illinois,Murray State,73,81,1,-8,2017-11-25
Stetson,North Dakota State,58,94,1,-36,2017-11-25
Boston College,Providence,66,86,1,-20,2017-11-25
Grambling,Texas-Rio Grande Valley,82,76,0,6,2017-11-25
Loyola Marymount,Boise State,48,68,1,-20,2017-11-25
San Diego,Grand Canyon,72,62,0,10,2017-11-25
Cal Poly,Idaho,66,75,1,-9,2017-11-25
Charleston Southern,Illinois State,64,62,0,2,2017-11-25
UTEP,New Mexico State,63,72,1,-9,2017-11-25
Texas State,Pacific,85,78,0,7,2017-11-25
Black Hills State,Weber State,52,105,1,-53,2017-11-25
Southern Utah,UNLV,82,101,1,-19,2017-11-25
Central Michigan,Cal State Bakersfield,75,72,0,3,2017-11-25
Arkansas-Pine Bluff,Canisius,58,81,1,-23,2017-11-25
Northern Colorado,Southern Miss,77,63,0,14,2017-11-26
St. John's (NY),UCF,46,43,0,3,2017-11-26
Tulane,Georgia State,59,70,1,-11,2017-11-26
Denver,Navy,71,79,1,-8,2017-11-26
Abilene Christian,Bowling Green State,88,83,0,5,2017-11-26
Texas,Gonzaga,71,76,1,-5,2017-11-26
Gardner-Webb,Jacksonville,99,106,1,-7,2017-11-26
Oklahoma,Oregon,90,80,0,10,2017-11-26
Hartwick,Binghamton,65,97,1,-32,2017-11-26
Princeton,Fairleigh Dickinson,83,76,0,7,2017-11-26
Manhattan,Fordham,57,70,1,-13,2017-11-26
Wagner,Hartford,72,50,0,22,2017-11-26
St. Peter's,Lafayette,86,82,0,4,2017-11-26
Loyola (MD),UMass-Lowell,75,83,1,-8,2017-11-26
Hiwassee,Mercer,53,90,1,-37,2017-11-26
Long Beach State,Nebraska,80,85,1,-5,2017-11-26
Maine,Quinnipiac,78,72,0,6,2017-11-26
St. Joseph's,Sacramento State,74,69,0,5,2017-11-26
Bucknell,Stony Brook,85,76,0,9,2017-11-26
Miami (OH),Austin Peay,61,86,1,-25,2017-11-26
Arkansas,UConn,102,67,0,35,2017-11-26
Chicago State,Drake,67,79,1,-12,2017-11-26
Montana State,Fresno State,67,80,1,-13,2017-11-26
North Carolina Wesleyan,Longwood,78,107,1,-29,2017-11-26
Jacksonville State,Mississippi State,56,59,1,-3,2017-11-26
Butler,Ohio State,67,66,0,1,2017-11-26
Houston Baptist,Oklahoma State,74,101,1,-27,2017-11-26
Mississippi Valley State,Samford,70,83,1,-13,2017-11-26
Youngstown State,South Dakota,53,81,1,-28,2017-11-26
Dakota State,South Dakota State,60,92,1,-32,2017-11-26
North Carolina Central,Southeast Missouri State,77,70,0,7,2017-11-26
Florida A&M,Stephen F. Austin,63,79,1,-16,2017-11-26
Fairfield,Wright State,56,57,1,-1,2017-11-26
Mississippi College,Alabama-Birmingham,53,90,1,-37,2017-11-26
Norfolk State,Little Rock,55,70,1,-15,2017-11-26
Wheaton (MA),Boston University,48,83,1,-35,2017-11-26
USC Upstate,Campbell,74,93,1,-19,2017-11-26
Air Force,Colorado,69,81,1,-12,2017-11-26
North Carolina A&T,East Carolina,87,81,0,6,2017-11-26
Concord,Marshall,70,106,1,-36,2017-11-26
UC-Riverside,Michigan,42,87,1,-45,2017-11-26
Wofford,UNC Asheville,65,85,1,-20,2017-11-26
Rockford,Northern Illinois,53,105,1,-52,2017-11-26
New Orleans,South Alabama,52,55,1,-3,2017-11-26
Eastern Michigan,South Florida,65,47,0,18,2017-11-26
Saint Mary's,Georgia,81,83,1,-2,2017-11-26
Temple,La Salle,83,87,1,-4,2017-11-26
Rust,Louisiana-Monroe,46,104,1,-58,2017-11-26
UMKC,UT-Martin,65,55,0,10,2017-11-26
Brown,Bryant,81,67,0,14,2017-11-26
St. Francis (NY),Florida Gulf Coast,51,75,1,-24,2017-11-26
UIC,Kentucky,73,107,1,-34,2017-11-26
Canisius,Pacific,58,80,1,-22,2017-11-26
UC-Irvine,UCLA,63,87,1,-24,2017-11-26
New Mexico Highlands,Wyoming,70,83,1,-13,2017-11-26
Portland,DePaul,69,82,1,-13,2017-11-26
Oregon State,Marist,65,46,0,19,2017-11-26
South Carolina State,Winthrop,61,86,1,-25,2017-11-26
UNC,Michigan State,45,63,1,-18,2017-11-26
UC-Davis,Washington,70,77,1,-7,2017-11-26
Harvard,Cal State Fullerton,61,70,1,-9,2017-11-26
Carroll,Montana,75,86,1,-11,2017-11-26
Portland State,Stanford,87,78,0,9,2017-11-26
Missouri,West Virginia,79,83,1,-4,2017-11-26
Duke,Florida,87,84,0,3,2017-11-26
Texas A&M,USC,75,59,0,16,2017-11-26
Washington State,San Diego State,93,86,0,7,2017-11-26
Shenandoah,UMBC,59,88,1,-29,2017-11-27
St. Mary's (MD),Towson,57,90,1,-33,2017-11-27
Lipscomb,Belmont,74,66,0,8,2017-11-27
Alabama State,Cincinnati,51,83,1,-32,2017-11-27
Yale,Delaware,76,66,0,10,2017-11-27
Cornell,Duquesne,78,71,0,7,2017-11-27
South Carolina,Florida International,78,61,0,17,2017-11-27
Saint Leo,Hampton,56,72,1,-16,2017-11-27
Howard,Liberty,55,75,1,-20,2017-11-27
Albany (NY),Monmouth,73,81,1,-8,2017-11-27
Morgan State,Mount St. Mary's,69,63,0,6,2017-11-27
Army,Niagara,71,77,1,-6,2017-11-27
Maryland-Eastern Shore,Old Dominion,44,83,1,-39,2017-11-27
Maryland,Syracuse,70,72,1,-2,2017-11-27
Morehead State,Central Arkansas,78,82,1,-4,2017-11-27
Stetson,Green Bay,83,71,0,12,2017-11-27
Eastern Illinois,Marquette,83,86,1,-3,2017-11-27
Blue Mountain College,Nicholls State,68,104,1,-36,2017-11-27
Grambling,North Texas,77,82,1,-5,2017-11-27
Oakland,Oral Roberts,93,86,0,7,2017-11-27
Texas-Dallas,Texas-Arlington,53,73,1,-20,2017-11-27
Delaware State,Troy,64,95,1,-31,2017-11-27
Lamar,UTEP,66,52,0,14,2017-11-27
Wisconsin,Virginia,37,49,1,-12,2017-11-27
Idaho State,Seattle,67,73,1,-6,2017-11-27
Adams State,Hawaii,77,87,1,-10,2017-11-27
Ave Maria,Florida Atlantic,54,91,1,-37,2017-11-28
Baylor,Xavier,63,76,1,-13,2017-11-28
Chattanooga,Akron,70,75,1,-5,2017-11-28
Oakland City,Ball State,57,81,1,-24,2017-11-28
VMI,Charleston Southern,76,68,0,8,2017-11-28
Davidson,Charlotte,85,70,0,15,2017-11-28
Loyola (MD),Dartmouth,63,64,1,-1,2017-11-28
Northwestern,Georgia Tech,51,52,1,-1,2017-11-28
Detroit,Purdue-Fort Wayne,82,91,1,-9,2017-11-28
LIU-Brooklyn,NJIT,69,73,1,-4,2017-11-28
Iona,Ohio,93,88,0,5,2017-11-28
High Point,Pitt,63,71,1,-8,2017-11-28
UNC Greensboro,Presbyterian,72,74,1,-2,2017-11-28
Brown,Rhode Island,62,86,1,-24,2017-11-28
Florida State,Rutgers,78,73,0,5,2017-11-28
Schreiner,Sam Houston State,55,81,1,-26,2017-11-28
Morris College,South Carolina State,91,100,1,-9,2017-11-28
Hannibal-LaGrange,Southeast Missouri State,59,83,1,-24,2017-11-28
Appalachian State,VCU,72,85,1,-13,2017-11-28
Maine,Georgetown,55,76,1,-21,2017-11-28
Dallas Christian,Houston Baptist,66,96,1,-30,2017-11-28
Toledo,Kansas,58,96,1,-38,2017-11-28
McNeese State,Louisiana,78,89,1,-11,2017-11-28
Jackson State,Louisiana-Monroe,52,65,1,-13,2017-11-28
South Dakota State,Ole Miss,99,97,0,2,2017-11-28
Colorado State,Missouri State,67,77,1,-10,2017-11-28
Harris-Stowe,Murray State,56,85,1,-29,2017-11-28
Presentation College,North Dakota,75,82,1,-7,2017-11-28
Louisville,Purdue,57,66,1,-9,2017-11-28
Western Michigan,Saint Louis,65,51,0,14,2017-11-28
Loyola (LA),Southeastern Louisiana,53,80,1,-27,2017-11-28
Texas-Rio Grande Valley,SMU,64,95,1,-31,2017-11-28
North Dakota State,Stephen F. Austin,50,54,1,-4,2017-11-28
Fisk,Tennessee State,53,67,1,-14,2017-11-28
UTSA,Tulsa,96,100,1,-4,2017-11-28
Utah State,Valparaiso,65,72,1,-7,2017-11-28
Radford,Vanderbilt,62,74,1,-12,2017-11-28
IUPUI,Western Illinois,77,90,1,-13,2017-11-28
Savannah State,Wichita State,66,112,1,-46,2017-11-28
Loyola (IL),Boise State,53,87,1,-34,2017-11-28
Iowa,Virginia Tech,55,79,1,-24,2017-11-28
Illinois,Wake Forest,73,80,1,-7,2017-11-28
Kennesaw State,Washington,71,85,1,-14,2017-11-28
Cal State Los Angeles,Loyola Marymount,66,87,1,-21,2017-11-28
UCSB,San Francisco,79,72,0,7,2017-11-28
Cal State Northridge,California,63,83,1,-20,2017-11-28
Colgate,Albany (NY),69,75,1,-6,2017-11-29
Central Arkansas,Little Rock,65,71,1,-6,2017-11-29
San Jose State,Bowling Green State,79,85,1,-6,2017-11-29
Arkansas State,Cleveland State,72,75,1,-3,2017-11-29
Wofford,Coastal Carolina,87,81,0,6,2017-11-29
Columbia,UConn,73,77,1,-4,2017-11-29
Auburn,Dayton,73,60,0,13,2017-11-29
Lafayette,Drexel,67,68,1,-1,2017-11-29
Webber,Florida Gulf Coast,61,115,1,-54,2017-11-29
Florida National University,Florida International,61,79,1,-18,2017-11-29
ETSU,Fordham,82,77,0,5,2017-11-29
Winthrop,Furman,93,74,0,19,2017-11-29
Morgan State,George Washington,66,73,1,-7,2017-11-29
Mid-Atlantic Christian,Hampton,54,117,1,-63,2017-11-29
Air Force,Indiana State,64,74,1,-10,2017-11-29
George Mason,James Madison,76,72,0,4,2017-11-29
Bluefield State,Longwood,59,84,1,-25,2017-11-29
Sacred Heart,UMass-Lowell,87,80,0,7,2017-11-29
Midway,Miami (OH),40,123,1,-83,2017-11-29
Boston University,New Hampshire,70,69,0,1,2017-11-29
Buffalo,Niagara,106,87,0,19,2017-11-29
Michigan,UNC,71,86,1,-15,2017-11-29
USC Upstate,UNC Asheville,70,82,1,-12,2017-11-29
Penn State,NC State,78,85,1,-7,2017-11-29
Eastern Michigan,North Florida,81,84,1,-3,2017-11-29
Berea,Northern Kentucky,33,112,1,-79,2017-11-29
Lyon,Northwestern State,56,67,1,-11,2017-11-29
Clemson,Ohio State,79,65,0,14,2017-11-29
Rider,Providence,84,88,1,-4,2017-11-29
UMass,Quinnipiac,66,68,1,-2,2017-11-29
Vermont,Richmond,71,65,0,6,2017-11-29
American,Saint Francis (PA),89,100,1,-11,2017-11-29
Bucknell,St. Joseph's,70,83,1,-13,2017-11-29
Fairleigh Dickinson,St. Peter's,53,77,1,-24,2017-11-29
St. Bonaventure,Siena,75,55,0,20,2017-11-29
Wiley,Southern,69,92,1,-23,2017-11-29
Shawnee State,Stony Brook,58,101,1,-43,2017-11-29
Mercer,Tennessee,60,84,1,-24,2017-11-29
Lipscomb,Tennessee Tech,80,86,1,-6,2017-11-29
Penn,Villanova,62,90,1,-28,2017-11-29
Marshall,William & Mary,104,114,1,-10,2017-11-29
Robert Morris,Youngstown State,81,74,0,7,2017-11-29
Louisiana Tech,Alabama,74,77,1,-3,2017-11-29
Georgia State,Alabama A&M,63,53,0,10,2017-11-29
Long Beach State,Arizona,56,91,1,-35,2017-11-29
Binghamton,Delaware State,85,64,0,21,2017-11-29
New Orleans,Houston,66,75,1,-9,2017-11-29
Oral Roberts,Kansas State,68,77,1,-9,2017-11-29
UT-Martin,LSU,60,84,1,-24,2017-11-29
Drake,Omaha,73,75,1,-2,2017-11-29
Kent State,Norfolk State,79,70,0,9,2017-11-29
UNLV,Northern Iowa,68,77,1,-9,2017-11-29
Austin Peay,Oklahoma State,63,79,1,-16,2017-11-29
Lehigh,Princeton,85,76,0,9,2017-11-29
Southern Miss,South Alabama,58,69,1,-11,2017-11-29
SIU-Edwardsville,Southern Illinois,59,86,1,-27,2017-11-29
Florida A&M,Texas,58,82,1,-24,2017-11-29
Rice,Texas-Arlington,49,69,1,-20,2017-11-29
Texas A&M-Corpus Christi,Texas State,53,66,1,-13,2017-11-29
UIC,Troy,66,87,1,-21,2017-11-29
Alcorn State,Tulane,65,81,1,-16,2017-11-29
Eastern Kentucky,Western Kentucky,51,83,1,-32,2017-11-29
Bryant,Yale,67,84,1,-17,2017-11-29
Wyoming,Denver,78,88,1,-10,2017-11-29
Incarnate Word,Gonzaga,68,103,1,-35,2017-11-29
Duke,Indiana,91,81,0,10,2017-11-29
Chicago State,Marquette,69,95,1,-26,2017-11-29
Miami (FL),Minnesota,86,81,0,5,2017-11-29
Bethesda University (CA),Montana State,61,98,1,-37,2017-11-29
Boston College,Nebraska,62,71,1,-9,2017-11-29
Evansville,New Mexico,59,78,1,-19,2017-11-29
Milwaukee,Northern Illinois,75,62,0,13,2017-11-29
Belmont,TCU,76,87,1,-11,2017-11-29
BYU,Utah Valley,85,58,0,27,2017-11-29
Northern Colorado,UC-Davis,51,56,1,-5,2017-11-29
Whittier,UC-Irvine,65,112,1,-47,2017-11-29
Illinois State,Nevada,68,98,1,-30,2017-11-29
Southern Utah,Pepperdine,88,82,0,6,2017-11-29
Montana,Stanford,54,70,1,-16,2017-11-29
Cal State Bakersfield,UCLA,66,75,1,-9,2017-11-29
Alice Lloyd,Morehead State,56,103,1,-47,2017-11-30
Seton Hall,Texas Tech,89,79,0,10,2017-11-30
North Carolina A&T,Central Connecticut,59,72,1,-13,2017-11-30
Western Carolina,College of Charleston,60,69,1,-9,2017-11-30
South Florida,Elon,78,79,1,-1,2017-11-30
Molloy,Hofstra,72,107,1,-35,2017-11-30
Central Pennsylvania College,Howard,64,81,1,-17,2017-11-30
Indiana-Kokomo,Purdue-Fort Wayne,63,99,1,-36,2017-11-30
Bethune-Cookman,Jacksonville,77,66,0,11,2017-11-30
Hartford,LIU-Brooklyn,78,79,1,-1,2017-11-30
Notre Dame,Michigan State,63,81,1,-18,2017-11-30
North Dakota State,Mississippi State,59,83,1,-24,2017-11-30
Christendom,North Carolina Central,38,116,1,-78,2017-11-30
Harvard,Northeastern,61,77,1,-16,2017-11-30
Texas Southern,Oakland,87,97,1,-10,2017-11-30
St. Thomas (TX),Sam Houston State,54,77,1,-23,2017-11-30
Carver Bible,Savannah State,60,98,1,-38,2017-11-30
New Rochelle,St. Francis (NY),79,104,1,-25,2017-11-30
Campbell,Stetson,85,78,0,7,2017-11-30
NJIT,West Virginia,69,102,1,-33,2017-11-30
Memphis,Alabama-Birmingham,56,71,1,-15,2017-11-30
UNC Wilmington,East Carolina,88,93,1,-5,2017-11-30
Alabama State,Jacksonville State,69,77,1,-8,2017-11-30
South Dakota,UMKC,82,63,0,19,2017-11-30
North Texas,Oklahoma,72,82,1,-10,2017-11-30
Texas-Rio Grande Valley,Texas A&M,60,78,1,-18,2017-11-30
Ottawa,UTSA,64,125,1,-61,2017-11-30
Missouri,UCF,62,59,0,3,2017-11-30
South Carolina,Temple,60,76,1,-16,2017-11-30
Pacific,UC-Riverside,57,55,0,2,2017-11-30
Weber State,Fresno State,71,83,1,-12,2017-11-30
Multnomah,Portland,65,112,1,-47,2017-11-30
Northern Arizona,Santa Clara,57,89,1,-32,2017-11-30
Kennesaw State,Seattle,54,66,1,-12,2017-11-30
New Mexico State,UTEP,80,60,0,20,2017-11-30
San Diego State,San Diego,66,57,0,9,2017-11-30
Holy Cross,Manhattan,54,70,1,-16,2017-12-01
Towson,La Salle,67,60,0,7,2017-12-01
Marist,Citadel,100,91,0,9,2017-12-01
Army,UMBC,81,70,0,11,2017-12-01
Jackson State,Central Michigan,63,70,1,-7,2017-12-01
Grambling,Georgia Tech,64,63,0,1,2017-12-01
Johnson & Wales (NC),High Point,54,90,1,-36,2017-12-01
Purdue,Maryland,80,75,0,5,2017-12-01
Delaware,Navy,76,82,1,-6,2017-12-01
Coppin State,Ohio,37,80,1,-43,2017-12-01
Duquesne,Pitt,64,76,1,-12,2017-12-01
Edward Waters,Stetson,52,85,1,-33,2017-12-01
Fairfield,Wagner,76,78,1,-2,2017-12-01
Rust,Alcorn State,50,89,1,-39,2017-12-01
Eastern Illinois,Bradley,56,67,1,-11,2017-12-01
UNC,Davidson,85,75,0,10,2017-12-01
Louisiana,Nicholls State,105,80,0,25,2017-12-01
Texas Lutheran,Texas A&M-Corpus Christi,42,80,1,-38,2017-12-01
Bethesda University (CA),Idaho State,71,92,1,-21,2017-12-01
Illinois,Northwestern,68,72,1,-4,2017-12-01
Boise State,Oregon,73,70,0,3,2017-12-01
Creighton,Gonzaga,74,91,1,-17,2017-12-01
Holy Cross,La Salle,54,58,1,-4,2017-12-02
Indiana,Michigan,55,69,1,-14,2017-12-02
South Carolina State,NC State,71,103,1,-32,2017-12-02
Manhattan,Towson,55,56,1,-1,2017-12-02
Lehigh,Virginia,54,75,1,-21,2017-12-02
Cincinnati,Xavier,76,89,1,-13,2017-12-02
Colorado,Colorado State,63,72,1,-9,2017-12-02
Fairleigh Dickinson,Iona,75,82,1,-7,2017-12-02
UNC Greensboro,Liberty,76,75,0,1,2017-12-02
Bryant,New Hampshire,59,75,1,-16,2017-12-02
Radford,VMI,63,50,0,13,2017-12-02
IUPUI,Ball State,64,83,1,-19,2017-12-02
Wichita State,Baylor,69,62,0,7,2017-12-02
Green Bay,Belmont,75,86,1,-11,2017-12-02
Colgate,Binghamton,65,76,1,-11,2017-12-02
Central Connecticut,Brown,68,62,0,6,2017-12-02
St. Bonaventure,Buffalo,73,62,0,11,2017-12-02
Saint Louis,Butler,45,75,1,-30,2017-12-02
Youngstown State,DePaul,73,89,1,-16,2017-12-02
Oakland City,Evansville,56,98,1,-42,2017-12-02
Maine,Fordham,66,67,1,-1,2017-12-02
Quinnipiac,Lafayette,58,79,1,-21,2017-12-02
Georgia,Marquette,73,66,0,7,2017-12-02
Virginia Tech,Ole Miss,83,80,0,3,2017-12-02
Robert Morris,Siena,74,76,1,-2,2017-12-02
UMass,South Carolina,70,76,1,-6,2017-12-02
Oakland,Western Michigan,78,73,0,5,2017-12-02
Reinhardt,Winthrop,76,107,1,-31,2017-12-02
Northern Illinois,Chicago State,95,77,0,18,2017-12-02
UMBC,Citadel,98,72,0,26,2017-12-02
Air Force,Denver,61,59,0,2,2017-12-02
South Dakota,Duke,80,96,1,-16,2017-12-02
USC Upstate,Gardner-Webb,66,87,1,-21,2017-12-02
Harvard,Kentucky,70,79,1,-9,2017-12-02
Fayetteville State,Longwood,52,61,1,-9,2017-12-02
Williams Baptist,New Orleans,70,87,1,-17,2017-12-02
Texas-Rio Grande Valley,Rice,69,67,0,2,2017-12-02
UC-Davis,Washington State,81,67,0,14,2017-12-02
Oral Roberts,Little Rock,74,66,0,8,2017-12-02
Alabama A&M,Austin Peay,47,67,1,-20,2017-12-02
Dartmouth,Canisius,60,73,1,-13,2017-12-02
Monmouth,UConn,81,84,1,-3,2017-12-02
Rider,Drexel,77,89,1,-12,2017-12-02
Tennessee Tech,Furman,50,64,1,-14,2017-12-02
Tulsa,Illinois State,58,65,1,-7,2017-12-02
UIC,Loyola (IL),61,85,1,-24,2017-12-02
American,Maryland-Eastern Shore,70,74,1,-4,2017-12-02
Montana State,Milwaukee,68,64,0,4,2017-12-02
Loyola (MD),Mount St. Mary's,75,80,1,-5,2017-12-02
Cornell,Northeastern,66,84,1,-18,2017-12-02
Portland Bible College,Portland State,50,125,1,-75,2017-12-02
North Carolina A&T,Presbyterian,70,73,1,-3,2017-12-02
William & Mary,Savannah State,108,85,0,23,2017-12-02
San Jose State,Southern Illinois,58,76,1,-18,2017-12-02
Sacred Heart,St. John's (NY),55,90,1,-35,2017-12-02
Louisiana-Monroe,Stephen F. Austin,65,68,1,-3,2017-12-02
Richmond,Wake Forest,53,82,1,-29,2017-12-02
Schreiner,Abilene Christian,43,71,1,-28,2017-12-02
UT-Martin,Chattanooga,63,66,1,-3,2017-12-02
Delaware State,East Carolina,57,63,1,-6,2017-12-02
Tennessee Wesleyan,Georgia Southern,61,97,1,-36,2017-12-02
Penn State,Iowa,77,73,0,4,2017-12-02
Army,Marist,82,75,0,7,2017-12-02
Mercer,Memphis,81,83,1,-2,2017-12-02
Loyola Marymount,Oregon State,74,78,1,-4,2017-12-02
Providence,Rhode Island,68,75,1,-7,2017-12-02
Villanova,St. Joseph's,94,53,0,41,2017-12-02
Kansas,Syracuse,76,60,0,16,2017-12-02
Wright State,Western Kentucky,60,78,1,-18,2017-12-02
Ohio State,Wisconsin,83,58,0,25,2017-12-02
Jacksonville,Eastern Kentucky,65,70,1,-5,2017-12-02
Bowling Green State,Norfolk State,92,77,0,15,2017-12-02
Drake,Wyoming,89,96,1,-7,2017-12-02
Columbia,Albany (NY),82,86,1,-4,2017-12-02
South Florida,Appalachian State,61,84,1,-23,2017-12-02
Vermont,Bucknell,77,81,1,-4,2017-12-02
Lamar,Coastal Carolina,69,67,0,2,2017-12-02
St. Peter's,Elon,65,71,1,-6,2017-12-02
Bethune-Cookman,Florida Atlantic,75,93,1,-18,2017-12-02
Middle Tennessee,Florida Gulf Coast,81,76,0,5,2017-12-02
South Alabama,Florida International,58,87,1,-29,2017-12-02
Boston College,Hartford,73,61,0,12,2017-12-02
Arkansas,Houston,65,91,1,-26,2017-12-02
Cleveland State,Kent State,62,72,1,-10,2017-12-02
Fresno State,Long Beach State,106,70,0,36,2017-12-02
Miles,Louisiana Tech,55,106,1,-51,2017-12-02
Akron,Marshall,64,86,1,-22,2017-12-02
Southeast Missouri State,North Carolina Central,86,77,0,9,2017-12-02
Trinity Baptist,North Florida,58,85,1,-27,2017-12-02
Morehead State,Northern Kentucky,49,86,1,-37,2017-12-02
Saint Francis (PA),Stony Brook,83,85,1,-2,2017-12-02
Texas Southern,Toledo,69,71,1,-2,2017-12-02
Hawaii,Utah,60,80,1,-20,2017-12-02
Old Dominion,VCU,75,82,1,-7,2017-12-02
Texas State,Houston Baptist,52,71,1,-19,2017-12-02
Charlotte,James Madison,82,87,1,-5,2017-12-02
Princeton,Miami (FL),52,80,1,-28,2017-12-02
Florida A&M,Murray State,59,80,1,-21,2017-12-02
Missouri State,South Dakota State,73,53,0,20,2017-12-02
San Diego Christian,Southern Utah,68,87,1,-19,2017-12-02
Lipscomb,Tennessee State,95,86,0,9,2017-12-02
North Texas,Texas-Arlington,60,65,1,-5,2017-12-02
Yale,TCU,66,92,1,-26,2017-12-02
Miami (OH),Western Illinois,76,73,0,3,2017-12-02
San Francisco,Arizona State,57,75,1,-18,2017-12-02
Cal Lutheran,Cal State Fullerton,58,86,1,-28,2017-12-02
UC-Riverside,Grand Canyon,56,68,1,-12,2017-12-02
New Mexico,UTEP,76,88,1,-12,2017-12-02
BYU,Utah State,75,66,0,9,2017-12-02
UTSA,Utah Valley,80,88,1,-8,2017-12-02
Pepperdine,Cal Poly,81,91,1,-10,2017-12-02
Northern Arizona,Cal State Bakersfield,60,52,0,8,2017-12-02
Nevada,UC-Irvine,76,65,0,11,2017-12-02
San Diego,UCSB,57,67,1,-10,2017-12-02
Arizona,UNLV,91,88,0,3,2017-12-02
Arkansas-Pine Bluff,Santa Clara,57,72,1,-15,2017-12-02
USC,SMU,55,72,1,-17,2017-12-02
Saint Mary's,California,74,63,0,11,2017-12-02
Morgan State,Navy,59,66,1,-7,2017-12-03
UCF,Alabama,65,62,0,3,2017-12-03
Temple,George Washington,67,71,1,-4,2017-12-03
SIU-Edwardsville,Purdue-Fort Wayne,71,86,1,-15,2017-12-03
UMass-Lowell,NJIT,65,78,1,-13,2017-12-03
Tulane,UNC,73,97,1,-24,2017-12-03
St. Francis (NY),Notre Dame,53,71,1,-18,2017-12-03
Kansas State,Vanderbilt,84,79,0,5,2017-12-03
George Mason,Auburn,63,79,1,-16,2017-12-03
UNC Asheville,Clemson,52,83,1,-31,2017-12-03
Samford,Jacksonville State,58,89,1,-31,2017-12-03
Mississippi Valley State,Oklahoma State,62,83,1,-21,2017-12-03
Rust,Southern Miss,61,109,1,-48,2017-12-03
Portland,Boise State,54,77,1,-23,2017-12-03
Seton Hall,Louisville,79,77,0,2,2017-12-03
Nebraska,Michigan State,57,86,1,-29,2017-12-03
Northwestern,Purdue,69,74,1,-5,2017-12-03
Eastern Washington,Seattle,65,84,1,-19,2017-12-03
Stanford,Long Beach State,68,76,1,-8,2017-12-03
Coppin State,Georgetown,60,76,1,-16,2017-12-03
Tennessee,Georgia Tech,77,70,0,7,2017-12-03
Rutgers,Minnesota,67,89,1,-22,2017-12-03
Prairie View,New Mexico State,57,69,1,-12,2017-12-03
Arkansas-Fort Smith,Pacific,68,105,1,-37,2017-12-03
Bradley,San Diego State,52,75,1,-23,2017-12-03
Idaho,Nicholls State,79,68,0,11,2017-12-03
Western State,Northern Colorado,75,87,1,-12,2017-12-03
Omaha,Washington,73,86,1,-13,2017-12-03
Maryland,Illinois,92,91,0,1,2017-12-03
Dayton,Mississippi State,59,61,1,-2,2017-12-03
Cal State Northridge,Montana,68,86,1,-18,2017-12-03
Detroit,UCLA,73,106,1,-33,2017-12-03
Michigan,Ohio State,62,71,1,-9,2017-12-04
High Point,College of Charleston,58,70,1,-12,2017-12-04
Quinnipiac,Columbia,89,87,0,2,2017-12-04
Maryland-Eastern Shore,Duquesne,61,86,1,-25,2017-12-04
Campbell,East Carolina,66,69,1,-3,2017-12-04
Liberty,Georgia State,77,74,0,3,2017-12-04
Penn,Howard,81,68,0,13,2017-12-04
Stony Brook,LIU-Brooklyn,71,75,1,-4,2017-12-04
Wisconsin,Penn State,64,63,0,1,2017-12-04
Appalachian State,Western Carolina,71,72,1,-1,2017-12-04
Sam Houston State,Baylor,56,84,1,-28,2017-12-04
Tougaloo,Grambling,95,111,1,-16,2017-12-04
Iowa,Indiana,64,77,1,-13,2017-12-04
Belmont,Lipscomb,54,69,1,-15,2017-12-04
Missouri State,North Dakota State,71,58,0,13,2017-12-04
UTSA,Oklahoma,85,97,1,-12,2017-12-04
Western State,Air Force,67,79,1,-12,2017-12-04
Florida State,Florida,83,66,0,17,2017-12-04
Northern Illinois,Iowa State,80,94,1,-14,2017-12-04
Sacramento State,Saint Mary's,54,70,1,-16,2017-12-04
Central Arkansas,San Francisco,76,78,1,-2,2017-12-04
Pacific Lutheran,Seattle,69,99,1,-30,2017-12-04
James Madison,Citadel,82,84,1,-2,2017-12-05
Dartmouth,Sacred Heart,73,79,1,-6,2017-12-05
Evansville,Bowling Green State,91,76,0,15,2017-12-05
Montana State,Central Michigan,48,75,1,-27,2017-12-05
Wake Forest,Charlotte,80,57,0,23,2017-12-05
VMI,Davidson,51,74,1,-23,2017-12-05
Florida Atlantic,Florida Gulf Coast,92,88,0,4,2017-12-05
UNC Asheville,Furman,72,83,1,-11,2017-12-05
Winthrop,Georgia,82,87,1,-5,2017-12-05
Villanova,Gonzaga,88,72,0,16,2017-12-05
Milwaukee,Jacksonville,62,52,0,10,2017-12-05
Maine-Presque Isle,Maine,55,75,1,-20,2017-12-05
Vermont,Marquette,81,91,1,-10,2017-12-05
Chattanooga,Marshall,66,70,1,-4,2017-12-05
Boston University,Miami (FL),54,69,1,-15,2017-12-05
Niagara,New Hampshire,78,70,0,8,2017-12-05
Bucknell,Northeastern,64,82,1,-18,2017-12-05
Ball State,Notre Dame,80,77,0,3,2017-12-05
Mount St. Mary's,Pitt,78,82,1,-4,2017-12-05
South Carolina State,Presbyterian,77,88,1,-11,2017-12-05
Michigan State,Rutgers,62,52,0,10,2017-12-05
Texas,VCU,71,67,0,4,2017-12-05
UMass-Lowell,Wagner,72,90,1,-18,2017-12-05
Virginia,West Virginia,61,68,1,-7,2017-12-05
Ohio Valley,Wright State,68,98,1,-30,2017-12-05
Colorado State,Arkansas,66,92,1,-26,2017-12-05
UT-Martin,Arkansas State,92,78,0,14,2017-12-05
North Dakota,Creighton,68,111,1,-43,2017-12-05
Texas Lutheran,Incarnate Word,63,91,1,-28,2017-12-05
USC Upstate,Kansas State,49,86,1,-37,2017-12-05
St. Thomas (TX),Lamar,46,60,1,-14,2017-12-05
Samford,Memphis,64,65,1,-1,2017-12-05
Nevada,Texas Tech,76,82,1,-6,2017-12-05
Alabama-Birmingham,Troy,90,78,0,12,2017-12-05
South Dakota State,Wichita State,85,95,1,-10,2017-12-05
Texas A&M,Arizona,64,67,1,-3,2017-12-05
Utah,Butler,69,81,1,-12,2017-12-05
Syracuse,UConn,72,63,0,9,2017-12-05
San Jose State,Denver,56,58,1,-2,2017-12-05
Saint Francis (PA),Duke,67,124,1,-57,2017-12-05
Miami (OH),Missouri,51,70,1,-19,2017-12-05
Minnesota,Nebraska,68,78,1,-10,2017-12-05
SMU,TCU,83,94,1,-11,2017-12-05
Omaha,UCSB,70,77,1,-7,2017-12-05
Cal State Bakersfield,Fresno State,55,70,1,-15,2017-12-05
Oral Roberts,UNLV,66,92,1,-26,2017-12-05
Eastern Kentucky,Oregon State,62,74,1,-12,2017-12-05
UC-Riverside,Pepperdine,59,70,1,-11,2017-12-05
St. John's (NY),Grand Canyon,68,60,0,8,2017-12-05
Fairfield,Houston,66,88,1,-22,2017-12-06
Southern,Tulane,76,95,1,-19,2017-12-06
Radford,Virginia Tech,68,95,1,-27,2017-12-06
Purdue-Fort Wayne,Akron,79,83,1,-4,2017-12-06
Bryant,Albany (NY),68,84,1,-16,2017-12-06
Army,Binghamton,66,71,1,-5,2017-12-06
St. Bonaventure,Canisius,73,65,0,8,2017-12-06
Navy,Coppin State,70,53,0,17,2017-12-06
Tennessee Tech,Dayton,66,79,1,-13,2017-12-06
Buffalo,Delaware,75,72,0,3,2017-12-06
UMBC,Delaware State,81,60,0,21,2017-12-06
Toledo,Detroit,89,86,0,3,2017-12-06
Northern Kentucky,ETSU,71,84,1,-13,2017-12-06
Oakland,Eastern Michigan,89,95,1,-6,2017-12-06
Loyola (MD),Florida State,71,96,1,-25,2017-12-06
Harvard,Fordham,47,45,0,2,2017-12-06
William & Mary,George Mason,77,70,0,7,2017-12-06
Princeton,George Washington,60,71,1,-11,2017-12-06
Coastal Carolina,Hampton,85,81,0,4,2017-12-06
SIU-Edwardsville,IUPUI,82,81,0,1,2017-12-06
Yale,Lehigh,86,77,0,9,2017-12-06
Stephen F. Austin,Louisiana Tech,85,83,0,2,2017-12-06
Siena,Louisville,60,86,1,-26,2017-12-06
Colgate,Marist,76,78,1,-2,2017-12-06
Holy Cross,UMass,50,64,1,-14,2017-12-06
Hofstra,Monmouth,85,84,0,1,2017-12-06
Western Carolina,UNC,61,104,1,-43,2017-12-06
Richmond,Old Dominion,60,79,1,-19,2017-12-06
Brown,Providence,72,77,1,-5,2017-12-06
Rider,Robert Morris,75,78,1,-3,2017-12-06
Houston Baptist,St. Peter's,74,76,1,-2,2017-12-06
Wyoming,South Carolina,64,80,1,-16,2017-12-06
UMKC,Southeast Missouri State,87,91,1,-4,2017-12-06
Wisconsin,Temple,55,59,1,-4,2017-12-06
Morgan State,Towson,78,82,1,-4,2017-12-06
Cleveland State,Western Michigan,67,78,1,-11,2017-12-06
Georgia Tech,Wofford,60,63,1,-3,2017-12-06
Kent State,Xavier,70,96,1,-26,2017-12-06
Rhode Island,Alabama,64,68,1,-4,2017-12-06
Gardner-Webb,Auburn,55,80,1,-25,2017-12-06
Stetson,Duquesne,59,73,1,-14,2017-12-06
Loyola (IL),Florida,65,59,0,6,2017-12-06
Eastern Illinois,Green Bay,57,59,1,-2,2017-12-06
Austin Peay,Illinois,57,64,1,-7,2017-12-06
Wisconsin-Parkside,UIC,48,76,1,-28,2017-12-06
Penn,Lafayette,73,68,0,5,2017-12-06
Loyola (LA),Louisiana,56,98,1,-42,2017-12-06
Indiana State,North Texas,76,79,1,-3,2017-12-06
San Diego Christian,Northern Arizona,70,79,1,-9,2017-12-06
Southern Illinois,Saint Louis,69,74,1,-5,2017-12-06
Drake,South Dakota,65,93,1,-28,2017-12-06
Long Beach State,Southern Utah,89,94,1,-5,2017-12-06
Texas A&M-Corpus Christi,Texas-Rio Grande Valley,78,82,1,-4,2017-12-06
McMurry,Texas State,50,100,1,-50,2017-12-06
Middle Tennessee,Vanderbilt,66,63,0,3,2017-12-06
American,Western Illinois,56,69,1,-13,2017-12-06
Abilene Christian,Air Force,62,58,0,4,2017-12-06
Illinois State,BYU,68,80,1,-12,2017-12-06
New Mexico,Colorado,57,75,1,-18,2017-12-06
Central Connecticut,DePaul,57,85,1,-28,2017-12-06
Cal State Northridge,Idaho State,66,74,1,-8,2017-12-06
Washington,Kansas,74,65,0,9,2017-12-06
San Diego,New Mexico State,65,60,0,5,2017-12-06
UC-Irvine,Utah State,59,62,1,-3,2017-12-06
Weber State,Utah Valley,56,83,1,-27,2017-12-06
Central Arkansas,California,96,69,0,27,2017-12-06
Pacific,UC-Davis,67,71,1,-4,2017-12-06
Washington State,Idaho,64,91,1,-27,2017-12-06
Portland State,Loyola Marymount,94,85,0,9,2017-12-06
Cal State Fullerton,Portland,76,66,0,10,2017-12-06
Antelope Valley,Sacramento State,74,97,1,-23,2017-12-06
Prairie View,Hawaii,60,72,1,-12,2017-12-06
Valparaiso,Purdue,50,80,1,-30,2017-12-07
Brevard,South Carolina State,65,93,1,-28,2017-12-07
Stony Brook,Columbia,76,66,0,10,2017-12-07
Quinnipiac,Hartford,75,77,1,-2,2017-12-07
Drexel,La Salle,72,70,0,2,2017-12-07
Ohio,Maryland,62,87,1,-25,2017-12-07
Elon,UNC Greensboro,44,75,1,-31,2017-12-07
NJIT,Rutgers,64,73,1,-9,2017-12-07
Howard,Georgetown,67,81,1,-14,2017-12-07
Iowa,Iowa State,78,84,1,-6,2017-12-07
Texas-Arlington,Northern Iowa,58,62,1,-4,2017-12-07
Eastern Washington,San Francisco,71,81,1,-10,2017-12-07
Life Pacific,Cal State Bakersfield,71,100,1,-29,2017-12-08
Concorida (NE),South Dakota State,67,103,1,-36,2017-12-08
Boston University,Bethune-Cookman,90,87,0,3,2017-12-08
Maryland-Eastern Shore,Liberty,49,71,1,-22,2017-12-08
Dartmouth,Maine,73,66,0,7,2017-12-08
Army,Wake Forest,80,109,1,-29,2017-12-08
St. John's (NY),Arizona State,70,82,1,-12,2017-12-08
Hampton,Missouri State,75,88,1,-13,2017-12-08
Southern Nazarene,Oral Roberts,68,60,0,8,2017-12-08
Air Force,UC-Riverside,48,67,1,-19,2017-12-08
Colorado State,Oregon,65,95,1,-30,2017-12-08
Oklahoma,USC,85,83,0,2,2017-12-08
Nevada,TCU,80,84,1,-4,2017-12-09
Duke,Boston College,84,89,1,-5,2017-12-09
Youngstown State,Butler,67,95,1,-28,2017-12-09
Delaware State,Duquesne,48,97,1,-49,2017-12-09
Monmouth,Kentucky,76,93,1,-17,2017-12-09
Gardner-Webb,Maryland,60,82,1,-22,2017-12-09
UCLA,Michigan,69,78,1,-9,2017-12-09
William & Mary,Ohio State,62,97,1,-35,2017-12-09
Coastal Carolina,South Carolina,78,80,1,-2,2017-12-09
Marquette,Wisconsin,82,63,0,19,2017-12-09
Southern,UCF,60,76,1,-16,2017-12-09
Tennessee Tech,Central Michigan,69,74,1,-5,2017-12-09
Stetson,Marist,79,76,0,3,2017-12-09
Bryant,Memphis,72,90,1,-18,2017-12-09
Purdue-Fort Wayne,Miami (OH),73,81,1,-8,2017-12-09
Central Connecticut,Northern Illinois,55,61,1,-6,2017-12-09
Longwood,VMI,70,81,1,-11,2017-12-09
Valparaiso,Ball State,70,71,1,-1,2017-12-09
UMass-Lowell,Brown,75,89,1,-14,2017-12-09
Central Pennsylvania College,Buffalo,54,88,1,-34,2017-12-09
Coppin State,UConn,59,72,1,-13,2017-12-09
Nebraska,Creighton,65,75,1,-10,2017-12-09
Western Michigan,Detroit,87,79,0,8,2017-12-09
Central State (OH),Eastern Michigan,65,80,1,-15,2017-12-09
Canisius,Evansville,58,65,1,-7,2017-12-09
North Carolina A&T,Georgetown,74,83,1,-9,2017-12-09
Montana,Georgia State,68,71,1,-3,2017-12-09
Louisiana-Monroe,Jacksonville State,56,75,1,-19,2017-12-09
Mount St. Mary's,Lehigh,60,75,1,-15,2017-12-09
Indiana,Louisville,62,71,1,-9,2017-12-09
UMKC,NC State,69,88,1,-19,2017-12-09
Yale,St. Bonaventure,67,75,1,-8,2017-12-09
Colgate,Syracuse,58,72,1,-14,2017-12-09
St. Joseph's,Temple,78,81,1,-3,2017-12-09
Lipscomb,Tennessee,71,81,1,-10,2017-12-09
UMBC,Towson,65,78,1,-13,2017-12-09
Samford,Clemson,59,81,1,-22,2017-12-09
Penn,Dayton,78,70,0,8,2017-12-09
USC Upstate,Denver,69,84,1,-15,2017-12-09
St. Francis (NY),Fordham,68,76,1,-8,2017-12-09
New Hampshire,Holy Cross,58,62,1,-4,2017-12-09
Providence,UMass,63,72,1,-9,2017-12-09
Chicago State,Oakland,50,82,1,-32,2017-12-09
Lafayette,Sacred Heart,50,62,1,-12,2017-12-09
VCU,Seton Hall,67,90,1,-23,2017-12-09
Rice,Stephen F. Austin,62,81,1,-19,2017-12-09
Florida Gulf Coast,Texas-Arlington,85,78,0,7,2017-12-09
Kent State,Wright State,54,63,1,-9,2017-12-09
Howard,American,63,74,1,-11,2017-12-09
Alabama-Birmingham,Auburn,80,85,1,-5,2017-12-09
Sacramento State,Boise State,54,77,1,-23,2017-12-09
South Carolina State,Furman,72,101,1,-29,2017-12-09
North Carolina Central,George Mason,65,77,1,-12,2017-12-09
DePaul,UIC,65,55,0,10,2017-12-09
Murray State,Illinois State,78,72,0,6,2017-12-09
Indianapolis,Indiana State,75,79,1,-4,2017-12-09
Norfolk State,Loyola (IL),52,80,1,-28,2017-12-09
Binghamton,Loyola (MD),77,64,0,13,2017-12-09
Florida A&M,Mercer,64,82,1,-18,2017-12-09
UCSB,Montana State,91,69,0,22,2017-12-09
Iona,NJIT,74,70,0,4,2017-12-09
Vermont,Northeastern,67,71,1,-4,2017-12-09
Wichita State,Oklahoma State,78,66,0,12,2017-12-09
George Washington,Penn State,54,74,1,-20,2017-12-09
Erskine,Radford,49,76,1,-27,2017-12-09
Prairie View,Texas A&M,53,73,1,-20,2017-12-09
Texas State,Abilene Christian,68,72,1,-4,2017-12-09
William Jessup,UC-Davis,52,86,1,-34,2017-12-09
Savannah State,Georgia Southern,91,102,1,-11,2017-12-09
Howard Payne,Lamar,56,112,1,-56,2017-12-09
Northwestern State,Louisiana College,88,58,0,30,2017-12-09
North Georgia,Mississippi State,62,95,1,-33,2017-12-09
California,San Diego State,63,62,0,1,2017-12-09
Colorado,Xavier,69,96,1,-27,2017-12-09
Minnesota,Arkansas,79,95,1,-16,2017-12-09
Florida,Cincinnati,66,60,0,6,2017-12-09
Omaha,Drake,74,93,1,-19,2017-12-09
Florida National University,Jacksonville,51,89,1,-38,2017-12-09
Southern Utah,Michigan State,63,88,1,-25,2017-12-09
Ole Miss,Middle Tennessee,58,77,1,-19,2017-12-09
McNeese State,North Texas,47,85,1,-38,2017-12-09
Pacific,Wyoming,72,86,1,-14,2017-12-09
Appalachian State,Akron,89,94,1,-5,2017-12-09
Hillsdale,Baylor,82,105,1,-23,2017-12-09
Notre Dame,Delaware,92,68,0,24,2017-12-09
Jackson State,Louisiana Tech,62,91,1,-29,2017-12-09
Morgan State,Manhattan,66,80,1,-14,2017-12-09
Bowling Green State,Old Dominion,46,88,1,-42,2017-12-09
Hofstra,Rider,88,82,0,6,2017-12-09
Fairleigh Dickinson,Rutgers,54,92,1,-38,2017-12-09
Albany (NY),Siena,74,69,0,5,2017-12-09
Marshall,Toledo,93,87,0,6,2017-12-09
Utah State,Utah,67,77,1,-10,2017-12-09
Johnson & Wales (NC),Wofford,45,104,1,-59,2017-12-09
Henderson State,Arkansas State,76,90,1,-14,2017-12-09
Little Rock,Central Arkansas,54,69,1,-15,2017-12-09
Tulsa,Kansas State,61,54,0,7,2017-12-09
North Dakota State,North Dakota,88,79,0,9,2017-12-09
West Virginia,Pitt,69,60,0,9,2017-12-09
Houston,Saint Louis,77,58,0,19,2017-12-09
Seattle,Saint Mary's,73,97,1,-24,2017-12-09
Southeast Missouri State,Southern Illinois,75,69,0,6,2017-12-09
UC-Irvine,Texas-Rio Grande Valley,59,73,1,-14,2017-12-09
Houston Baptist,UTSA,71,87,1,-16,2017-12-09
Milwaukee,Western Illinois,69,90,1,-21,2017-12-09
Utah Valley,Cal State Fullerton,83,91,1,-8,2017-12-09
Grambling,Grand Canyon,53,87,1,-34,2017-12-09
Northwest Nazarene,Idaho State,57,73,1,-16,2017-12-09
Green Bay,Missouri,77,100,1,-23,2017-12-09
New Mexico State,New Mexico,65,62,0,3,2017-12-09
Washington State,UTEP,69,76,1,-7,2017-12-09
Alabama,Arizona,82,88,1,-6,2017-12-09
Fresno State,Cal Poly,83,63,0,20,2017-12-09
Idaho,Cal State Bakersfield,55,66,1,-11,2017-12-09
Loyola Marymount,Cal State Northridge,74,57,0,17,2017-12-09
Arkansas-Pine Bluff,Oregon State,58,85,1,-27,2017-12-09
Long Beach State,Pepperdine,78,71,0,7,2017-12-09
San Jose State,Portland,55,64,1,-9,2017-12-09
Northern Arizona,San Diego,51,79,1,-28,2017-12-09
Portland State,Santa Clara,87,84,0,3,2017-12-09
BYU,Weber State,74,68,0,6,2017-12-09
Hawaii-Hilo,Hawaii,64,82,1,-18,2017-12-09
Illinois,UNLV,82,89,1,-7,2017-12-09
Webber,Florida Atlantic,46,106,1,-60,2017-12-10
Tulane,Florida State,53,72,1,-19,2017-12-10
Charlotte,Chattanooga,50,64,1,-14,2017-12-10
Navy,Columbia,73,68,0,5,2017-12-10
La Salle,Villanova,68,77,1,-9,2017-12-10
Notre Dame (CA),Cleveland State,56,89,1,-33,2017-12-10
North Greenville,College of Charleston,60,92,1,-32,2017-12-10
Hiwassee,ETSU,48,94,1,-46,2017-12-10
Toccoa Falls,High Point,39,110,1,-71,2017-12-10
Arizona State,Kansas,95,85,0,10,2017-12-10
Maine-Machias,Maine,51,104,1,-53,2017-12-10
Saint Francis (PA),Niagara,93,87,0,6,2017-12-10
Western Kentucky,Ohio,84,89,1,-5,2017-12-10
James Madison,Richmond,71,74,1,-3,2017-12-10
Drexel,Robert Morris,60,74,1,-14,2017-12-10
Eastern Washington,South Dakota,73,75,1,-2,2017-12-10
Fairfield,LIU-Brooklyn,76,72,0,4,2017-12-10
Milligan,UNC Asheville,60,97,1,-37,2017-12-10
South Alabama,SIU-Edwardsville,75,76,1,-1,2017-12-10
Troy,Southern Miss,71,89,1,-18,2017-12-10
Cincinnati-Clermont,UT-Martin,92,127,1,-35,2017-12-10
Maryland-Eastern Shore,Virginia Tech,40,93,1,-53,2017-12-10
Missouri State,Oral Roberts,66,73,1,-7,2017-12-10
Mercy,Wagner,41,75,1,-34,2017-12-10
Southern,Iowa,60,91,1,-31,2017-12-10
UNC Wilmington,LSU,84,97,1,-13,2017-12-10
Dubuque,Northern Iowa,47,80,1,-33,2017-12-10
Alcorn State,Iowa State,58,78,1,-20,2017-12-10
Eastern Kentucky,Northern Kentucky,63,91,1,-28,2017-12-10
Panhandle State,Northern Colorado,53,104,1,-51,2017-12-10
IUPUI,Purdue,61,86,1,-25,2017-12-10
Gonzaga,Washington,97,70,0,27,2017-12-10
North Florida,Florida A&M,101,89,0,12,2017-12-11
Sacred Heart,Hartford,72,86,1,-14,2017-12-11
Fisk,Jackson State,53,60,1,-7,2017-12-11
Bryant,Louisville,59,102,1,-43,2017-12-11
Chicago State,Northwestern,31,96,1,-65,2017-12-11
Florida International,South Florida,65,53,0,12,2017-12-11
Siena,Vermont,57,81,1,-24,2017-12-11
Drake,Minnesota,67,68,1,-1,2017-12-11
Alabama A&M,DePaul,59,83,1,-24,2017-12-11
North Carolina Central,Grand Canyon,59,64,1,-5,2017-12-11
Texas Southern,Oregon,68,74,1,-6,2017-12-11
Kentucky Christian,Morehead State,57,85,1,-28,2017-12-12
Charleston Southern,South Carolina State,88,91,1,-3,2017-12-12
Cal Poly,Bethune-Cookman,53,67,1,-14,2017-12-12
Columbia,Boston College,66,81,1,-15,2017-12-12
Southeastern Louisiana,UCF,53,61,1,-8,2017-12-12
Mississippi State,Cincinnati,50,65,1,-15,2017-12-12
NJIT,Colgate,76,87,1,-11,2017-12-12
Georgia Southern,George Mason,74,51,0,23,2017-12-12
Point,Georgia State,70,90,1,-20,2017-12-12
Green Bay,Indiana State,63,85,1,-22,2017-12-12
Yale,Iona,67,83,1,-16,2017-12-12
Louisiana,Louisiana Tech,75,71,0,4,2017-12-12
Catholic,Maryland,59,76,1,-17,2017-12-12
Coppin State,UMBC,74,81,1,-7,2017-12-12
Monmouth,Princeton,58,69,1,-11,2017-12-12
Fordham,Rutgers,63,75,1,-12,2017-12-12
St. Peter's,Seton Hall,61,84,1,-23,2017-12-12
Army,St. Francis (NY),76,64,0,12,2017-12-12
Hofstra,Stony Brook,84,81,0,3,2017-12-12
Tennessee State,Alabama State,64,45,0,19,2017-12-12
Fisk,Alcorn State,69,77,1,-8,2017-12-12
San Diego,Colorado,69,59,0,10,2017-12-12
Grambling,Louisiana-Monroe,57,59,1,-2,2017-12-12
Valley City State,North Dakota State,58,101,1,-43,2017-12-12
Murray State,Saint Louis,55,69,1,-14,2017-12-12
North Dakota,South Dakota State,63,99,1,-36,2017-12-12
Albany (NY),Memphis,58,67,1,-9,2017-12-12
Eastern New Mexico,New Mexico State,62,84,1,-22,2017-12-12
Michigan,Texas,59,52,0,7,2017-12-12
Eastern Washington,Wyoming,88,93,1,-5,2017-12-12
Jacksonville State,Oregon State,69,70,1,-1,2017-12-12
Boston University,UMass-Lowell,82,87,1,-5,2017-12-13
Milwaukee,Belmont,63,82,1,-19,2017-12-13
Mississippi Valley State,Duquesne,49,73,1,-24,2017-12-13
UNC Wilmington,UNC Greensboro,58,71,1,-13,2017-12-13
Florida International,North Florida,85,87,1,-2,2017-12-13
Villanova,Temple,87,67,0,20,2017-12-13
Southern Miss,Alabama A&M,69,54,0,15,2017-12-13
Little Rock,Bradley,46,86,1,-40,2017-12-13
Longwood,Illinois,45,92,1,-47,2017-12-13
Sam Houston State,Ole Miss,69,82,1,-13,2017-12-13
Arkansas State,Omaha,74,77,1,-3,2017-12-13
Jackson State,Southern Illinois,51,69,1,-18,2017-12-13
New Orleans,SMU,66,79,1,-13,2017-12-13
Savannah State,Texas A&M,66,113,1,-47,2017-12-13
Western Kentucky,Wisconsin,80,81,1,-1,2017-12-13
Grand Canyon,Boise State,80,85,1,-5,2017-12-13
Houston,LSU,77,80,1,-3,2017-12-13
Denver,Northern Colorado,63,83,1,-20,2017-12-13
Kennesaw State,Texas Tech,53,82,1,-29,2017-12-13
Arkansas-Pine Bluff,Fresno State,52,78,1,-26,2017-12-13
Portland State,Oregon,84,95,1,-11,2017-12-13
Saint Martin's,Seattle,72,88,1,-16,2017-12-13
St. Edward's,Rice,86,91,1,-5,2017-12-14
Washington Adventist,Howard,65,76,1,-11,2017-12-14
Citadel,Campbell,77,87,1,-10,2017-12-14
Montreat,Furman,47,103,1,-56,2017-12-14
Florida College,Lipscomb,68,100,1,-32,2017-12-14
Mid-Atlantic Christian,Norfolk State,34,112,1,-78,2017-12-14
McNeese State,North Carolina Central,71,77,1,-6,2017-12-14
Toccoa Falls,Presbyterian,35,104,1,-69,2017-12-14
Bethune-Cookman,South Florida,63,83,1,-20,2017-12-14
Florida A&M,Southern,50,68,1,-18,2017-12-14
Southern Wesleyan,VMI,52,90,1,-38,2017-12-14
Texas Southern,Baylor,68,99,1,-31,2017-12-14
Valparaiso,Northwestern,50,84,1,-34,2017-12-14
Southern-New Orleans,Southeastern Louisiana,77,106,1,-29,2017-12-14
Prairie View,Tulsa,73,77,1,-4,2017-12-14
South Dakota,Northern Arizona,90,77,0,13,2017-12-14
Bethesda University (CA),Utah Valley,44,106,1,-62,2017-12-14
Santa Clara,USC,59,82,1,-23,2017-12-14
Eastern Kentucky,Charleston Southern,70,65,0,5,2017-12-15
Washington College,Mount St. Mary's,67,89,1,-22,2017-12-15
Tennessee State,North Carolina A&T,54,64,1,-10,2017-12-15
Little Rock,Sam Houston State,55,57,1,-2,2017-12-15
South Dakota State,Colorado,103,112,1,-9,2017-12-15
Maryland-Eastern Shore,Creighton,36,87,1,-51,2017-12-15
Barclay,Houston Baptist,65,100,1,-35,2017-12-15
Dartmouth,UIC,60,76,1,-16,2017-12-15
Thomas University,Samford,51,98,1,-47,2017-12-15
St. Mary's (TX),Texas A&M-Corpus Christi,55,71,1,-16,2017-12-15
Simon Fraser University,Idaho,54,73,1,-19,2017-12-15
Denver,Stanford,62,75,1,-13,2017-12-15
UC-Davis,San Francisco,61,74,1,-13,2017-12-15
Michigan,Detroit,90,58,0,32,2017-12-16
Miami (FL),George Washington,59,50,0,9,2017-12-16
Syracuse,Georgetown,86,79,0,7,2017-12-16
Louisville,Memphis,81,72,0,9,2017-12-16
UNC Greensboro,NC State,81,76,0,5,2017-12-16
Butler,Purdue,67,82,1,-15,2017-12-16
Seton Hall,Rutgers,65,71,1,-6,2017-12-16
Indiana State,Western Kentucky,65,81,1,-16,2017-12-16
Point,Citadel,66,110,1,-44,2017-12-16
Kentucky Christian,Liberty,40,96,1,-56,2017-12-16
Stephen F. Austin,LSU,83,82,0,1,2017-12-16
Mississippi Valley State,Akron,63,81,1,-18,2017-12-16
Winthrop,Alabama State,88,80,0,8,2017-12-16
Robert Morris,Buffalo,70,86,1,-16,2017-12-16
Montreat,Coastal Carolina,70,83,1,-13,2017-12-16
Northwestern,DePaul,62,60,0,2,2017-12-16
Oklahoma State,Florida State,71,70,0,1,2017-12-16
Drake,Iowa,64,90,1,-26,2017-12-16
Stetson,Purdue-Fort Wayne,84,88,1,-4,2017-12-16
Virginia Tech,Kentucky,86,93,1,-7,2017-12-16
Cornell,Longwood,69,62,0,7,2017-12-16
Loyola (IL),Milwaukee,56,73,1,-17,2017-12-16
Indiana,Notre Dame,80,77,0,3,2017-12-16
Michigan State,Oakland,86,73,0,13,2017-12-16
McNeese State,Pitt,51,72,1,-21,2017-12-16
Central Michigan,Southern Utah,80,86,1,-6,2017-12-16
Louisiana Tech,Texas,60,75,1,-15,2017-12-16
Wright State,Toledo,77,69,0,8,2017-12-16
Davidson,Virginia,60,80,1,-20,2017-12-16
ETSU,Xavier,66,68,1,-2,2017-12-16
Alabama A&M,Alabama-Birmingham,58,90,1,-32,2017-12-16
Pepperdine,Belmont,62,79,1,-17,2017-12-16
Bradley,Chicago State,84,58,0,26,2017-12-16
Georgia,UMass,62,72,1,-10,2017-12-16
Illinois State,Ole Miss,101,97,0,4,2017-12-16
Lyndon State,New Hampshire,31,111,1,-80,2017-12-16
Grambling,Southeastern Louisiana,68,67,0,1,2017-12-16
Cincinnati,UCLA,77,63,0,14,2017-12-16
Cal State Fullerton,California,89,95,1,-6,2017-12-16
Florida,Clemson,69,71,1,-2,2017-12-16
Austin Peay,Evansville,74,78,1,-4,2017-12-16
UMKC,Incarnate Word,73,77,1,-4,2017-12-16
Northern Iowa,Iowa State,65,76,1,-11,2017-12-16
USC Upstate,Jacksonville State,61,77,1,-16,2017-12-16
Fairleigh Dickinson,NJIT,68,71,1,-3,2017-12-16
Niagara,Norfolk State,85,82,0,3,2017-12-16
Linfield,Portland State,71,116,1,-45,2017-12-16
College of Charleston,Rhode Island,62,68,1,-6,2017-12-16
Wagner,Rider,84,90,1,-6,2017-12-16
Eastern Illinois,South Alabama,52,63,1,-11,2017-12-16
Jacksonville,South Carolina State,74,83,1,-9,2017-12-16
Vermont,St. Bonaventure,79,81,1,-2,2017-12-16
SUNY-Maritime,St. Francis (NY),67,88,1,-21,2017-12-16
Oklahoma,Wichita State,91,83,0,8,2017-12-16
Georgia Southern,Cal State Bakersfield,53,55,1,-2,2017-12-16
William Carey,Southern Miss,58,75,1,-17,2017-12-16
Drexel,Temple,60,63,1,-3,2017-12-16
Middle Tennessee,Auburn,70,76,1,-6,2017-12-16
Oregon,Fresno State,68,61,0,7,2017-12-16
Northwestern State,Louisiana State-Shreveport,84,85,1,-1,2017-12-16
Appalachian State,Ohio State,67,80,1,-13,2017-12-16
Bucknell,VCU,79,85,1,-6,2017-12-16
IUPUI,Washington State,59,72,1,-13,2017-12-16
Canisius,Albany (NY),65,68,1,-3,2017-12-16
Georgia State,Dayton,83,88,1,-5,2017-12-16
Arkansas State,Florida Atlantic,64,63,0,1,2017-12-16
James Madison,Florida International,76,67,0,9,2017-12-16
Wisconsin-Parkside,Green Bay,50,86,1,-36,2017-12-16
Bethune-Cookman,Kennesaw State,74,81,1,-7,2017-12-16
Eastern Michigan,Long Beach State,85,80,0,5,2017-12-16
Culver-Stockton,Nicholls State,51,92,1,-41,2017-12-16
Manhattan,Tulsa,66,80,1,-14,2017-12-16
Troy,Arkansas,63,88,1,-25,2017-12-16
Oral Roberts,Florida Gulf Coast,83,64,0,19,2017-12-16
North Dakota,Gonzaga,83,89,1,-6,2017-12-16
New Mexico State,Illinois,74,69,0,5,2017-12-16
Southeast Missouri State,Kansas State,71,89,1,-18,2017-12-16
New Orleans,Louisiana,65,87,1,-22,2017-12-16
Ohio,Marshall,96,99,1,-3,2017-12-16
UT-Martin,Mississippi State,61,92,1,-31,2017-12-16
North Florida,Missouri,51,85,1,-34,2017-12-16
Marist,Murray State,63,100,1,-37,2017-12-16
Kansas,Nebraska,73,72,0,1,2017-12-16
Arizona,New Mexico,89,73,0,16,2017-12-16
UC-Irvine,Saint Mary's,66,73,1,-7,2017-12-16
Texas-Arlington,Texas-Rio Grande Valley,86,65,0,21,2017-12-16
Bethany College (KS),UTSA,67,95,1,-28,2017-12-16
Rice,Texas Tech,53,73,1,-20,2017-12-16
Life Pacific,Utah State,62,96,1,-34,2017-12-16
Arkansas-Pine Bluff,Weber State,74,96,1,-22,2017-12-16
Princeton,Cal Poly,80,60,0,20,2017-12-16
Saint Louis,Oregon State,60,63,1,-3,2017-12-16
UNLV,Pacific,81,76,0,5,2017-12-16
North Texas,San Diego,86,83,0,3,2017-12-16
Portland,Seattle,76,89,1,-13,2017-12-16
Texas Southern,Wyoming,66,72,1,-6,2017-12-16
Utah,BYU,65,77,1,-12,2017-12-16
North Carolina A&T,Duquesne,58,74,1,-16,2017-12-17
St. Peter's,LIU-Brooklyn,71,56,0,15,2017-12-17
Northern Kentucky,UMBC,75,76,1,-1,2017-12-17
Air Force,Army,54,79,1,-25,2017-12-17
Central Connecticut,Boston College,65,84,1,-19,2017-12-17
Elon,Boston University,77,69,0,8,2017-12-17
Siena,Bryant,87,68,0,19,2017-12-17
Old Dominion,Fairfield,82,77,0,5,2017-12-17
Binghamton,Sacred Heart,51,48,0,3,2017-12-17
Vanderbilt,Arizona State,64,76,1,-12,2017-12-17
Gardner-Webb,Hampton,80,79,0,1,2017-12-17
Abilene Christian,Lipscomb,65,67,1,-2,2017-12-17
Rio Grande,Miami (OH),70,109,1,-39,2017-12-17
Central Arkansas,Morehead State,94,98,1,-4,2017-12-17
Cornell (IA),Omaha,58,99,1,-41,2017-12-17
Furman,UNC Wilmington,90,84,0,6,2017-12-17
Stony Brook,Providence,60,62,1,-2,2017-12-17
Milligan,William & Mary,69,126,1,-57,2017-12-17
High Point,Wofford,57,70,1,-13,2017-12-17
Savannah State,Baylor,86,118,1,-32,2017-12-17
UC-Riverside,Montana,61,77,1,-16,2017-12-17
UNC,Tennessee,78,73,0,5,2017-12-17
Chattanooga,Tennessee Tech,76,82,1,-6,2017-12-17
Cal State Northridge,Eastern Washington,58,86,1,-28,2017-12-17
Midway,Evansville,52,79,1,-27,2017-12-17
Penn State,George Mason,72,54,0,18,2017-12-17
Florida A&M,Georgia Tech,54,79,1,-25,2017-12-17
Prairie View,Houston,72,92,1,-20,2017-12-17
Mercer,La Salle,85,95,1,-10,2017-12-17
Western Carolina,UNC Asheville,76,72,0,4,2017-12-17
Maine,St. Joseph's,59,72,1,-13,2017-12-17
Lamar,Southern Illinois,61,71,1,-10,2017-12-17
Iona,St. John's (NY),59,69,1,-10,2017-12-17
Texas State,Colorado State,58,66,1,-8,2017-12-17
Radford,Nevada,62,77,1,-15,2017-12-17
South Dakota,San Jose State,76,62,0,14,2017-12-17
San Francisco,Stanford,59,71,1,-12,2017-12-17
Loyola Marymount,Washington,78,80,1,-2,2017-12-17
Delaware,Delaware State,68,59,0,9,2017-12-17
UCSB,USC,87,98,1,-11,2017-12-17
Utah Valley,Hawaii,69,70,1,-1,2017-12-17
Coastal Georgia,USC Upstate,75,83,1,-8,2017-12-18
Houston Baptist,Michigan State,62,107,1,-45,2017-12-18
Mount St. Mary's,American,59,56,0,3,2017-12-18
University of the Ozarks,Little Rock,49,94,1,-45,2017-12-18
Wake Forest,Coastal Carolina,84,80,0,4,2017-12-18
Quinnipiac,Drexel,71,72,1,-1,2017-12-18
Charlotte,East Carolina,69,50,0,19,2017-12-18
Charleston Southern,Florida State,58,69,1,-11,2017-12-18
Omaha,Kansas,64,109,1,-45,2017-12-18
Northeastern,Kent State,81,69,0,12,2017-12-18
Susquehanna,Lafayette,70,82,1,-12,2017-12-18
Northern Illinois,Marquette,70,79,1,-9,2017-12-18
Bethany (WV),Saint Francis (PA),77,113,1,-36,2017-12-18
Northern Arizona,South Florida,56,70,1,-14,2017-12-18
Idaho,Western Michigan,82,52,0,30,2017-12-18
Blue Mountain College,Alcorn State,56,83,1,-27,2017-12-18
Norfolk State,Eastern Kentucky,66,83,1,-17,2017-12-18
Rockford,Green Bay,64,108,1,-44,2017-12-18
Purdue-Fort Wayne,Indiana,92,72,0,20,2017-12-18
Howard,Jacksonville State,60,62,1,-2,2017-12-18
Millsaps,Louisiana-Monroe,44,97,1,-53,2017-12-18
Panhandle State,New Orleans,59,107,1,-48,2017-12-18
Asbury,Samford,70,99,1,-29,2017-12-18
Nicholls State,Tulane,69,76,1,-7,2017-12-18
North Dakota State,Arizona,53,83,1,-30,2017-12-18
Texas-Arlington,Creighton,81,90,1,-9,2017-12-18
IUPUI,Gonzaga,71,101,1,-30,2017-12-18
Mississippi Valley State,Grand Canyon,38,71,1,-33,2017-12-18
Youngstown State,Idaho State,62,86,1,-24,2017-12-18
Denver,Montana State,65,79,1,-14,2017-12-18
Boise State,SMU,63,86,1,-23,2017-12-18
Tennessee State,Texas,46,47,1,-1,2017-12-18
Texas Southern,TCU,72,91,1,-19,2017-12-18
Cal State Monterey Bay,Fresno State,56,93,1,-37,2017-12-18
Valparaiso,Santa Clara,76,68,0,8,2017-12-18
UCF,Stetson,74,55,0,19,2017-12-19
Marshall,Xavier,77,81,1,-4,2017-12-19
North Florida,Ball State,65,79,1,-14,2017-12-19
Elon,Canisius,51,67,1,-16,2017-12-19
Arkansas-Pine Bluff,Cincinnati,49,77,1,-28,2017-12-19
South Carolina,Clemson,48,64,1,-16,2017-12-19
South Carolina State,College of Charleston,64,80,1,-16,2017-12-19
ETSU,Detroit,81,73,0,8,2017-12-19
Lamar,Duquesne,64,65,1,-1,2017-12-19
Florida Gulf Coast,Florida International,88,91,1,-3,2017-12-19
Iona,Holy Cross,82,68,0,14,2017-12-19
Georgia Southern,Kennesaw State,78,69,0,9,2017-12-19
Texas A&M-Corpus Christi,Ole Miss,63,85,1,-22,2017-12-19
Cleveland State,Niagara,77,79,1,-2,2017-12-19
UNC Asheville,UNC Greensboro,67,60,0,7,2017-12-19
Robert Morris,NC State,69,81,1,-12,2017-12-19
Dartmouth,Notre Dame,87,97,1,-10,2017-12-19
Citadel,Ohio State,65,94,1,-29,2017-12-19
Northwestern State,Oklahoma,68,105,1,-37,2017-12-19
Binghamton,Penn State,65,80,1,-15,2017-12-19
Delaware State,Pitt,68,74,1,-6,2017-12-19
Bucknell,Richmond,86,78,0,8,2017-12-19
Buffalo,Syracuse,74,81,1,-7,2017-12-19
Savannah State,Virginia,47,78,1,-31,2017-12-19
Winthrop,VCU,55,69,1,-14,2017-12-19
Presbyterian,Virginia Tech,55,63,1,-8,2017-12-19
High Point,Western Carolina,72,61,0,11,2017-12-19
Arlington Baptist,Abilene Christian,60,109,1,-49,2017-12-19
Oral Roberts,Arkansas,69,104,1,-35,2017-12-19
Troy,Austin Peay,73,75,1,-2,2017-12-19
Morehead State,Butler,69,85,1,-16,2017-12-19
Western Illinois,Eastern Illinois,77,78,1,-1,2017-12-19
UIC,Illinois State,70,71,1,-1,2017-12-19
Southeastern Louisiana,Louisiana,74,82,1,-8,2017-12-19
Sam Houston State,LSU,58,80,1,-22,2017-12-19
Central Michigan,UMKC,92,86,0,6,2017-12-19
Wright State,Missouri State,50,66,1,-16,2017-12-19
Auburn,Murray State,81,77,0,4,2017-12-19
Lewis,Northwestern,48,85,1,-37,2017-12-19
Campbell,Saint Louis,66,74,1,-8,2017-12-19
Drake,South Dakota State,74,87,1,-13,2017-12-19
North Carolina A&T,Southern Illinois,64,102,1,-38,2017-12-19
Chicago State,SIU-Edwardsville,76,88,1,-12,2017-12-19
Cal Poly,SMU,64,84,1,-20,2017-12-19
Northern Kentucky,Texas A&M,58,64,1,-6,2017-12-19
McNeese State,Texas College,84,68,0,16,2017-12-19
Ecclesia,Texas State,43,85,1,-42,2017-12-19
Florida Atlantic,Texas Tech,54,90,1,-36,2017-12-19
Belmont,Western Kentucky,75,72,0,3,2017-12-19
Arkansas State,Wichita State,80,89,1,-9,2017-12-19
Mercer,Alabama,79,80,1,-1,2017-12-19
Longwood,Arizona State,61,95,1,-34,2017-12-19
Arkansas-Fort Smith,Colorado State,73,87,1,-14,2017-12-19
Georgia Tech,Georgia,59,80,1,-21,2017-12-19
Southern Utah,Iowa,64,92,1,-28,2017-12-19
Stephen F. Austin,Missouri,81,82,1,-1,2017-12-19
UC-Irvine,Montana,68,86,1,-18,2017-12-19
Rice,New Mexico,69,78,1,-9,2017-12-19
Tulsa,Oklahoma State,59,71,1,-12,2017-12-19
Incarnate Word,UTEP,66,72,1,-6,2017-12-19
South Dakota,UCLA,82,85,1,-3,2017-12-19
Pepperdine,Weber State,67,72,1,-5,2017-12-19
Northern Colorado,Wyoming,91,84,0,7,2017-12-19
San Diego Christian,UCSB,69,87,1,-18,2017-12-19
UC-Davis,Nevada,73,88,1,-15,2017-12-19
Hartford,Portland,67,78,1,-11,2017-12-19
Cal State Northridge,Sacramento State,61,66,1,-5,2017-12-19
Dayton,Saint Mary's,54,69,1,-15,2017-12-19
Radford,San Francisco,41,52,1,-11,2017-12-19
California,Seattle,81,59,0,22,2017-12-19
Bethune-Cookman,Washington,55,106,1,-51,2017-12-19
Princeton,USC,103,93,0,10,2017-12-19
Toccoa Falls,Gardner-Webb,41,102,1,-61,2017-12-20
Bradley,Southeast Missouri State,75,67,0,8,2017-12-20
St. Joseph's,St. John's (NY),73,77,1,-4,2017-12-20
Houston,Providence,70,59,0,11,2017-12-20
Maine,Central Connecticut,57,84,1,-27,2017-12-20
Lafayette,Cornell,71,80,1,-9,2017-12-20
Cal State Bakersfield,Delaware,62,76,1,-14,2017-12-20
Evansville,Duke,40,104,1,-64,2017-12-20
James Madison,Florida,63,72,1,-9,2017-12-20
New Hampshire,George Washington,64,68,1,-4,2017-12-20
North Texas,Georgetown,63,75,1,-12,2017-12-20
Appalachian State,Hampton,53,86,1,-33,2017-12-20
Manhattan,Hofstra,63,61,0,2,2017-12-20
Maryland-Eastern Shore,Iowa State,49,55,1,-6,2017-12-20
Northern Arizona,Jacksonville,83,72,0,11,2017-12-20
Georgia State,UMass,71,63,0,8,2017-12-20
Towson,Oakland,86,97,1,-11,2017-12-20
Prairie View,Ohio,65,84,1,-19,2017-12-20
Wagner,Seton Hall,68,89,1,-21,2017-12-20
Northeastern,St. Bonaventure,65,84,1,-19,2017-12-20
Jackson State,Toledo,57,83,1,-26,2017-12-20
Houston Baptist,Vanderbilt,48,81,1,-33,2017-12-20
Coppin State,West Virginia,38,77,1,-39,2017-12-20
New Orleans,Alabama-Birmingham,67,74,1,-7,2017-12-20
Southern,Baylor,60,80,1,-20,2017-12-20
Centenary (LA),Louisiana-Monroe,51,74,1,-23,2017-12-20
Siena,Memphis,66,70,1,-4,2017-12-20
Little Rock,Mississippi State,48,64,1,-16,2017-12-20
UTSA,Nebraska,94,104,1,-10,2017-12-20
Mobile,Nicholls State,52,96,1,-44,2017-12-20
Blue Mountain College,UT-Martin,76,84,1,-8,2017-12-20
USC Upstate,Creighton,62,116,1,-54,2017-12-20
Great Falls,Eastern Washington,66,94,1,-28,2017-12-20
Albany (NY),Louisville,68,70,1,-2,2017-12-20
Wofford,UNC,79,75,0,4,2017-12-20
Furman,Tennessee,61,66,1,-5,2017-12-20
Northwestern State,Utah,62,84,1,-22,2017-12-20
Youngstown State,Utah State,74,91,1,-17,2017-12-20
Montana Tech,Utah Valley,56,84,1,-28,2017-12-20
Valparaiso,UC-Riverside,60,73,1,-13,2017-12-20
Mississippi Valley State,UNLV,63,95,1,-32,2017-12-20
Central Arkansas,Oregon,82,96,1,-14,2017-12-20
Kansas State,Washington State,68,65,0,3,2017-12-20
Liberty,Purdue-Fort Wayne,64,75,1,-11,2017-12-21
Chattanooga,Jacksonville State,70,67,0,3,2017-12-21
South Alabama,Tulane,73,77,1,-4,2017-12-21
St. Francis (IL),Eastern Illinois,38,74,1,-36,2017-12-21
Southern Miss,Florida State,45,98,1,-53,2017-12-21
Piedmont,Presbyterian,60,77,1,-17,2017-12-21
Louisiana Tech,Alabama State,74,62,0,12,2017-12-21
Southeastern,UNC Greensboro,67,85,1,-18,2017-12-21
Tennessee State,Purdue,48,97,1,-49,2017-12-21
Western Illinois,Butler,46,107,1,-61,2017-12-21
South Carolina State,UCF,64,89,1,-25,2017-12-21
Johnson & Wales (NC),Charleston Southern,58,102,1,-44,2017-12-21
Cleveland State,Cincinnati,62,81,1,-19,2017-12-21
Grambling,East Carolina,68,76,1,-8,2017-12-21
Florida A&M,Fordham,69,79,1,-10,2017-12-21
Bowling Green State,Green Bay,81,78,0,3,2017-12-21
Boston University,Harvard,63,74,1,-11,2017-12-21
Samford,Kennesaw State,66,71,1,-5,2017-12-21
Oregon State,Kent State,78,79,1,-1,2017-12-21
Drexel,Loyola (MD),62,66,1,-4,2017-12-21
American,Marquette,51,92,1,-41,2017-12-21
Fairleigh Dickinson,Maryland,50,75,1,-25,2017-12-21
Long Beach State,Michigan State,60,102,1,-42,2017-12-21
Lipscomb,Navy,73,64,0,9,2017-12-21
North Dakota State,UNC Wilmington,100,63,0,37,2017-12-21
Southeastern Louisiana,Notre Dame,50,86,1,-36,2017-12-21
Iona,Rhode Island,74,80,1,-6,2017-12-21
Lehigh,Saint Francis (PA),70,84,1,-14,2017-12-21
Charlotte,South Florida,76,78,1,-2,2017-12-21
Arlington Baptist,Stephen F. Austin,66,116,1,-50,2017-12-21
Milligan,Troy,67,80,1,-13,2017-12-21
Quinnipiac,Vermont,73,80,1,-7,2017-12-21
Longwood,Grand Canyon,56,86,1,-30,2017-12-21
Tennessee Tech,Indiana,59,87,1,-28,2017-12-21
Oral Roberts,Minnesota,63,77,1,-14,2017-12-21
Montana State,Omaha,71,84,1,-13,2017-12-21
UIC,Northern Illinois,63,69,1,-6,2017-12-21
Portland,Sacramento State,80,75,0,5,2017-12-21
Northland,South Dakota,42,88,1,-46,2017-12-21
Cal Poly,Texas-Arlington,56,77,1,-21,2017-12-21
UConn,Arizona,58,73,1,-15,2017-12-21
Idaho State,BYU,71,85,1,-14,2017-12-21
Idaho,UC-Irvine,59,67,1,-8,2017-12-21
Miami (OH),DePaul,66,83,1,-17,2017-12-21
Alabama A&M,Michigan,47,97,1,-50,2017-12-21
Buffalo,Texas A&M,73,89,1,-16,2017-12-21
Howard,UTEP,56,69,1,-13,2017-12-21
Gonzaga,San Diego State,70,72,1,-2,2017-12-21
San Jose State,Santa Clara,75,63,0,12,2017-12-21
Portland State,California,106,81,0,25,2017-12-21
Kansas,Stanford,75,54,0,21,2017-12-21
Bryant,Dartmouth,58,75,1,-17,2017-12-22
Indiana-Kokomo,IUPUI,76,87,1,-11,2017-12-22
Liberty,Alabama State,87,70,0,17,2017-12-22
Temple,Georgia,66,84,1,-18,2017-12-22
Texas-Rio Grande Valley,Oklahoma State,83,102,1,-19,2017-12-22
Utah Valley,Sam Houston State,75,64,0,11,2017-12-22
Allen,Campbell,62,91,1,-29,2017-12-22
Pittsburgh-Bradford,Colgate,52,103,1,-51,2017-12-22
Bryn Athyn,NJIT,53,99,1,-46,2017-12-22
Pacific,Arizona State,65,104,1,-39,2017-12-22
Marist,Brown,69,90,1,-21,2017-12-22
Louisiana,Clemson,60,89,1,-29,2017-12-22
Purdue-Fort Wayne,Louisiana Tech,76,85,1,-9,2017-12-22
North Carolina A&T,Radford,60,66,1,-6,2017-12-22
Abilene Christian,Texas Tech,47,74,1,-27,2017-12-22
Johnson & Wales,Air Force,68,111,1,-43,2017-12-22
Maine,UMass,63,74,1,-11,2017-12-22
Lamar,UC-Davis,68,77,1,-9,2017-12-22
Middle Tennessee,Princeton,69,67,0,2,2017-12-22
Elon,Indiana State,73,68,0,5,2017-12-22
Sacred Heart,Providence,75,89,1,-14,2017-12-22
Jackson State,Ball State,54,70,1,-16,2017-12-22
LIU-Brooklyn,Binghamton,74,66,0,8,2017-12-22
La Salle,Bucknell,81,88,1,-7,2017-12-22
SIU-Edwardsville,Central Michigan,52,70,1,-18,2017-12-22
College of Charleston,Coastal Carolina,67,65,0,2,2017-12-22
Mount St. Mary's,Coppin State,66,53,0,13,2017-12-22
Murray State,Detroit,81,72,0,9,2017-12-22
Georgia Southern,ETSU,59,79,1,-20,2017-12-22
New Hampshire,Fairfield,68,78,1,-10,2017-12-22
Incarnate Word,Florida,60,75,1,-15,2017-12-22
Hartford,Florida International,79,72,0,7,2017-12-22
Morgan State,George Mason,79,86,1,-7,2017-12-22
Eastern Kentucky,Marshall,71,91,1,-20,2017-12-22
Bradley,Ole Miss,59,82,1,-23,2017-12-22
South Dakota State,UMKC,85,60,0,25,2017-12-22
Jacksonville,NC State,64,116,1,-52,2017-12-22
Howard,UNC Wilmington,80,75,0,5,2017-12-22
Eastern Michigan,Oakland,81,86,1,-5,2017-12-22
Northwestern,Oklahoma,78,104,1,-26,2017-12-22
Norfolk State,Old Dominion,50,61,1,-11,2017-12-22
Rider,Penn State,71,70,0,1,2017-12-22
Towson,Pitt,59,63,1,-4,2017-12-22
Canisius,Robert Morris,76,62,0,14,2017-12-22
Stony Brook,Rutgers,75,73,0,2,2017-12-22
Southeast Missouri State,Saint Louis,48,78,1,-30,2017-12-22
Holy Cross,Siena,65,71,1,-6,2017-12-22
Akron,USC,53,84,1,-31,2017-12-22
St. Bonaventure,Syracuse,60,57,0,3,2017-12-22
Alcorn State,Vanderbilt,51,92,1,-41,2017-12-22
Hampton,Virginia,48,82,1,-34,2017-12-22
VMI,VCU,65,75,1,-10,2017-12-22
Florida Gulf Coast,Wichita State,65,75,1,-10,2017-12-22
Monmouth,Yale,85,64,0,21,2017-12-22
Culver-Stockton,Arkansas State,68,99,1,-31,2017-12-22
Western Kentucky,Austin Peay,72,55,0,17,2017-12-22
Maryland-Eastern Shore,Drake,57,81,1,-24,2017-12-22
San Francisco,Duquesne,65,67,1,-2,2017-12-22
North Florida,LSU,52,104,1,-52,2017-12-22
Western Michigan,Milwaukee,66,63,0,3,2017-12-22
Delaware State,Nebraska,68,85,1,-17,2017-12-22
Texas State,Rice,74,66,0,8,2017-12-22
Arkansas-Pine Bluff,UT-Martin,68,74,1,-6,2017-12-22
Hofstra,Villanova,71,95,1,-24,2017-12-22
Texas,Alabama,66,50,0,16,2017-12-22
Wright State,Georgia Tech,85,81,0,4,2017-12-22
Colorado,Iowa,73,80,1,-7,2017-12-22
Loyola (IL),Missouri State,59,64,1,-5,2017-12-22
Prairie View,New Mexico,78,87,1,-9,2017-12-22
Xavier,Northern Iowa,77,67,0,10,2017-12-22
William & Mary,TCU,75,86,1,-11,2017-12-22
North Dakota State,UTEP,63,51,0,12,2017-12-22
Bethune-Cookman,Washington State,58,86,1,-28,2017-12-22
Presentation College,Weber State,48,88,1,-40,2017-12-22
UC-Merced,UC-Riverside,46,91,1,-45,2017-12-22
Cal State Fullerton,Loyola Marymount,88,80,0,8,2017-12-22
Northern Colorado,UNLV,91,94,1,-3,2017-12-22
UNC Asheville,Saint Mary's,69,95,1,-26,2017-12-22
Life Pacific,San Diego,51,94,1,-43,2017-12-22
Southern Illinois,Nevada,64,86,1,-22,2017-12-22
Davidson,New Mexico State,68,69,1,-1,2017-12-22
Montana,Washington,63,66,1,-3,2017-12-22
Miami (FL),Hawaii,75,57,0,18,2017-12-23
Harvard,George Washington,48,58,1,-10,2017-12-23
Alabama A&M,Georgetown,49,89,1,-40,2017-12-23
Loyola (MD),Memphis,71,83,1,-12,2017-12-23
Manhattan,Seton Hall,62,74,1,-12,2017-12-23
Tennessee,Wake Forest,79,60,0,19,2017-12-23
Fordham,West Virginia,69,86,1,-17,2017-12-23
Richmond,Boston College,73,78,1,-5,2017-12-23
Georgia State,Chattanooga,71,48,0,23,2017-12-23
Niagara,Cornell,89,86,0,3,2017-12-23
Grand Canyon,Louisville,56,74,1,-18,2017-12-23
Central Connecticut,UMass-Lowell,76,73,0,3,2017-12-23
Ohio State,UNC,72,86,1,-14,2017-12-23
UConn,Auburn,64,89,1,-25,2017-12-23
Toledo,Cleveland State,77,62,0,15,2017-12-23
Illinois State,Evansville,72,66,0,6,2017-12-23
St. Francis (NY),St. Peter's,68,71,1,-3,2017-12-23
Mississippi Valley State,Alabama-Birmingham,57,74,1,-17,2017-12-23
Wagner,Dayton,67,79,1,-12,2017-12-23
North Carolina A&T,Lamar,74,70,0,4,2017-12-23
Florida Atlantic,Minnesota,60,95,1,-35,2017-12-23
Long Beach State,Colorado State,66,68,1,-2,2017-12-23
Trinity Christian,UIC,45,84,1,-39,2017-12-23
Nicholls State,Seattle,89,95,1,-6,2017-12-23
Middle Tennessee,USC,84,89,1,-5,2017-12-23
Kentucky,UCLA,75,83,1,-8,2017-12-23
Radford,UC-Davis,72,62,0,10,2017-12-23
Green Bay,Wisconsin,60,81,1,-21,2017-12-23
Idaho State,Cal State Northridge,67,55,0,12,2017-12-23
Princeton,Akron,64,62,0,2,2017-12-23
Southern Miss,Mississippi State,64,70,1,-6,2017-12-23
Southern Illinois,Duquesne,74,64,0,10,2017-12-23
Illinois,Missouri,70,64,0,6,2017-12-23
Texas Southern,BYU,52,73,1,-21,2017-12-23
New Mexico State,Miami (FL),63,54,0,9,2017-12-23
UCSB,Sacramento State,82,72,0,10,2017-12-23
San Francisco,Nevada,66,64,0,2,2017-12-23
Davidson,Hawaii,71,79,1,-8,2017-12-24
Akron,Davidson,78,91,1,-13,2017-12-25
Princeton,Hawaii,77,63,0,14,2017-12-25
USC,New Mexico State,77,72,0,5,2017-12-25
Middle Tennessee,Miami (FL),81,84,1,-3,2017-12-25
Limestone,South Carolina,45,74,1,-29,2017-12-27
Butler,Georgetown,91,89,0,2,2017-12-27
Villanova,DePaul,103,85,0,18,2017-12-27
Coppin State,Georgia Tech,62,76,1,-14,2017-12-27
Delaware State,Penn,52,105,1,-53,2017-12-27
Florida Gulf Coast,Rhode Island,60,80,1,-20,2017-12-27
Eastern Michigan,Syracuse,47,62,1,-15,2017-12-27
Cal State Bakersfield,Arkansas,68,95,1,-27,2017-12-27
Xavier,Marquette,91,87,0,4,2017-12-27
Colorado State,Boise State,71,93,1,-22,2017-12-27
Morgan State,Grand Canyon,74,100,1,-26,2017-12-27
Air Force,New Mexico,58,87,1,-29,2017-12-27
UCF,SMU,51,56,1,-5,2017-12-27
San Jose State,Utah State,72,86,1,-14,2017-12-27
Chicago State,Wisconsin,70,82,1,-12,2017-12-27
San Diego State,Wyoming,69,82,1,-13,2017-12-27
San Diego Christian,Cal State Northridge,63,93,1,-30,2017-12-27
Nevada,Fresno State,80,65,0,15,2017-12-27
North Carolina A&T,Virginia Tech,59,76,1,-17,2017-12-28
Texas A&M-Corpus Christi,Central Arkansas,69,81,1,-12,2017-12-28
Cornell,Delaware,96,97,1,-1,2017-12-28
Lourdes,Bowling Green State,56,97,1,-41,2017-12-28
East Carolina,Tulsa,53,79,1,-26,2017-12-28
Creighton,Seton Hall,84,90,1,-6,2017-12-28
Kent State,Albany (NY),68,78,1,-10,2017-12-28
NJIT,Buffalo,81,86,1,-5,2017-12-28
Tusculum,ETSU,65,84,1,-19,2017-12-28
St. Peter's,Fairfield,61,70,1,-9,2017-12-28
Valparaiso,Indiana State,64,73,1,-9,2017-12-28
Olivet,Purdue-Fort Wayne,93,99,1,-6,2017-12-28
Middle Georgia State,Jacksonville,60,81,1,-21,2017-12-28
Southern Miss,Marshall,66,85,1,-19,2017-12-28
Incarnate Word,McNeese State,62,85,1,-23,2017-12-28
Kennesaw State,Mercer,56,89,1,-33,2017-12-28
Greensboro,UNC Wilmington,60,101,1,-41,2017-12-28
IUPUI,Northern Kentucky,59,77,1,-18,2017-12-28
Monmouth,Quinnipiac,76,78,1,-2,2017-12-28
Hartford,Rutgers,60,58,0,2,2017-12-28
Houston,South Florida,79,60,0,19,2017-12-28
Providence,St. John's (NY),94,72,0,22,2017-12-28
Tulane,Temple,85,75,0,10,2017-12-28
Tennessee State,UT-Martin,60,63,1,-3,2017-12-28
UIC,Wright State,61,65,1,-4,2017-12-28
SIU-Edwardsville,Austin Peay,58,78,1,-20,2017-12-28
Bradley,Drake,64,66,1,-2,2017-12-28
Detroit,Green Bay,83,95,1,-12,2017-12-28
Eastern Kentucky,Jacksonville State,58,76,1,-18,2017-12-28
Houston Baptist,Lamar,68,86,1,-18,2017-12-28
Oakland,Milwaukee,76,68,0,8,2017-12-28
Avila,UMKC,58,89,1,-31,2017-12-28
Eastern Illinois,Murray State,52,80,1,-28,2017-12-28
Abilene Christian,New Orleans,74,77,1,-3,2017-12-28
Northwestern State,Nicholls State,46,87,1,-41,2017-12-28
Montana,Northern Arizona,87,69,0,18,2017-12-28
Southern Illinois,Northern Iowa,56,53,0,3,2017-12-28
Belmont,Southeast Missouri State,94,72,0,22,2017-12-28
Stephen F. Austin,Southeastern Louisiana,62,73,1,-11,2017-12-28
Montana State,Southern Utah,104,99,0,5,2017-12-28
Morehead State,Tennessee Tech,67,69,1,-2,2017-12-28
Rice,UTSA,66,79,1,-13,2017-12-28
Louisiana Tech,Western Kentucky,68,69,1,-1,2017-12-28
Portland,BYU,45,69,1,-24,2017-12-28
Colorado Mesa,Denver,60,106,1,-46,2017-12-28
Pacific,Gonzaga,48,81,1,-33,2017-12-28
LSU,Memphis,71,61,0,10,2017-12-28
San Francisco,San Diego,63,73,1,-10,2017-12-28
North Texas,UTEP,63,62,0,1,2017-12-28
UC-Riverside,Utah Valley,82,90,1,-8,2017-12-28
New Mexico State,UC-Irvine,65,60,0,5,2017-12-28
Pepperdine,Santa Clara,65,72,1,-7,2017-12-28
Grambling,Seattle,63,93,1,-30,2017-12-28
Loyola Marymount,Saint Mary's,59,87,1,-28,2017-12-28
Louisville,Kentucky,61,90,1,-29,2017-12-29
Rochester (MI),Eastern Michigan,48,67,1,-19,2017-12-29
Ecclesia,Southern,57,98,1,-41,2017-12-29
Robert Morris,Bryant,68,54,0,14,2017-12-29
St. Francis (NY),Sacred Heart,73,68,0,5,2017-12-29
Rider,Canisius,76,77,1,-1,2017-12-29
Fairleigh Dickinson,LIU-Brooklyn,82,71,0,11,2017-12-29
Toledo,Penn,85,72,0,13,2017-12-29
Jarvis Christian,Prairie View,80,110,1,-30,2017-12-29
Florida Memorial,Florida Gulf Coast,42,76,1,-34,2017-12-29
Cleveland State,Michigan State,61,111,1,-50,2017-12-29
Concord,Akron,49,86,1,-37,2017-12-29
Texas State,Appalachian State,62,66,1,-4,2017-12-29
Florida A&M,Ball State,54,75,1,-21,2017-12-29
Army,Boston University,82,90,1,-8,2017-12-29
American,Bucknell,55,84,1,-29,2017-12-29
Saint Francis (PA),Central Connecticut,68,72,1,-4,2017-12-29
Lawrence,Central Michigan,73,91,1,-18,2017-12-29
Texas-Arlington,Coastal Carolina,65,90,1,-25,2017-12-29
Colgate,Holy Cross,79,74,0,5,2017-12-29
Lehigh,Lafayette,79,74,0,5,2017-12-29
Navy,Loyola (MD),63,72,1,-9,2017-12-29
Siena,Marist,58,63,1,-5,2017-12-29
Iona,Niagara,98,93,0,5,2017-12-29
Northwestern Ohio,Ohio,58,65,1,-7,2017-12-29
West Virginia,Oklahoma State,85,79,0,6,2017-12-29
Mount St. Mary's,Wagner,57,76,1,-19,2017-12-29
Louisiana,Little Rock,77,63,0,14,2017-12-29
Louisiana-Monroe,Arkansas State,64,75,1,-11,2017-12-29
Youngstown State,Indiana,51,79,1,-28,2017-12-29
Northern Illinois,Iowa,75,98,1,-23,2017-12-29
UMBC,Maryland,45,66,1,-21,2017-12-29
Stetson,Nebraska,62,71,1,-9,2017-12-29
Idaho,North Dakota,74,57,0,17,2017-12-29
Georgia State,South Alabama,64,86,1,-22,2017-12-29
Baylor,Texas Tech,53,77,1,-24,2017-12-29
Georgia Southern,Troy,86,80,0,6,2017-12-29
Kansas State,Iowa State,91,75,0,16,2017-12-29
Eastern Washington,Northern Colorado,75,88,1,-13,2017-12-29
Kansas,Texas,92,86,0,6,2017-12-29
Utah,Oregon,66,56,0,10,2017-12-29
Washington,USC,88,81,0,7,2017-12-29
Howard,Hawaii,59,84,1,-25,2017-12-29
Colorado,Oregon State,57,76,1,-19,2017-12-29
Washington State,UCLA,82,96,1,-14,2017-12-29
Wichita State,UConn,72,62,0,10,2017-12-30
Wake Forest,UNC,69,73,1,-4,2017-12-30
Brown,Northwestern,73,95,1,-22,2017-12-30
Miami (OH),Ohio State,59,72,1,-13,2017-12-30
Fordham,VCU,63,76,1,-13,2017-12-30
Tennessee,Arkansas,93,95,1,-2,2017-12-30
Western Carolina,Citadel,81,79,0,2,2017-12-30
Oakland,Green Bay,79,80,1,-1,2017-12-30
Coppin State,Penn State,43,88,1,-45,2017-12-30
Furman,VMI,87,57,0,30,2017-12-30
Maine,Columbia,71,83,1,-12,2017-12-30
Florida State,Duke,93,100,1,-7,2017-12-30
Drexel,Elon,75,90,1,-15,2017-12-30
Saint Louis,La Salle,60,83,1,-23,2017-12-30
Harvard,Minnesota,55,65,1,-10,2017-12-30
Campbell,UNC Asheville,79,85,1,-6,2017-12-30
St. Andrews,North Carolina Central,55,75,1,-20,2017-12-30
Georgia Tech,Notre Dame,59,68,1,-9,2017-12-30
North Greenville,USC Upstate,59,80,1,-21,2017-12-30
Montana,Southern Utah,79,49,0,30,2017-12-30
UMass,St. Bonaventure,78,98,1,-20,2017-12-30
Oklahoma,TCU,90,89,0,1,2017-12-30
Boston College,Virginia,58,59,1,-1,2017-12-30
High Point,Winthrop,60,76,1,-16,2017-12-30
DePaul,Xavier,72,77,1,-5,2017-12-30
Cornell,Auburn,77,98,1,-21,2017-12-30
Jamestown,North Dakota State,50,99,1,-49,2017-12-30
Presentation College,South Dakota State,68,111,1,-43,2017-12-30
Southern Miss,Western Kentucky,66,82,1,-16,2017-12-30
Elmira,Binghamton,65,113,1,-48,2017-12-30
Saint Mary's,BYU,74,64,0,10,2017-12-30
Villanova,Butler,93,101,1,-8,2017-12-30
NC State,Clemson,62,78,1,-16,2017-12-30
Towson,College of Charleston,62,73,1,-11,2017-12-30
Dayton,Duquesne,62,70,1,-8,2017-12-30
Vanderbilt,Florida,74,81,1,-7,2017-12-30
Liberty,Gardner-Webb,55,58,1,-3,2017-12-30
St. Joseph's,George Washington,64,70,1,-6,2017-12-30
Grand Canyon,Illinois,58,62,1,-4,2017-12-30
Concordia (MI),Purdue-Fort Wayne,59,92,1,-33,2017-12-30
Northeastern,James Madison,81,70,0,11,2017-12-30
Yale,Kennesaw State,89,74,0,15,2017-12-30
Evansville,Loyola (IL),59,66,1,-7,2017-12-30
Georgetown,Marquette,65,74,1,-9,2017-12-30
Northwestern State,McNeese State,63,72,1,-9,2017-12-30
Miami (FL),Pitt,67,53,0,14,2017-12-30
Radford,Presbyterian,78,62,0,16,2017-12-30
George Mason,Rhode Island,64,83,1,-19,2017-12-30
Davidson,Richmond,58,69,1,-11,2017-12-30
Pepperdine,San Diego,66,74,1,-8,2017-12-30
UC-Riverside,Seattle,71,95,1,-24,2017-12-30
Denver,South Dakota,71,82,1,-11,2017-12-30
Chicago State,Western Michigan,71,92,1,-21,2017-12-30
Hofstra,William & Mary,87,90,1,-3,2017-12-30
UMass-Lowell,Wisconsin,53,82,1,-29,2017-12-30
IUPUI,Wright State,52,60,1,-8,2017-12-30
Middle Tennessee,Alabama-Birmingham,63,60,0,3,2017-12-30
Holy Names,UC-Davis,62,89,1,-27,2017-12-30
Longwood,Charleston Southern,43,84,1,-41,2017-12-30
Morehead State,Jacksonville State,69,76,1,-7,2017-12-30
North Florida,Mississippi State,81,109,1,-28,2017-12-30
New Mexico,Nevada,74,77,1,-3,2017-12-30
Wofford,UNC Greensboro,67,71,1,-4,2017-12-30
Colorado State,San Jose State,59,52,0,7,2017-12-30
Texas A&M,Alabama,57,79,1,-22,2017-12-30
Temple,Houston,73,76,1,-3,2017-12-30
Jacksonville,Michigan,51,76,1,-25,2017-12-30
Florida Atlantic,Florida International,57,58,1,-1,2017-12-30
Air Force,Fresno State,59,71,1,-12,2017-12-30
Santa Clara,Gonzaga,52,101,1,-49,2017-12-30
Texas A&M-International,Long Beach State,59,77,1,-18,2017-12-30
Fairfield,Manhattan,58,61,1,-3,2017-12-30
Louisiana Tech,Marshall,65,78,1,-13,2017-12-30
Detroit,Milwaukee,79,87,1,-8,2017-12-30
Dartmouth,New Hampshire,66,83,1,-17,2017-12-30
Incarnate Word,Nicholls State,60,77,1,-17,2017-12-30
Delaware,UNC Wilmington,58,56,0,2,2017-12-30
Montana State,Northern Arizona,76,73,0,3,2017-12-30
UIC,Northern Kentucky,51,86,1,-35,2017-12-30
Charlotte,Old Dominion,58,89,1,-31,2017-12-30
Norfolk State,Stony Brook,74,68,0,6,2017-12-30
Belmont,UT-Martin,65,58,0,7,2017-12-30
Eastern Kentucky,Tennessee Tech,69,77,1,-8,2017-12-30
Sam Houston State,Abilene Christian,72,75,1,-3,2017-12-30
Eastern Illinois,Austin Peay,54,70,1,-16,2017-12-30
New Orleans,Houston Baptist,64,57,0,7,2017-12-30
SIU-Edwardsville,Murray State,63,87,1,-24,2017-12-30
Omaha,Oral Roberts,74,93,1,-19,2017-12-30
Lipscomb,Purdue,66,98,1,-32,2017-12-30
Chattanooga,Samford,56,73,1,-17,2017-12-30
Lamar,Texas A&M-Corpus Christi,77,72,0,5,2017-12-30
Hampton,Texas-Rio Grande Valley,69,80,1,-11,2017-12-30
North Texas,UTSA,72,71,0,1,2017-12-30
Cal State Fullerton,Utah Valley,78,87,1,-9,2017-12-30
Arizona State,Arizona,78,84,1,-6,2017-12-30
San Francisco,Portland,84,61,0,23,2017-12-30
Rice,UTEP,62,80,1,-18,2017-12-30
Idaho State,Weber State,62,60,0,2,2017-12-30
Notre Dame (CA),Cal Poly,40,73,1,-33,2017-12-30
Morgan State,Cal State Northridge,69,79,1,-10,2017-12-30
Pacific Union,UCSB,49,81,1,-32,2017-12-30
Loyola Marymount,Pacific,82,88,1,-6,2017-12-30
Portland State,Sacramento State,75,80,1,-5,2017-12-30
Utah State,San Diego State,59,79,1,-20,2017-12-30
California,Stanford,77,74,0,3,2017-12-30
Boise State,UNLV,83,74,0,9,2017-12-30
Savannah State,Michigan State,52,108,1,-56,2017-12-31
Monmouth,St. Peter's,64,77,1,-13,2017-12-31
Iona,Canisius,78,85,1,-7,2017-12-31
Florida Tech,Florida Gulf Coast,54,62,1,-8,2017-12-31
Centenary (NJ),UMBC,41,85,1,-44,2017-12-31
Rider,Niagara,99,76,0,23,2017-12-31
Wagner,St. Francis (NY),75,82,1,-7,2017-12-31
Texas-Arlington,Appalachian State,76,80,1,-4,2017-12-31
Northern Iowa,Bradley,53,72,1,-19,2017-12-31
Providence,Creighton,64,83,1,-19,2017-12-31
Mount St. Mary's,LIU-Brooklyn,57,71,1,-14,2017-12-31
ETSU,Mercer,74,55,0,19,2017-12-31
Fairleigh Dickinson,Sacred Heart,65,66,1,-1,2017-12-31
Tennessee State,Southeast Missouri State,65,77,1,-12,2017-12-31
Tulsa,Tulane,65,56,0,9,2017-12-31
Saint Francis (PA),Bryant,86,82,0,4,2017-12-31
Robert Morris,Central Connecticut,71,57,0,14,2017-12-31
Texas State,Coastal Carolina,53,48,0,5,2017-12-31
Central Pennsylvania College,Maryland-Eastern Shore,69,74,1,-5,2017-12-31
Lincoln Christian,Western Illinois,57,91,1,-34,2017-12-31
Louisiana,Arkansas State,88,78,0,10,2017-12-31
Southeastern Louisiana,Central Arkansas,73,69,0,4,2017-12-31
Memphis,Cincinnati,48,82,1,-34,2017-12-31
UCF,East Carolina,59,39,0,20,2017-12-31
Indiana State,Illinois State,81,84,1,-3,2017-12-31
Idaho,Northern Colorado,77,81,1,-4,2017-12-31
Georgia Southern,South Alabama,67,69,1,-2,2017-12-31
Drake,Southern Illinois,70,67,0,3,2017-12-31
Georgia State,Troy,66,68,1,-2,2017-12-31
Missouri State,Valparaiso,67,50,0,17,2017-12-31
Louisiana-Monroe,Little Rock,62,71,1,-9,2017-12-31
Eastern Washington,North Dakota,77,64,0,13,2017-12-31
St. John's (NY),Seton Hall,70,75,1,-5,2017-12-31
Georgia,Kentucky,61,66,1,-5,2017-12-31
South Carolina,Ole Miss,69,74,1,-5,2017-12-31
Utah,Oregon State,66,64,0,2,2017-12-31
Virginia Tech,Syracuse,56,68,1,-12,2017-12-31
South Florida,SMU,39,79,1,-40,2017-12-31
Washington,UCLA,53,74,1,-21,2017-12-31
Washington State,USC,71,89,1,-18,2017-12-31
Colorado,Oregon,62,77,1,-15,2017-12-31
Youngstown State,Cleveland State,80,77,0,3,2018-01-01
Quinnipiac,Siena,71,70,0,1,2018-01-01
Florida National University,Stetson,88,94,1,-6,2018-01-01
Alabama A&M,Grambling,71,64,0,7,2018-01-01
West Virginia,Kansas State,77,69,0,8,2018-01-01
Arkansas-Pine Bluff,Mississippi Valley State,80,71,0,9,2018-01-01
Alcorn State,Prairie View,64,76,1,-12,2018-01-01
Texas,Iowa State,74,70,0,4,2018-01-01
Alabama State,Jackson State,73,82,1,-9,2018-01-01
Southern,Texas Southern,66,78,1,-12,2018-01-01
Colgate,American,72,63,0,9,2018-01-02
Loyola (MD),Army,75,86,1,-11,2018-01-02
Eastern Michigan,Ball State,62,72,1,-10,2018-01-02
TCU,Baylor,81,78,0,3,2018-01-02
Miami (OH),Bowling Green State,77,72,0,5,2018-01-02
Boston University,Bucknell,84,79,0,5,2018-01-02
Toledo,Buffalo,94,104,1,-10,2018-01-02
Ohio,Central Michigan,50,75,1,-25,2018-01-02
Delaware,College of Charleston,78,93,1,-15,2018-01-02
Towson,Elon,72,75,1,-3,2018-01-02
Vermont,Harvard,62,56,0,6,2018-01-02
Michigan,Iowa,75,68,0,7,2018-01-02
Trinity Baptist,Jacksonville,48,105,1,-57,2018-01-02
William & Mary,James Madison,84,76,0,8,2018-01-02
Carver Bible,Kennesaw State,75,98,1,-23,2018-01-02
Holy Cross,Lafayette,48,60,1,-12,2018-01-02
Charleston Southern,Liberty,53,70,1,-17,2018-01-02
Manhattan,Marist,101,96,0,5,2018-01-02
Penn State,Maryland,69,75,1,-6,2018-01-02
Lehigh,Navy,66,78,1,-12,2018-01-02
Drexel,UNC Wilmington,87,107,1,-20,2018-01-02
Florida National University,North Florida,70,104,1,-34,2018-01-02
Hofstra,Northeastern,71,70,0,1,2018-01-02
UMKC,USC Upstate,79,77,0,2,2018-01-02
Auburn,Tennessee,94,84,0,10,2018-01-02
Alabama,Vanderbilt,75,76,1,-1,2018-01-02
Akron,Western Michigan,75,87,1,-12,2018-01-02
Indiana,Wisconsin,61,71,1,-10,2018-01-02
Butler,Xavier,79,86,1,-7,2018-01-02
IUPUI,Green Bay,67,63,0,4,2018-01-02
Doane College,Omaha,60,100,1,-40,2018-01-02
Kent State,Northern Illinois,61,75,1,-14,2018-01-02
Our Lady of the Lake,Texas-Rio Grande Valley,75,96,1,-21,2018-01-02
San Diego State,Colorado State,77,68,0,9,2018-01-02
Georgetown,DePaul,90,81,0,9,2018-01-02
Texas Tech,Kansas,85,73,0,12,2018-01-02
Pitt,Louisville,51,77,1,-26,2018-01-02
Arkansas,Mississippi State,75,78,1,-3,2018-01-02
Nebraska,Northwestern,70,55,0,15,2018-01-02
Florida,Texas A&M,83,66,0,17,2018-01-02
Ole Miss,Georgia,60,71,1,-11,2018-01-03
Marquette,Providence,95,90,0,5,2018-01-03
Hartford,Albany (NY),72,64,0,8,2018-01-03
South Carolina State,Bethune-Cookman,80,86,1,-6,2018-01-03
Clemson,Boston College,74,70,0,4,2018-01-03
NJIT,Brown,69,70,1,-1,2018-01-03
Gardner-Webb,Campbell,82,80,0,2,2018-01-03
Memphis,UCF,56,65,1,-9,2018-01-03
Saint Louis,Davidson,51,54,1,-3,2018-01-03
North Carolina Central,Delaware State,65,62,0,3,2018-01-03
George Washington,Duquesne,52,69,1,-17,2018-01-03
UNC,Florida State,80,81,1,-1,2018-01-03
Richmond,Fordham,65,69,1,-4,2018-01-03
UNC Asheville,High Point,74,84,1,-10,2018-01-03
Fisk,Lipscomb,53,99,1,-46,2018-01-03
Presbyterian,Longwood,78,65,0,13,2018-01-03
New Hampshire,UMBC,67,71,1,-4,2018-01-03
George Mason,UMass,80,72,0,8,2018-01-03
Maryland-Eastern Shore,Morgan State,82,85,1,-3,2018-01-03
Rutgers,Purdue,51,82,1,-31,2018-01-03
Winthrop,Radford,79,85,1,-6,2018-01-03
La Salle,Rhode Island,62,74,1,-12,2018-01-03
VCU,St. Joseph's,81,87,1,-6,2018-01-03
Central Arkansas,Sam Houston State,76,82,1,-6,2018-01-03
East Carolina,South Florida,67,65,0,2,2018-01-03
Maine,Stony Brook,70,71,1,-1,2018-01-03
UConn,Tulsa,88,90,1,-2,2018-01-03
Syracuse,Wake Forest,67,73,1,-6,2018-01-03
McNeese State,Abilene Christian,74,79,1,-5,2018-01-03
Valparaiso,Bradley,71,80,1,-9,2018-01-03
St. John's (NY),Creighton,71,78,1,-7,2018-01-03
St. Bonaventure,Dayton,72,82,1,-10,2018-01-03
Illinois State,Drake,62,87,1,-25,2018-01-03
Howard,Florida A&M,76,84,1,-8,2018-01-03
Alabama State,Grambling,74,66,0,8,2018-01-03
Alabama A&M,Jackson State,56,59,1,-3,2018-01-03
Kentucky,LSU,74,71,0,3,2018-01-03
Indiana State,Loyola (IL),61,57,0,4,2018-01-03
Lamar,New Orleans,62,72,1,-10,2018-01-03
Coppin State,Norfolk State,67,75,1,-8,2018-01-03
South Dakota State,North Dakota State,87,80,0,7,2018-01-03
Southern,Prairie View,74,78,1,-4,2018-01-03
Western Illinois,South Dakota,50,62,1,-12,2018-01-03
Evansville,Southern Illinois,63,65,1,-2,2018-01-03
Nicholls State,Stephen F. Austin,64,81,1,-17,2018-01-03
Northwestern State,Texas A&M-Corpus Christi,65,67,1,-2,2018-01-03
Alcorn State,Texas Southern,70,85,1,-15,2018-01-03
New Mexico,Boise State,62,90,1,-28,2018-01-03
Miami (FL),Georgia Tech,54,64,1,-10,2018-01-03
Illinois,Minnesota,67,77,1,-10,2018-01-03
NC State,Notre Dame,58,88,1,-30,2018-01-03
Oklahoma State,Oklahoma,89,109,1,-20,2018-01-03
Missouri,South Carolina,79,68,0,11,2018-01-03
Fresno State,Utah State,79,81,1,-2,2018-01-03
Virginia,Virginia Tech,78,52,0,26,2018-01-03
UC-Riverside,Cal State Fullerton,65,68,1,-3,2018-01-03
Wyoming,Nevada,83,92,1,-9,2018-01-03
UNLV,San Jose State,82,76,0,6,2018-01-03
Eastern Illinois,Morehead State,61,52,0,9,2018-01-04
UT-Martin,Austin Peay,69,75,1,-6,2018-01-04
Western Carolina,Chattanooga,75,63,0,12,2018-01-04
Green Bay,Cleveland State,79,80,1,-1,2018-01-04
Central Connecticut,Fairleigh Dickinson,77,81,1,-4,2018-01-04
Alabama-Birmingham,Florida Atlantic,75,44,0,31,2018-01-04
Middle Tennessee,Florida International,71,66,0,5,2018-01-04
Citadel,Furman,67,107,1,-40,2018-01-04
Arkansas State,Georgia Southern,49,80,1,-31,2018-01-04
Little Rock,Georgia State,64,73,1,-9,2018-01-04
Ohio State,Iowa,92,81,0,11,2018-01-04
UIC,IUPUI,70,65,0,5,2018-01-04
UTSA,Louisiana Tech,78,76,0,2,2018-01-04
Vermont,UMass-Lowell,88,77,0,11,2018-01-04
Bryant,Mount St. Mary's,80,96,1,-16,2018-01-04
St. Francis (NY),Robert Morris,79,80,1,-1,2018-01-04
LIU-Brooklyn,Saint Francis (PA),68,85,1,-17,2018-01-04
Sacred Heart,Wagner,63,69,1,-6,2018-01-04
Houston,Wichita State,63,81,1,-18,2018-01-04
VMI,Wofford,53,92,1,-39,2018-01-04
Tennessee Tech,Belmont,67,80,1,-13,2018-01-04
Arizona State,Colorado,81,90,1,-9,2018-01-04
SIU-Edwardsville,Eastern Kentucky,85,82,0,3,2018-01-04
Appalachian State,Louisiana,45,78,1,-33,2018-01-04
Coastal Carolina,Louisiana-Monroe,72,82,1,-10,2018-01-04
Maryland,Michigan State,61,91,1,-30,2018-01-04
Southeast Missouri State,Murray State,73,89,1,-16,2018-01-04
Charlotte,North Texas,70,68,0,2,2018-01-04
Purdue-Fort Wayne,Oral Roberts,60,76,1,-16,2018-01-04
Old Dominion,Rice,82,75,0,7,2018-01-04
ETSU,Samford,90,72,0,18,2018-01-04
UTEP,Southern Miss,75,85,1,-10,2018-01-04
Jacksonville State,Tennessee State,60,67,1,-7,2018-01-04
Troy,Texas-Arlington,76,86,1,-10,2018-01-04
South Alabama,Texas State,69,72,1,-3,2018-01-04
Milwaukee,Youngstown State,63,72,1,-9,2018-01-04
Portland State,Eastern Washington,74,81,1,-7,2018-01-04
Southern Utah,Idaho State,78,93,1,-15,2018-01-04
Northern Iowa,Missouri State,55,62,1,-7,2018-01-04
North Dakota,Montana,79,109,1,-30,2018-01-04
Northern Colorado,Montana State,64,76,1,-12,2018-01-04
Cincinnati,Temple,55,53,0,2,2018-01-04
SMU,Tulane,70,73,1,-3,2018-01-04
Arizona,Utah,94,82,0,12,2018-01-04
Northern Arizona,Weber State,55,95,1,-40,2018-01-04
UCSB,Cal Poly,79,80,1,-1,2018-01-04
USC,California,80,62,0,18,2018-01-04
UC-Irvine,UC-Davis,53,64,1,-11,2018-01-04
Sacramento State,Idaho,68,69,1,-1,2018-01-04
Hawaii,Long Beach State,81,89,1,-8,2018-01-04
Santa Clara,Loyola Marymount,65,49,0,16,2018-01-04
San Diego,Portland,81,74,0,7,2018-01-04
Pacific,Saint Mary's,56,74,1,-18,2018-01-04
UCLA,Stanford,99,107,1,-8,2018-01-04
Gonzaga,Pepperdine,89,59,0,30,2018-01-04
BYU,San Francisco,69,59,0,10,2018-01-04
Central Pennsylvania College,Cornell,69,93,1,-24,2018-01-05
Holy Cross,Lehigh,77,83,1,-6,2018-01-05
Akron,Toledo,65,67,1,-2,2018-01-05
Bucknell,Army,83,66,0,17,2018-01-05
Lafayette,Colgate,71,68,0,3,2018-01-05
William & Mary,Delaware,90,65,0,25,2018-01-05
College of Charleston,Drexel,82,87,1,-5,2018-01-05
James Madison,Hofstra,81,87,1,-6,2018-01-05
St. Peter's,Iona,69,73,1,-4,2018-01-05
Boston University,Loyola (MD),65,68,1,-3,2018-01-05
Manhattan,Monmouth,66,77,1,-11,2018-01-05
American,Navy,64,70,1,-6,2018-01-05
Elon,Northeastern,60,72,1,-12,2018-01-05
Fairfield,Rider,77,96,1,-19,2018-01-05
Wisconsin,Rutgers,60,64,1,-4,2018-01-05
Niagara,Siena,84,76,0,8,2018-01-05
UNC Wilmington,Towson,71,89,1,-18,2018-01-05
Northwestern,Penn State,63,78,1,-15,2018-01-05
Canisius,Quinnipiac,82,74,0,8,2018-01-05
Wright State,Detroit,80,73,0,7,2018-01-05
Northern Kentucky,Oakland,87,83,0,4,2018-01-05
Oregon,Oregon State,64,76,1,-12,2018-01-05
Louisville,Clemson,69,74,1,-5,2018-01-06
East Carolina,UConn,65,70,1,-5,2018-01-06
UMass,Dayton,62,60,0,2,2018-01-06
Bowling Green State,Eastern Michigan,75,71,0,4,2018-01-06
Creighton,Georgetown,90,66,0,24,2018-01-06
Alabama,Georgia,46,65,1,-19,2018-01-06
Illinois,Michigan,69,79,1,-10,2018-01-06
Xavier,Providence,72,81,1,-9,2018-01-06
Pitt,Virginia Tech,67,81,1,-14,2018-01-06
Maine,Binghamton,76,73,0,3,2018-01-06
Florida,Missouri,77,75,0,2,2018-01-06
Albany (NY),New Hampshire,61,64,1,-3,2018-01-06
Bryant,Sacred Heart,79,74,0,5,2018-01-06
UNC,Virginia,49,61,1,-12,2018-01-06
UNC Greensboro,VMI,63,61,0,2,2018-01-06
Nevada,Air Force,86,75,0,11,2018-01-06
Buffalo,Ball State,83,63,0,20,2018-01-06
Texas,Baylor,60,69,1,-9,2018-01-06
Seton Hall,Butler,90,87,0,3,2018-01-06
Winthrop,Campbell,77,88,1,-11,2018-01-06
Arizona,Colorado,77,80,1,-3,2018-01-06
Sarah Lawrence,Columbia,42,87,1,-45,2018-01-06
Arkansas State,Georgia State,75,79,1,-4,2018-01-06
Dartmouth,Harvard,51,61,1,-10,2018-01-06
Drake,Indiana State,75,72,0,3,2018-01-06
VCU,La Salle,80,74,0,6,2018-01-06
Gardner-Webb,Longwood,73,79,1,-6,2018-01-06
Nebraska,Purdue,62,74,1,-12,2018-01-06
North Dakota State,South Dakota,84,79,0,5,2018-01-06
DePaul,St. John's (NY),91,74,0,17,2018-01-06
LSU,Texas A&M,69,68,0,1,2018-01-06
New Mexico State,Chicago State,97,60,0,37,2018-01-06
Milwaukee,Cleveland State,67,63,0,4,2018-01-06
Purdue-Fort Wayne,Denver,82,63,0,19,2018-01-06
Duquesne,Fordham,64,41,0,23,2018-01-06
Appalachian State,Louisiana-Monroe,79,73,0,6,2018-01-06
Western Michigan,Miami (OH),67,62,0,5,2018-01-06
Northern Illinois,Ohio,68,78,1,-10,2018-01-06
Charlotte,Rice,64,73,1,-9,2018-01-06
Notre Dame,Syracuse,51,49,0,2,2018-01-06
Wake Forest,Boston College,71,77,1,-6,2018-01-06
Savannah State,Coppin State,80,71,0,9,2018-01-06
Eastern Illinois,Eastern Kentucky,54,53,0,1,2018-01-06
Bradley,Evansville,44,68,1,-24,2018-01-06
Mercer,Furman,71,74,1,-3,2018-01-06
Rhode Island,George Washington,81,60,0,21,2018-01-06
Bethune-Cookman,Howard,92,87,0,5,2018-01-06
Sam Houston State,Incarnate Word,85,74,0,11,2018-01-06
Lipscomb,Kennesaw State,86,71,0,15,2018-01-06
Presbyterian,Liberty,48,60,1,-12,2018-01-06
Hampton,Maryland-Eastern Shore,83,92,1,-9,2018-01-06
New Orleans,McNeese State,82,75,0,7,2018-01-06
Tulsa,Memphis,67,76,1,-9,2018-01-06
Mississippi State,Ole Miss,58,64,1,-6,2018-01-06
North Dakota,Montana State,68,79,1,-11,2018-01-06
SIU-Edwardsville,Morehead State,70,65,0,5,2018-01-06
Florida A&M,Morgan State,68,87,1,-19,2018-01-06
Central Connecticut,Mount St. Mary's,51,78,1,-27,2018-01-06
USC Upstate,NJIT,87,98,1,-11,2018-01-06
Stephen F. Austin,Northwestern State,64,56,0,8,2018-01-06
Iowa State,Oklahoma State,87,96,1,-9,2018-01-06
Princeton,Penn,70,76,1,-6,2018-01-06
San Francisco,Pepperdine,80,67,0,13,2018-01-06
UNC Asheville,Radford,70,90,1,-20,2018-01-06
LIU-Brooklyn,Robert Morris,79,88,1,-9,2018-01-06
St. Francis (NY),Saint Francis (PA),87,91,1,-4,2018-01-06
Kansas State,Texas Tech,58,74,1,-16,2018-01-06
Southern Illinois,Valparaiso,72,83,1,-11,2018-01-06
Fairleigh Dickinson,Wagner,65,73,1,-8,2018-01-06
Washington,Washington State,70,65,0,5,2018-01-06
Southeastern Louisiana,Abilene Christian,72,70,0,2,2018-01-06
ETSU,Chattanooga,85,66,0,19,2018-01-06
Fresno State,Colorado State,82,79,0,3,2018-01-06
Sacramento State,Eastern Washington,67,82,1,-15,2018-01-06
Middle Tennessee,Florida Atlantic,61,57,0,4,2018-01-06
Little Rock,Georgia Southern,69,72,1,-3,2018-01-06
Central Arkansas,Lamar,100,91,0,9,2018-01-06
Indiana,Minnesota,75,71,0,4,2018-01-06
UTSA,Southern Miss,83,93,1,-10,2018-01-06
Tennessee Tech,Tennessee State,87,81,0,6,2018-01-06
South Alabama,Texas-Arlington,67,91,1,-24,2018-01-06
Troy,Texas State,56,57,1,-1,2018-01-06
Mississippi Valley State,Alabama State,46,63,1,-17,2018-01-06
Jackson State,Alcorn State,60,55,0,5,2018-01-06
Arkansas,Auburn,77,88,1,-11,2018-01-06
Jacksonville State,Belmont,64,60,0,4,2018-01-06
UCLA,California,107,84,0,23,2018-01-06
Old Dominion,North Texas,63,60,0,3,2018-01-06
Vanderbilt,South Carolina,60,71,1,-11,2018-01-06
Grambling,Southern,69,80,1,-11,2018-01-06
Arkansas-Pine Bluff,Alabama A&M,69,62,0,7,2018-01-06
South Carolina State,Delaware State,63,60,0,3,2018-01-06
Stetson,Florida Gulf Coast,52,90,1,-38,2018-01-06
Alabama-Birmingham,Florida International,75,64,0,11,2018-01-06
Yale,Georgia Tech,60,74,1,-14,2018-01-06
Stony Brook,Hartford,63,61,0,2,2018-01-06
Charleston Southern,High Point,59,80,1,-21,2018-01-06
Central Michigan,Kent State,69,85,1,-16,2018-01-06
UTEP,Louisiana Tech,88,97,1,-9,2018-01-06
Western Kentucky,Marshall,112,87,0,25,2018-01-06
Jacksonville,North Florida,90,86,0,4,2018-01-06
UMBC,Vermont,56,71,1,-15,2018-01-06
Oklahoma,West Virginia,76,89,1,-13,2018-01-06
Citadel,Wofford,92,109,1,-17,2018-01-06
Green Bay,Youngstown State,74,85,1,-11,2018-01-06
Southeast Missouri State,Austin Peay,71,76,1,-5,2018-01-06
Nicholls State,Houston Baptist,72,71,0,1,2018-01-06
Coastal Carolina,Louisiana,64,81,1,-17,2018-01-06
Texas-Rio Grande Valley,UMKC,73,61,0,12,2018-01-06
UT-Martin,Murray State,68,82,1,-14,2018-01-06
South Dakota State,Omaha,101,88,0,13,2018-01-06
Duke,NC State,85,96,1,-11,2018-01-06
Western Illinois,Oral Roberts,66,81,1,-15,2018-01-06
St. Bonaventure,St. Joseph's,78,85,1,-7,2018-01-06
Richmond,Saint Louis,62,69,1,-7,2018-01-06
Western Carolina,Samford,71,85,1,-14,2018-01-06
Prairie View,Texas Southern,94,100,1,-6,2018-01-06
Marquette,Villanova,90,100,1,-10,2018-01-06
Boise State,Wyoming,78,79,1,-1,2018-01-06
Northern Arizona,Idaho State,60,64,1,-4,2018-01-06
Northern Colorado,Montana,80,89,1,-9,2018-01-06
San Jose State,New Mexico,47,80,1,-33,2018-01-06
Kentucky,Tennessee,65,76,1,-11,2018-01-06
Kansas,TCU,88,84,0,4,2018-01-06
Cal State Bakersfield,Utah Valley,42,75,1,-33,2018-01-06
Southern Utah,Weber State,76,92,1,-16,2018-01-06
Cal State Fullerton,Cal Poly,101,97,0,4,2018-01-06
Hawaii,Cal State Northridge,65,46,0,19,2018-01-06
Long Beach State,UC-Irvine,73,86,1,-13,2018-01-06
Portland State,Idaho,73,72,0,1,2018-01-06
Gonzaga,Loyola Marymount,85,66,0,19,2018-01-06
Utah State,UNLV,85,78,0,7,2018-01-06
BYU,Pacific,66,67,1,-1,2018-01-06
Portland,Santa Clara,68,70,1,-2,2018-01-06
Grand Canyon,Seattle,73,57,0,16,2018-01-06
UC-Riverside,UCSB,57,65,1,-8,2018-01-06
San Diego,Saint Mary's,63,70,1,-7,2018-01-06
Temple,UCF,39,60,1,-21,2018-01-07
Davidson,George Mason,86,59,0,27,2018-01-07
Fairfield,Iona,65,84,1,-19,2018-01-07
UNC Wilmington,Delaware,76,96,1,-20,2018-01-07
Northern Kentucky,Detroit,56,54,0,2,2018-01-07
Missouri State,Illinois State,68,72,1,-4,2018-01-07
Niagara,Marist,86,70,0,16,2018-01-07
James Madison,Northeastern,67,80,1,-13,2018-01-07
Quinnipiac,St. Peter's,58,84,1,-26,2018-01-07
College of Charleston,Towson,62,73,1,-11,2018-01-07
Wright State,Oakland,86,81,0,5,2018-01-07
Canisius,Siena,62,65,1,-3,2018-01-07
William & Mary,Drexel,85,63,0,22,2018-01-07
Elon,Hofstra,89,76,0,13,2018-01-07
Loyola (IL),Northern Iowa,56,50,0,6,2018-01-07
Michigan State,Ohio State,64,80,1,-16,2018-01-07
South Florida,Wichita State,57,95,1,-38,2018-01-07
SMU,Cincinnati,56,76,1,-20,2018-01-07
Rider,Manhattan,82,76,0,6,2018-01-07
Florida State,Miami (FL),74,80,1,-6,2018-01-07
Iowa,Maryland,73,91,1,-18,2018-01-07
Arizona State,Utah,80,77,0,3,2018-01-07
USC,Stanford,76,77,1,-1,2018-01-07
Navy,Colgate,62,70,1,-8,2018-01-08
Arkansas-Pine Bluff,Alabama State,94,68,0,26,2018-01-08
Army,American,58,54,0,4,2018-01-08
Lehigh,Boston University,81,92,1,-11,2018-01-08
Florida A&M,Coppin State,78,79,1,-1,2018-01-08
North Carolina A&T,Delaware State,76,66,0,10,2018-01-08
Loyola (MD),Holy Cross,57,64,1,-7,2018-01-08
Bucknell,Lafayette,80,75,0,5,2018-01-08
Bethune-Cookman,Maryland-Eastern Shore,89,84,0,5,2018-01-08
Savannah State,Morgan State,88,89,1,-1,2018-01-08
Norfolk State,North Carolina Central,63,64,1,-1,2018-01-08
Mississippi Valley State,Alabama A&M,55,65,1,-10,2018-01-08
Grambling,Alcorn State,72,61,0,11,2018-01-08
Jackson State,Southern,65,61,0,4,2018-01-08
Penn State,Indiana,70,74,1,-4,2018-01-09
Georgetown,St. John's (NY),69,66,0,3,2018-01-09
Buffalo,Akron,87,65,0,22,2018-01-09
South Carolina,Alabama,62,76,1,-14,2018-01-09
Northern Illinois,Bowling Green State,57,66,1,-9,2018-01-09
Radford,Charleston Southern,64,61,0,3,2018-01-09
Central Michigan,Eastern Michigan,74,79,1,-5,2018-01-09
High Point,Gardner-Webb,45,62,1,-17,2018-01-09
Texas A&M,Kentucky,73,74,1,-1,2018-01-09
Tulane,Memphis,89,96,1,-7,2018-01-09
Kent State,Miami (OH),69,80,1,-11,2018-01-09
Longwood,UNC Asheville,80,90,1,-10,2018-01-09
Ball State,Ohio,75,68,0,7,2018-01-09
Texas Tech,Oklahoma,65,75,1,-10,2018-01-09
Campbell,Presbyterian,83,79,0,4,2018-01-09
Dayton,Richmond,87,81,0,6,2018-01-09
Rhode Island,Saint Louis,72,65,0,7,2018-01-09
Western Michigan,Toledo,61,84,1,-23,2018-01-09
Baylor,West Virginia,54,57,1,-3,2018-01-09
Liberty,Winthrop,73,70,0,3,2018-01-09
Southern Illinois,Bradley,62,68,1,-6,2018-01-09
Butler,Creighton,74,85,1,-11,2018-01-09
Wisconsin,Nebraska,59,63,1,-4,2018-01-09
Boston College,UNC,66,96,1,-30,2018-01-09
Trinity Baptist,South Alabama,34,99,1,-65,2018-01-09
Syracuse,Virginia,61,68,1,-7,2018-01-09
Duquesne,VCU,67,78,1,-11,2018-01-09
Ole Miss,Auburn,70,85,1,-15,2018-01-09
Iowa State,Kansas,78,83,1,-5,2018-01-09
Seton Hall,Marquette,64,84,1,-20,2018-01-09
Purdue,Michigan,70,69,0,1,2018-01-09
Tennessee,Vanderbilt,92,84,0,8,2018-01-09
Boise State,Fresno State,70,64,0,6,2018-01-09
San Jose State,San Diego State,49,85,1,-36,2018-01-09
Stony Brook,Albany (NY),65,78,1,-13,2018-01-10
Furman,Chattanooga,73,55,0,18,2018-01-10
UCF,UConn,53,62,1,-9,2018-01-10
Vermont,Dartmouth,91,78,0,13,2018-01-10
George Washington,Davidson,45,72,1,-27,2018-01-10
Cleveland State,Detroit,84,85,1,-1,2018-01-10
Mississippi State,Florida,54,71,1,-17,2018-01-10
St. Joseph's,George Mason,79,81,1,-2,2018-01-10
Notre Dame,Georgia Tech,53,60,1,-7,2018-01-10
UMass-Lowell,Hartford,73,84,1,-11,2018-01-10
Northern Iowa,Indiana State,67,69,1,-2,2018-01-10
Milwaukee,IUPUI,71,72,1,-1,2018-01-10
UMBC,Maine,72,67,0,5,2018-01-10
La Salle,UMass,79,86,1,-7,2018-01-10
Rutgers,Michigan State,72,76,1,-4,2018-01-10
Binghamton,New Hampshire,67,71,1,-4,2018-01-10
Youngstown State,Oakland,82,95,1,-13,2018-01-10
Duke,Pitt,87,52,0,35,2018-01-10
Marist,Quinnipiac,79,80,1,-1,2018-01-10
Fordham,St. Bonaventure,61,77,1,-16,2018-01-10
Virginia Tech,Wake Forest,83,75,0,8,2018-01-10
Mercer,Western Carolina,56,58,1,-2,2018-01-10
Harvard,Wofford,62,63,1,-1,2018-01-10
Incarnate Word,Central Arkansas,76,92,1,-16,2018-01-10
Missouri State,Evansville,55,64,1,-9,2018-01-10
Abilene Christian,Houston Baptist,82,74,0,8,2018-01-10
Green Bay,UIC,73,84,1,-11,2018-01-10
Loyola (IL),Illinois State,68,61,0,7,2018-01-10
Oklahoma State,Kansas State,82,86,1,-4,2018-01-10
Southeastern Louisiana,Lamar,63,58,0,5,2018-01-10
McNeese State,Nicholls State,80,85,1,-5,2018-01-10
New Orleans,Stephen F. Austin,68,78,1,-10,2018-01-10
Sam Houston State,Texas A&M-Corpus Christi,82,50,0,32,2018-01-10
Drake,Valparaiso,60,77,1,-17,2018-01-10
Xavier,Villanova,65,89,1,-24,2018-01-10
LSU,Arkansas,75,54,0,21,2018-01-10
Louisville,Florida State,73,69,0,4,2018-01-10
Georgia,Missouri,56,68,1,-12,2018-01-10
Wyoming,New Mexico,66,75,1,-9,2018-01-10
Minnesota,Northwestern,60,83,1,-23,2018-01-10
Temple,SMU,66,64,0,2,2018-01-10
TCU,Texas,98,99,1,-1,2018-01-10
Colorado State,Utah State,84,75,0,9,2018-01-10
UNLV,Air Force,81,76,0,5,2018-01-10
Cal State Northridge,Long Beach State,70,80,1,-10,2018-01-10
Colorado,USC,58,70,1,-12,2018-01-10
Cal Poly,Hawaii,45,57,1,-12,2018-01-10
Lafayette,Army,71,81,1,-10,2018-01-11
Samford,Citadel,107,91,0,16,2018-01-11
Loyola (MD),American,65,76,1,-11,2018-01-11
Georgia State,Appalachian State,71,58,0,13,2018-01-11
Colgate,Boston University,58,72,1,-14,2018-01-11
Wagner,Bryant,71,62,0,9,2018-01-11
Lehigh,Bucknell,65,78,1,-13,2018-01-11
Marshall,Charlotte,91,83,0,8,2018-01-11
Georgia Southern,Coastal Carolina,77,66,0,11,2018-01-11
Northeastern,College of Charleston,66,82,1,-16,2018-01-11
Drexel,Delaware,66,72,1,-6,2018-01-11
UNC Greensboro,ETSU,58,68,1,-10,2018-01-11
Tennessee State,Eastern Illinois,69,65,0,4,2018-01-11
UNC Wilmington,Elon,80,78,0,2,2018-01-11
Manhattan,Fairfield,59,53,0,6,2018-01-11
LIU-Brooklyn,Fairleigh Dickinson,90,85,0,5,2018-01-11
USC Upstate,Florida Gulf Coast,58,75,1,-17,2018-01-11
Tulsa,Houston,71,104,1,-33,2018-01-11
Siena,Iona,69,71,1,-2,2018-01-11
South Dakota,Purdue-Fort Wayne,68,58,0,10,2018-01-11
Kennesaw State,Jacksonville,58,65,1,-7,2018-01-11
Sacred Heart,Mount St. Mary's,75,81,1,-6,2018-01-11
Holy Cross,Navy,56,61,1,-5,2018-01-11
Lipscomb,North Florida,96,102,1,-6,2018-01-11
Wright State,Northern Kentucky,84,81,0,3,2018-01-11
Maryland,Ohio State,69,91,1,-22,2018-01-11
Saint Francis (PA),Robert Morris,89,80,0,9,2018-01-11
Central Connecticut,St. Francis (NY),60,77,1,-17,2018-01-11
NJIT,Stetson,67,80,1,-13,2018-01-11
Hofstra,Towson,76,73,0,3,2018-01-11
James Madison,William & Mary,82,89,1,-7,2018-01-11
Southern Miss,Alabama-Birmingham,75,86,1,-11,2018-01-11
Texas-Arlington,Little Rock,65,77,1,-12,2018-01-11
Texas State,Arkansas State,73,67,0,6,2018-01-11
Iowa,Illinois,104,97,0,7,2018-01-11
Murray State,Jacksonville State,71,76,1,-5,2018-01-11
Idaho State,North Dakota,58,81,1,-23,2018-01-11
Denver,North Dakota State,67,61,0,6,2018-01-11
Western Kentucky,Old Dominion,75,68,0,7,2018-01-11
Oral Roberts,South Dakota State,75,78,1,-3,2018-01-11
Morehead State,Southeast Missouri State,75,78,1,-3,2018-01-11
Belmont,SIU-Edwardsville,76,61,0,15,2018-01-11
Eastern Kentucky,UT-Martin,78,70,0,8,2018-01-11
Austin Peay,Tennessee Tech,74,86,1,-12,2018-01-11
Florida International,UTSA,79,76,0,3,2018-01-11
Omaha,Western Illinois,87,66,0,21,2018-01-11
Oregon State,Arizona,53,62,1,-9,2018-01-11
Pepperdine,BYU,63,83,1,-20,2018-01-11
Wichita State,East Carolina,95,60,0,35,2018-01-11
Portland,Gonzaga,57,103,1,-46,2018-01-11
New Mexico State,Grand Canyon,70,59,0,11,2018-01-11
Louisiana Tech,Middle Tennessee,57,72,1,-15,2018-01-11
Clemson,NC State,77,78,1,-1,2018-01-11
Weber State,Northern Colorado,78,74,0,4,2018-01-11
Florida Atlantic,UTEP,73,66,0,7,2018-01-11
UMKC,Utah Valley,59,95,1,-36,2018-01-11
Stanford,Washington State,79,70,0,9,2018-01-11
Oregon,Arizona State,76,72,0,4,2018-01-11
Texas-Rio Grande Valley,Cal State Bakersfield,87,74,0,13,2018-01-11
Cal State Fullerton,UC-Irvine,67,64,0,3,2018-01-11
UC-Davis,UC-Riverside,75,65,0,10,2018-01-11
San Francisco,Loyola Marymount,65,67,1,-2,2018-01-11
San Diego,Pacific,70,74,1,-4,2018-01-11
Montana,Sacramento State,78,66,0,12,2018-01-11
Chicago State,Seattle,64,67,1,-3,2018-01-11
Montana State,Portland State,74,93,1,-19,2018-01-11
Saint Mary's,Santa Clara,81,57,0,24,2018-01-11
Utah,UCLA,64,83,1,-19,2018-01-11
California,Washington,56,66,1,-10,2018-01-11
Brown,Yale,72,78,1,-6,2018-01-12
Marquette,Butler,83,94,1,-11,2018-01-12
High Point,Campbell,64,65,1,-1,2018-01-12
St. Peter's,Canisius,58,70,1,-12,2018-01-12
Winthrop,Charleston Southern,64,53,0,11,2018-01-12
VCU,Dayton,79,106,1,-27,2018-01-12
Youngstown State,Detroit,91,93,1,-2,2018-01-12
Radford,Gardner-Webb,54,59,1,-5,2018-01-12
Delaware State,Hampton,56,78,1,-22,2018-01-12
Green Bay,IUPUI,61,67,1,-6,2018-01-12
Ohio,Kent State,69,70,1,-1,2018-01-12
Longwood,Liberty,58,51,0,7,2018-01-12
Monmouth,Niagara,77,78,1,-1,2018-01-12
Cleveland State,Oakland,68,81,1,-13,2018-01-12
Nebraska,Penn State,74,76,1,-2,2018-01-12
UNC Asheville,Presbyterian,76,56,0,20,2018-01-12
Quinnipiac,Rider,60,78,1,-18,2018-01-12
Providence,DePaul,71,64,0,7,2018-01-12
Milwaukee,UIC,73,88,1,-15,2018-01-12
Cornell,Penn,61,69,1,-8,2018-01-12
Columbia,Princeton,56,72,1,-16,2018-01-12
Idaho,Eastern Washington,58,51,0,7,2018-01-12
St. Bonaventure,Rhode Island,73,87,1,-14,2018-01-13
Wake Forest,Duke,71,89,1,-18,2018-01-13
La Salle,Duquesne,94,101,1,-7,2018-01-13
Kansas State,Kansas,72,73,1,-1,2018-01-13
Albany (NY),Maine,84,66,0,18,2018-01-13
UMBC,UMass-Lowell,89,62,0,27,2018-01-13
Michigan,Michigan State,82,72,0,10,2018-01-13
Purdue,Minnesota,81,47,0,34,2018-01-13
Georgetown,Seton Hall,61,74,1,-13,2018-01-13
Dartmouth,Boston College,72,86,1,-14,2018-01-13
Chattanooga,Citadel,101,110,1,-9,2018-01-13
South Carolina,Georgia,64,57,0,7,2018-01-13
Florida,Ole Miss,72,78,1,-6,2018-01-13
TCU,Oklahoma,97,102,1,-5,2018-01-13
UConn,Tulane,67,57,0,10,2018-01-13
Bowling Green State,Akron,78,80,1,-2,2018-01-13
Oregon,Arizona,83,90,1,-7,2018-01-13
Miami (OH),Buffalo,66,82,1,-16,2018-01-13
Syracuse,Florida State,90,101,1,-11,2018-01-13
Saint Louis,George Mason,81,86,1,-5,2018-01-13
Binghamton,Hartford,65,97,1,-32,2018-01-13
Georgia Tech,Pitt,69,54,0,15,2018-01-13
Mount St. Mary's,Saint Francis (PA),81,80,0,1,2018-01-13
Memphis,Temple,75,72,0,3,2018-01-13
West Virginia,Texas Tech,71,72,1,-1,2018-01-13
Stony Brook,Vermont,62,73,1,-11,2018-01-13
Creighton,Xavier,70,92,1,-22,2018-01-13
Georgia Southern,Appalachian State,60,59,0,1,2018-01-13
Bryant,Central Connecticut,76,80,1,-4,2018-01-13
Miami (FL),Clemson,63,72,1,-9,2018-01-13
Georgia State,Coastal Carolina,72,58,0,14,2018-01-13
Baylor,Iowa State,65,75,1,-10,2018-01-13
Auburn,Mississippi State,76,68,0,8,2018-01-13
Weber State,North Dakota,79,89,1,-10,2018-01-13
Oral Roberts,North Dakota State,64,82,1,-18,2018-01-13
North Texas,Rice,85,78,0,7,2018-01-13
Denver,South Dakota State,72,94,1,-22,2018-01-13
Florida Atlantic,UTSA,73,69,0,4,2018-01-13
Southern,Arkansas-Pine Bluff,76,78,1,-2,2018-01-13
Florida A&M,Bethune-Cookman,81,99,1,-18,2018-01-13
Toledo,Central Michigan,93,82,0,11,2018-01-13
Hofstra,Drexel,91,86,0,5,2018-01-13
VMI,ETSU,48,89,1,-41,2018-01-13
Belmont,Eastern Illinois,75,66,0,9,2018-01-13
Robert Morris,Fairleigh Dickinson,81,75,0,6,2018-01-13
Delaware,James Madison,61,60,0,1,2018-01-13
Wagner,LIU-Brooklyn,67,69,1,-2,2018-01-13
Virginia Tech,Louisville,86,94,1,-8,2018-01-13
Bradley,Loyola (IL),65,81,1,-16,2018-01-13
Samford,Mercer,50,81,1,-31,2018-01-13
Central Arkansas,Nicholls State,79,86,1,-7,2018-01-13
Morgan State,North Carolina A&T,67,69,1,-2,2018-01-13
Coppin State,North Carolina Central,61,81,1,-20,2018-01-13
Idaho State,Northern Colorado,80,94,1,-14,2018-01-13
Eastern Michigan,Northern Illinois,66,72,1,-6,2018-01-13
Abilene Christian,Northwestern State,69,58,0,11,2018-01-13
Montana,Portland State,92,89,0,3,2018-01-13
George Washington,Richmond,68,78,1,-10,2018-01-13
UMKC,Seattle,75,77,1,-2,2018-01-13
Troy,South Alabama,79,64,0,15,2018-01-13
Howard,South Carolina State,88,91,1,-3,2018-01-13
Northern Arizona,Southern Utah,75,81,1,-6,2018-01-13
Sacred Heart,St. Francis (NY),92,52,0,40,2018-01-13
USC Upstate,Stetson,69,87,1,-18,2018-01-13
Kentucky,Vanderbilt,74,67,0,7,2018-01-13
California,Washington State,53,78,1,-25,2018-01-13
Ball State,Western Michigan,58,73,1,-15,2018-01-13
Towson,William & Mary,99,73,0,26,2018-01-13
Colorado State,Wyoming,78,73,0,5,2018-01-13
Louisiana Tech,Alabama-Birmingham,62,74,1,-12,2018-01-13
Evansville,Drake,65,81,1,-16,2018-01-13
Austin Peay,Jacksonville State,87,67,0,20,2018-01-13
Alcorn State,Mississippi Valley State,77,63,0,14,2018-01-13
Texas A&M-Corpus Christi,New Orleans,55,61,1,-6,2018-01-13
Texas,Oklahoma State,64,65,1,-1,2018-01-13
Air Force,San Jose State,78,71,0,7,2018-01-13
Eastern Kentucky,Southeast Missouri State,91,86,0,5,2018-01-13
Alabama A&M,Alabama State,67,70,1,-3,2018-01-13
Oregon State,Arizona State,75,77,1,-2,2018-01-13
Missouri,Arkansas,63,65,1,-2,2018-01-13
Texas State,Little Rock,72,70,0,2,2018-01-13
Prairie View,Grambling,71,80,1,-9,2018-01-13
Texas Southern,Jackson State,80,85,1,-5,2018-01-13
Lipscomb,Jacksonville,69,87,1,-18,2018-01-13
Southern Miss,Middle Tennessee,49,69,1,-20,2018-01-13
UNC,Notre Dame,69,68,0,1,2018-01-13
Maryland-Eastern Shore,Savannah State,59,87,1,-28,2018-01-13
McNeese State,Southeastern Louisiana,71,62,0,9,2018-01-13
Illinois State,Southern Illinois,70,74,1,-4,2018-01-13
Texas A&M,Tennessee,62,75,1,-13,2018-01-13
Western Kentucky,Charlotte,73,63,0,10,2018-01-13
College of Charleston,Elon,58,63,1,-5,2018-01-13
NJIT,Florida Gulf Coast,54,68,1,-14,2018-01-13
New Mexico,Fresno State,80,89,1,-9,2018-01-13
Omaha,Purdue-Fort Wayne,78,82,1,-4,2018-01-13
Siena,Manhattan,61,72,1,-11,2018-01-13
Fairfield,Marist,89,95,1,-6,2018-01-13
Northeastern,UNC Wilmington,81,77,0,4,2018-01-13
Kennesaw State,North Florida,78,85,1,-7,2018-01-13
Marshall,Old Dominion,76,82,1,-6,2018-01-13
Columbia,Penn,71,77,1,-6,2018-01-13
Cornell,Princeton,54,91,1,-37,2018-01-13
Houston Baptist,Sam Houston State,68,81,1,-13,2018-01-13
Cincinnati,South Florida,78,55,0,23,2018-01-13
Incarnate Word,Stephen F. Austin,63,83,1,-20,2018-01-13
Morehead State,UT-Martin,71,67,0,4,2018-01-13
Wichita State,Tulsa,72,69,0,3,2018-01-13
UNC Greensboro,Western Carolina,66,55,0,11,2018-01-13
Furman,Wofford,70,79,1,-9,2018-01-13
Texas-Arlington,Arkansas State,97,71,0,26,2018-01-13
Louisiana-Monroe,Louisiana,48,82,1,-34,2018-01-13
Alabama,LSU,74,66,0,8,2018-01-13
Utah State,Nevada,57,83,1,-26,2018-01-13
Valparaiso,Northern Iowa,76,81,1,-5,2018-01-13
Saint Mary's,Pepperdine,91,67,0,24,2018-01-13
Tennessee State,SIU-Edwardsville,79,82,1,-3,2018-01-13
Villanova,St. John's (NY),78,71,0,7,2018-01-13
Murray State,Tennessee Tech,71,45,0,26,2018-01-13
Stanford,Washington,73,64,0,9,2018-01-13
Oak Hills,Western Illinois,45,107,1,-62,2018-01-13
UC-Davis,Cal State Fullerton,70,85,1,-15,2018-01-13
Long Beach State,UC-Riverside,75,68,0,7,2018-01-13
Texas-Rio Grande Valley,Grand Canyon,71,84,1,-13,2018-01-13
Gonzaga,San Francisco,75,65,0,10,2018-01-13
Florida International,UTEP,68,72,1,-4,2018-01-13
Chicago State,Utah Valley,58,83,1,-25,2018-01-13
San Diego State,Boise State,80,83,1,-3,2018-01-13
New Mexico State,Cal State Bakersfield,66,53,0,13,2018-01-13
UC-Irvine,Cal State Northridge,71,54,0,17,2018-01-13
Pacific,Portland,66,54,0,12,2018-01-13
Montana State,Sacramento State,68,87,1,-19,2018-01-13
Loyola Marymount,San Diego,71,75,1,-4,2018-01-13
BYU,Santa Clara,84,50,0,34,2018-01-13
Colorado,UCLA,68,59,0,9,2018-01-13
UCSB,Hawaii,76,77,1,-1,2018-01-14
Boston University,Holy Cross,54,40,0,14,2018-01-14
Rider,Iona,64,91,1,-27,2018-01-14
Monmouth,Canisius,79,94,1,-15,2018-01-14
Houston,East Carolina,65,49,0,16,2018-01-14
American,Lehigh,66,76,1,-10,2018-01-14
Lafayette,Loyola (MD),77,83,1,-6,2018-01-14
Army,Navy,64,62,0,2,2018-01-14
St. Peter's,Niagara,70,73,1,-3,2018-01-14
Davidson,Fordham,75,45,0,30,2018-01-14
Indiana State,Missouri State,73,76,1,-3,2018-01-14
Northwestern,Indiana,46,66,1,-20,2018-01-14
St. Joseph's,UMass,69,72,1,-3,2018-01-14
NC State,Virginia,51,68,1,-17,2018-01-14
Ohio State,Rutgers,68,46,0,22,2018-01-14
Utah,USC,67,84,1,-17,2018-01-14
New Hampshire,UMass-Lowell,74,62,0,12,2018-01-15
Morgan State,North Carolina Central,63,77,1,-14,2018-01-15
Butler,Providence,60,70,1,-10,2018-01-15
Bethune-Cookman,Stetson,74,62,0,12,2018-01-15
Youngstown State,Wright State,67,77,1,-10,2018-01-15
Alcorn State,Arkansas-Pine Bluff,59,71,1,-12,2018-01-15
Hartford,UMBC,56,78,1,-22,2018-01-15
Maryland,Michigan,67,68,1,-1,2018-01-15
Albany (NY),Binghamton,66,79,1,-13,2018-01-15
Florida State,Boston College,75,81,1,-6,2018-01-15
Bucknell,Colgate,63,51,0,12,2018-01-15
Presbyterian,High Point,49,73,1,-24,2018-01-15
Campbell,Longwood,62,76,1,-14,2018-01-15
Chattanooga,Mercer,71,75,1,-4,2018-01-15
Duke,Miami (FL),83,75,0,8,2018-01-15
Elizabeth City State,Norfolk State,76,67,0,9,2018-01-15
Charleston Southern,UNC Asheville,73,83,1,-10,2018-01-15
Coppin State,North Carolina A&T,47,60,1,-13,2018-01-15
Cleveland State,Northern Kentucky,55,70,1,-15,2018-01-15
Minnesota,Penn State,95,84,0,11,2018-01-15
Liberty,Radford,57,59,1,-2,2018-01-15
Maryland-Eastern Shore,South Carolina State,62,66,1,-4,2018-01-15
Maine,Vermont,62,83,1,-21,2018-01-15
VMI,Western Carolina,58,65,1,-7,2018-01-15
Gardner-Webb,Winthrop,67,90,1,-23,2018-01-15
Delaware State,Florida A&M,89,94,1,-5,2018-01-15
Texas Southern,Grambling,78,79,1,-1,2018-01-15
Milwaukee,Green Bay,92,99,1,-7,2018-01-15
Oakland,UIC,78,68,0,10,2018-01-15
Prairie View,Jackson State,71,79,1,-8,2018-01-15
Southern,Mississippi Valley State,78,70,0,8,2018-01-15
Howard,Savannah State,90,91,1,-1,2018-01-15
Oklahoma State,Baylor,60,76,1,-16,2018-01-15
DePaul,Marquette,52,70,1,-18,2018-01-15
Illinois,Nebraska,63,64,1,-1,2018-01-15
Kansas,West Virginia,71,66,0,5,2018-01-15
Central Michigan,Ball State,76,82,1,-6,2018-01-16
Northern Illinois,Buffalo,67,95,1,-28,2018-01-16
Cincinnati,UCF,49,38,0,11,2018-01-16
Akron,Eastern Michigan,49,63,1,-14,2018-01-16
Detroit,IUPUI,66,81,1,-15,2018-01-16
Western Michigan,Kent State,71,73,1,-2,2018-01-16
Georgia,LSU,61,60,0,1,2018-01-16
Bowling Green State,Miami (OH),81,70,0,11,2018-01-16
Vanderbilt,Mississippi State,62,80,1,-18,2018-01-16
Clemson,UNC,79,87,1,-8,2018-01-16
Louisville,Notre Dame,82,78,0,4,2018-01-16
Toledo,Ohio,91,57,0,34,2018-01-16
Wisconsin,Purdue,50,78,1,-28,2018-01-16
Texas A&M-Corpus Christi,Nicholls State,61,91,1,-30,2018-01-16
North Dakota,North Dakota State,86,77,0,9,2018-01-16
Drake,Northern Iowa,54,68,1,-14,2018-01-16
Oklahoma,Kansas State,69,87,1,-18,2018-01-16
UConn,Memphis,49,73,1,-24,2018-01-16
Kentucky,South Carolina,68,76,1,-8,2018-01-16
Pitt,Syracuse,45,59,1,-14,2018-01-16
Ole Miss,Texas A&M,69,71,1,-2,2018-01-16
Northwestern State,Sam Houston State,52,75,1,-23,2018-01-17
Villanova,Georgetown,88,56,0,32,2018-01-17
Dayton,St. Joseph's,65,81,1,-16,2018-01-17
Tulsa,Temple,58,59,1,-1,2018-01-17
Auburn,Alabama,71,76,1,-5,2018-01-17
American,Boston University,69,58,0,11,2018-01-17
South Florida,East Carolina,52,90,1,-38,2018-01-17
Arkansas,Florida,73,88,1,-15,2018-01-17
George Mason,George Washington,68,80,1,-12,2018-01-17
Army,Holy Cross,66,70,1,-4,2018-01-17
Bradley,Illinois State,57,70,1,-13,2018-01-17
Fordham,La Salle,67,75,1,-8,2018-01-17
Navy,Lafayette,75,72,0,3,2018-01-17
Colgate,Lehigh,76,72,0,4,2018-01-17
Bucknell,Loyola (MD),78,70,0,8,2018-01-17
UMass,Rhode Island,51,73,1,-22,2018-01-17
Iowa,Rutgers,64,80,1,-16,2018-01-17
Richmond,VCU,67,52,0,15,2018-01-17
SMU,Wichita State,83,78,0,5,2018-01-17
Stephen F. Austin,Abilene Christian,76,66,0,10,2018-01-17
Seton Hall,Creighton,63,80,1,-17,2018-01-17
Indiana State,Evansville,71,66,0,5,2018-01-17
Lamar,Incarnate Word,90,69,0,21,2018-01-17
Southern Illinois,Loyola (IL),65,79,1,-14,2018-01-17
Valparaiso,Missouri State,57,64,1,-7,2018-01-17
Central Arkansas,New Orleans,81,57,0,24,2018-01-17
Duquesne,Saint Louis,63,76,1,-13,2018-01-17
Oral Roberts,South Dakota,70,82,1,-12,2018-01-17
Houston Baptist,Southeastern Louisiana,69,85,1,-16,2018-01-17
Texas Tech,Texas,58,67,1,-9,2018-01-17
Houston,Tulane,72,81,1,-9,2018-01-17
Purdue-Fort Wayne,Western Illinois,74,75,1,-1,2018-01-17
St. John's (NY),Xavier,82,88,1,-6,2018-01-17
Utah State,Boise State,67,71,1,-4,2018-01-17
Arizona,California,79,58,0,21,2018-01-17
Air Force,Colorado State,76,71,0,5,2018-01-17
Tennessee,Missouri,55,59,1,-4,2018-01-17
Ohio State,Northwestern,71,65,0,6,2018-01-17
Iowa State,TCU,73,96,1,-23,2018-01-17
Long Beach State,UC-Davis,75,84,1,-9,2018-01-17
Cal State Northridge,UC-Riverside,66,57,0,9,2018-01-17
Cal State Fullerton,UCSB,64,83,1,-19,2018-01-17
New Mexico,UNLV,85,81,0,4,2018-01-17
Nevada,San Jose State,71,54,0,17,2018-01-17
Fresno State,San Diego State,77,73,0,4,2018-01-17
Arizona State,Stanford,77,86,1,-9,2018-01-17
Norfolk State,North Carolina A&T,68,71,1,-3,2018-01-18
Robert Morris,Sacred Heart,74,60,0,14,2018-01-18
Austin Peay,Tennessee State,56,70,1,-14,2018-01-18
UMass-Lowell,Albany (NY),62,70,1,-8,2018-01-18
Murray State,Belmont,72,79,1,-7,2018-01-18
Charleston Southern,Campbell,47,62,1,-15,2018-01-18
Fairleigh Dickinson,Central Connecticut,65,66,1,-1,2018-01-18
IUPUI,Cleveland State,67,70,1,-3,2018-01-18
UNC Wilmington,College of Charleston,76,80,1,-4,2018-01-18
Charlotte,Florida Atlantic,64,75,1,-11,2018-01-18
Old Dominion,Florida International,64,54,0,10,2018-01-18
ETSU,Furman,62,61,0,1,2018-01-18
Presbyterian,Gardner-Webb,53,61,1,-8,2018-01-18
Liberty,High Point,60,71,1,-11,2018-01-18
Delaware,Hofstra,63,90,1,-27,2018-01-18
Elon,James Madison,74,85,1,-11,2018-01-18
Stetson,Kennesaw State,81,95,1,-14,2018-01-18
Florida Gulf Coast,Lipscomb,88,83,0,5,2018-01-18
Bryant,LIU-Brooklyn,79,83,1,-4,2018-01-18
North Texas,Louisiana Tech,65,66,1,-1,2018-01-18
Hartford,Maine,86,68,0,18,2018-01-18
Jacksonville State,Morehead State,58,57,0,1,2018-01-18
Vermont,New Hampshire,67,56,0,11,2018-01-18
North Florida,NJIT,59,91,1,-32,2018-01-18
Citadel,UNC Greensboro,58,72,1,-14,2018-01-18
Niagara,Quinnipiac,81,73,0,8,2018-01-18
Longwood,Radford,63,70,1,-7,2018-01-18
Rider,St. Peter's,88,84,0,4,2018-01-18
Marist,Siena,65,68,1,-3,2018-01-18
Jacksonville,USC Upstate,85,91,1,-6,2018-01-18
Mount St. Mary's,St. Francis (NY),73,81,1,-8,2018-01-18
Binghamton,Stony Brook,66,77,1,-11,2018-01-18
Drexel,Towson,68,90,1,-22,2018-01-18
Mercer,VMI,62,56,0,6,2018-01-18
Saint Francis (PA),Wagner,64,73,1,-9,2018-01-18
Northeastern,William & Mary,90,70,0,20,2018-01-18
UIC,Youngstown State,92,78,0,14,2018-01-18
Grand Canyon,Chicago State,86,58,0,28,2018-01-18
Washington State,Colorado,73,82,1,-9,2018-01-18
UT-Martin,Eastern Illinois,60,80,1,-20,2018-01-18
Tennessee Tech,Eastern Kentucky,70,67,0,3,2018-01-18
Virginia,Georgia Tech,64,48,0,16,2018-01-18
Wright State,Green Bay,80,67,0,13,2018-01-18
Middle Tennessee,Marshall,63,73,1,-10,2018-01-18
Minnesota,Maryland,66,77,1,-11,2018-01-18
Northern Kentucky,Milwaukee,91,64,0,27,2018-01-18
Cal State Bakersfield,UMKC,59,62,1,-3,2018-01-18
Denver,Omaha,80,86,1,-6,2018-01-18
Wake Forest,NC State,63,72,1,-9,2018-01-18
Eastern Washington,Northern Arizona,81,76,0,5,2018-01-18
Wofford,Samford,93,89,0,4,2018-01-18
Coastal Carolina,South Alabama,57,60,1,-3,2018-01-18
Southeast Missouri State,SIU-Edwardsville,86,74,0,12,2018-01-18
Rice,Southern Miss,75,86,1,-11,2018-01-18
Idaho,Southern Utah,80,76,0,4,2018-01-18
Louisiana,Texas-Arlington,77,65,0,12,2018-01-18
Utah Valley,Texas-Rio Grande Valley,84,76,0,8,2018-01-18
Louisiana-Monroe,Texas State,52,55,1,-3,2018-01-18
Saint Mary's,Gonzaga,74,71,0,3,2018-01-18
Portland State,Idaho State,87,83,0,4,2018-01-18
Michigan,Nebraska,52,72,1,-20,2018-01-18
Seattle,New Mexico State,62,75,1,-13,2018-01-18
USC,Oregon,75,70,0,5,2018-01-18
Sacramento State,Weber State,64,80,1,-16,2018-01-18
Alabama-Birmingham,Western Kentucky,69,77,1,-8,2018-01-18
UNC Asheville,Winthrop,58,85,1,-27,2018-01-18
Cal Poly,UC-Irvine,73,80,1,-7,2018-01-18
Pepperdine,Pacific,78,92,1,-14,2018-01-18
Portland,San Diego,55,49,0,6,2018-01-18
Washington,Utah,62,70,1,-8,2018-01-18
Loyola Marymount,BYU,67,82,1,-15,2018-01-18
UCLA,Oregon State,63,69,1,-6,2018-01-18
Santa Clara,San Francisco,65,62,0,3,2018-01-18
St. Bonaventure,Davidson,73,83,1,-10,2018-01-19
Indiana,Michigan State,57,85,1,-28,2018-01-19
Iona,Monmouth,76,73,0,3,2018-01-19
Buffalo,Western Michigan,84,74,0,10,2018-01-19
Yale,Brown,80,81,1,-1,2018-01-19
Canisius,Manhattan,68,59,0,9,2018-01-19
Illinois,Wisconsin,50,75,1,-25,2018-01-19
Holy Cross,Bucknell,56,77,1,-21,2018-01-20
Villanova,UConn,81,61,0,20,2018-01-20
St. John's (NY),Georgetown,89,93,1,-4,2018-01-20
Wichita State,Houston,59,73,1,-14,2018-01-20
Purdue,Iowa,87,64,0,23,2018-01-20
Ohio State,Minnesota,67,49,0,18,2018-01-20
George Washington,VCU,63,87,1,-24,2018-01-20
Florida State,Virginia Tech,91,82,0,9,2018-01-20
Rhode Island,Dayton,88,74,0,14,2018-01-20
Niagara,Fairfield,85,104,1,-19,2018-01-20
Northern Kentucky,Green Bay,77,65,0,12,2018-01-20
North Dakota State,Purdue-Fort Wayne,88,92,1,-4,2018-01-20
Saint Francis (PA),Sacred Heart,73,60,0,13,2018-01-20
Fordham,St. Joseph's,46,68,1,-22,2018-01-20
LSU,Vanderbilt,71,77,1,-6,2018-01-20
Citadel,VMI,81,88,1,-7,2018-01-20
Lafayette,American,62,53,0,9,2018-01-20
Lehigh,Army,81,93,1,-12,2018-01-20
Loyola (MD),Colgate,72,77,1,-5,2018-01-20
Butler,DePaul,79,67,0,12,2018-01-20
Ohio,Eastern Michigan,72,66,0,6,2018-01-20
Old Dominion,Florida Atlantic,73,62,0,11,2018-01-20
Georgia Southern,Georgia State,66,83,1,-17,2018-01-20
Illinois State,Indiana State,54,84,1,-30,2018-01-20
Texas Tech,Iowa State,52,70,1,-18,2018-01-20
Saint Louis,UMass,66,47,0,19,2018-01-20
Boston University,Navy,75,68,0,7,2018-01-20
Georgia Tech,UNC,66,80,1,-14,2018-01-20
Delaware,Northeastern,64,76,1,-12,2018-01-20
Penn State,Northwestern,61,70,1,-9,2018-01-20
Oklahoma,Oklahoma State,81,83,1,-2,2018-01-20
Temple,Penn,60,51,0,9,2018-01-20
La Salle,Richmond,74,81,1,-7,2018-01-20
Xavier,Seton Hall,73,64,0,9,2018-01-20
North Florida,USC Upstate,100,80,0,20,2018-01-20
UT-Martin,SIU-Edwardsville,70,69,0,1,2018-01-20
Eastern Washington,Southern Utah,62,66,1,-4,2018-01-20
Texas,West Virginia,51,86,1,-35,2018-01-20
Ole Miss,Arkansas,93,97,1,-4,2018-01-20
Central Michigan,Bowling Green State,84,75,0,9,2018-01-20
LIU-Brooklyn,Central Connecticut,63,72,1,-9,2018-01-20
Cal State Bakersfield,Chicago State,89,78,0,11,2018-01-20
UIC,Cleveland State,87,80,0,7,2018-01-20
Ball State,Miami (OH),53,71,1,-18,2018-01-20
Creighton,Providence,71,85,1,-14,2018-01-20
Northern Illinois,Akron,67,82,1,-15,2018-01-20
Abilene Christian,Central Arkansas,80,63,0,17,2018-01-20
East Carolina,Cincinnati,60,86,1,-26,2018-01-20
Notre Dame,Clemson,58,67,1,-9,2018-01-20
Hofstra,College of Charleston,70,76,1,-6,2018-01-20
Morgan State,Coppin State,73,80,1,-7,2018-01-20
Bethune-Cookman,Delaware State,85,78,0,7,2018-01-20
Oakland,Detroit,92,86,0,6,2018-01-20
Missouri State,Drake,58,61,1,-3,2018-01-20
Pitt,Duke,54,81,1,-27,2018-01-20
George Mason,Duquesne,89,95,1,-6,2018-01-20
Western Carolina,ETSU,50,66,1,-16,2018-01-20
Southeast Missouri State,Eastern Illinois,86,74,0,12,2018-01-20
Mount St. Mary's,Fairleigh Dickinson,72,73,1,-1,2018-01-20
Samford,Furman,67,78,1,-11,2018-01-20
North Carolina Central,Howard,78,84,1,-6,2018-01-20
Drexel,James Madison,73,75,1,-2,2018-01-20
TCU,Kansas State,68,73,1,-5,2018-01-20
Florida Gulf Coast,Kennesaw State,66,49,0,17,2018-01-20
North Carolina A&T,Maryland-Eastern Shore,66,64,0,2,2018-01-20
Tennessee Tech,Morehead State,55,74,1,-19,2018-01-20
Jacksonville,NJIT,63,61,0,2,2018-01-20
Appalachian State,South Alabama,77,83,1,-6,2018-01-20
Norfolk State,South Carolina State,78,54,0,24,2018-01-20
Bryant,St. Francis (NY),80,85,1,-5,2018-01-20
Arizona,Stanford,73,71,0,2,2018-01-20
Missouri,Texas A&M,49,60,1,-11,2018-01-20
Robert Morris,Wagner,49,62,1,-13,2018-01-20
UNLV,Colorado State,79,74,0,5,2018-01-20
Sam Houston State,Lamar,77,84,1,-7,2018-01-20
Stetson,Lipscomb,82,85,1,-3,2018-01-20
Mercer,UNC Greensboro,66,70,1,-4,2018-01-20
North Texas,Southern Miss,78,85,1,-7,2018-01-20
Louisiana-Monroe,Texas-Arlington,55,71,1,-16,2018-01-20
Louisiana,Texas State,80,55,0,25,2018-01-20
Coastal Carolina,Troy,74,73,0,1,2018-01-20
Alabama A&M,Alcorn State,52,68,1,-16,2018-01-20
Arkansas State,Little Rock,70,62,0,8,2018-01-20
Georgia,Auburn,65,79,1,-14,2018-01-20
Austin Peay,Belmont,59,83,1,-24,2018-01-20
Washington,Colorado,72,62,0,10,2018-01-20
Grambling,Jackson State,72,45,0,27,2018-01-20
Baylor,Kansas,67,70,1,-3,2018-01-20
Utah Valley,New Mexico State,59,86,1,-27,2018-01-20
Arkansas-Pine Bluff,Prairie View,72,66,0,6,2018-01-20
Hampton,Savannah State,101,103,1,-2,2018-01-20
Tennessee,South Carolina,70,63,0,7,2018-01-20
UCF,South Florida,71,69,0,2,2018-01-20
Northwestern State,Southeastern Louisiana,58,85,1,-27,2018-01-20
Alabama State,Southern,61,63,1,-2,2018-01-20
Tulane,SMU,62,73,1,-11,2018-01-20
Cal Poly,Cal State Northridge,54,72,1,-18,2018-01-20
Cornell,Columbia,62,88,1,-26,2018-01-20
Harvard,Dartmouth,62,57,0,5,2018-01-20
Jacksonville State,Eastern Kentucky,68,60,0,8,2018-01-20
William & Mary,Elon,80,73,0,7,2018-01-20
Charlotte,Florida International,59,79,1,-20,2018-01-20
Rice,Louisiana Tech,54,69,1,-15,2018-01-20
Alabama-Birmingham,Marshall,78,86,1,-8,2018-01-20
San Diego State,New Mexico,75,79,1,-4,2018-01-20
Incarnate Word,New Orleans,70,74,1,-4,2018-01-20
Towson,UNC Wilmington,71,73,1,-2,2018-01-20
Idaho,Northern Arizona,84,80,0,4,2018-01-20
Marist,Rider,57,60,1,-3,2018-01-20
Kent State,Toledo,65,72,1,-7,2018-01-20
Middle Tennessee,Western Kentucky,66,62,0,4,2018-01-20
Chattanooga,Wofford,67,71,1,-4,2018-01-20
IUPUI,Youngstown State,62,85,1,-23,2018-01-20
Mississippi State,Alabama,62,68,1,-6,2018-01-20
Evansville,Bradley,53,66,1,-13,2018-01-20
McNeese State,Houston Baptist,86,81,0,5,2018-01-20
Florida,Kentucky,66,64,0,2,2018-01-20
Wright State,Milwaukee,61,66,1,-5,2018-01-20
Grand Canyon,UMKC,86,69,0,17,2018-01-20
South Dakota,Omaha,85,71,0,14,2018-01-20
Denver,Oral Roberts,73,64,0,9,2018-01-20
USC,Oregon State,74,67,0,7,2018-01-20
Gonzaga,Santa Clara,75,60,0,15,2018-01-20
Murray State,Tennessee State,76,57,0,19,2018-01-20
Seattle,Texas-Rio Grande Valley,79,76,0,3,2018-01-20
UTEP,UTSA,61,65,1,-4,2018-01-20
Mississippi Valley State,Texas Southern,77,91,1,-14,2018-01-20
Memphis,Tulsa,51,64,1,-13,2018-01-20
South Dakota State,Western Illinois,98,70,0,28,2018-01-20
San Diego,BYU,58,74,1,-16,2018-01-20
Sacramento State,Idaho State,65,71,1,-6,2018-01-20
Montana,Montana State,67,52,0,15,2018-01-20
North Dakota,Northern Colorado,91,94,1,-3,2018-01-20
Wyoming,Utah State,85,77,0,8,2018-01-20
Portland State,Weber State,79,84,1,-5,2018-01-20
Arizona State,California,81,73,0,8,2018-01-20
Cal State Fullerton,Long Beach State,73,81,1,-8,2018-01-20
Portland,Loyola Marymount,72,65,0,7,2018-01-20
Boise State,Nevada,68,74,1,-6,2018-01-20
UCLA,Oregon,91,94,1,-3,2018-01-20
Saint Mary's,Pacific,72,69,0,3,2018-01-20
Pepperdine,San Francisco,73,80,1,-7,2018-01-20
UC-Irvine,UCSB,58,70,1,-12,2018-01-20
UC-Davis,Hawaii,72,77,1,-5,2018-01-20
Boston College,Louisville,69,77,1,-8,2018-01-21
Rutgers,Michigan,47,62,1,-15,2018-01-21
Miami (FL),NC State,86,81,0,5,2018-01-21
Manhattan,St. Peter's,68,57,0,11,2018-01-21
Vermont,Hartford,76,53,0,23,2018-01-21
Canisius,Iona,84,82,0,2,2018-01-21
Stony Brook,New Hampshire,51,53,1,-2,2018-01-21
UMBC,Albany (NY),39,83,1,-44,2018-01-21
UMass-Lowell,Binghamton,79,71,0,8,2018-01-21
Radford,Campbell,56,59,1,-3,2018-01-21
UNC Asheville,Liberty,84,68,0,16,2018-01-21
Siena,Quinnipiac,69,76,1,-7,2018-01-21
High Point,Longwood,75,55,0,20,2018-01-21
Winthrop,Presbyterian,81,68,0,13,2018-01-21
Northern Iowa,Southern Illinois,53,64,1,-11,2018-01-21
Loyola (IL),Valparaiso,70,54,0,16,2018-01-21
Gardner-Webb,Charleston Southern,68,83,1,-15,2018-01-21
Virginia,Wake Forest,59,49,0,10,2018-01-21
Washington State,Utah,69,82,1,-13,2018-01-21
Holy Cross,American,60,57,0,3,2018-01-22
North Carolina A&T,Howard,88,90,1,-2,2018-01-22
Maryland,Indiana,68,71,1,-3,2018-01-22
North Carolina Central,Maryland-Eastern Shore,63,60,0,3,2018-01-22
Delaware State,Morgan State,47,61,1,-14,2018-01-22
Hampton,South Carolina State,91,84,0,7,2018-01-22
Iowa State,Texas,57,73,1,-16,2018-01-22
UNC,Virginia Tech,69,80,1,-11,2018-01-22
Alabama State,Alcorn State,64,81,1,-17,2018-01-22
Nebraska,Ohio State,59,64,1,-5,2018-01-22
Mississippi Valley State,Prairie View,77,93,1,-16,2018-01-22
Norfolk State,Savannah State,99,104,1,-5,2018-01-22
Alabama A&M,Southern,61,62,1,-1,2018-01-22
Arkansas-Pine Bluff,Texas Southern,74,72,0,2,2018-01-22
Appalachian State,Troy,79,81,1,-2,2018-01-22
Kansas State,Baylor,90,83,0,7,2018-01-22
Michigan State,Illinois,87,74,0,13,2018-01-22
West Virginia,TCU,73,82,1,-9,2018-01-22
Arkansas,Georgia,80,77,0,3,2018-01-23
Providence,Villanova,69,89,1,-20,2018-01-23
Ohio,Akron,68,71,1,-3,2018-01-23
Eastern Michigan,Buffalo,69,83,1,-14,2018-01-23
Miami (OH),Central Michigan,70,61,0,9,2018-01-23
Davidson,Dayton,64,65,1,-1,2018-01-23
Rider,Fairfield,90,88,0,2,2018-01-23
Wisconsin,Iowa,67,85,1,-18,2018-01-23
Ball State,Kent State,80,88,1,-8,2018-01-23
Campbell,Liberty,94,85,0,9,2018-01-23
William Jewell,UMKC,86,74,0,12,2018-01-23
Kansas,Oklahoma,80,85,1,-5,2018-01-23
Vanderbilt,Tennessee,62,67,1,-5,2018-01-23
Oklahoma State,Texas Tech,70,75,1,-5,2018-01-23
Clemson,Virginia,36,61,1,-25,2018-01-23
Toledo,Western Michigan,85,81,0,4,2018-01-23
Missouri State,Bradley,52,72,1,-20,2018-01-23
Alabama,Ole Miss,66,78,1,-12,2018-01-23
Bowling Green State,Northern Illinois,62,93,1,-31,2018-01-23
East Texas Baptist,Oral Roberts,66,93,1,-27,2018-01-23
Creighton,St. John's (NY),68,63,0,5,2018-01-23
William Jessup,Grand Canyon,80,96,1,-16,2018-01-23
Mississippi State,Kentucky,65,78,1,-13,2018-01-23
Texas A&M,LSU,65,77,1,-12,2018-01-23
Northwestern,Minnesota,77,69,0,8,2018-01-23
VCU,Saint Louis,75,74,0,1,2018-01-23
Duke,Wake Forest,84,70,0,14,2018-01-23
UNLV,Fresno State,63,69,1,-6,2018-01-23
Marquette,Xavier,70,89,1,-19,2018-01-24
Colgate,Army,81,78,0,3,2018-01-24
Presbyterian,Charleston Southern,57,49,0,8,2018-01-24
Samford,Chattanooga,71,78,1,-7,2018-01-24
Richmond,Duquesne,77,73,0,4,2018-01-24
Mercer,ETSU,75,84,1,-9,2018-01-24
South Carolina,Florida,77,72,0,5,2018-01-24
Georgia Tech,Florida State,77,88,1,-11,2018-01-24
Rhode Island,Fordham,78,58,0,20,2018-01-24
Radford,High Point,78,76,0,2,2018-01-24
Stetson,Jacksonville,69,76,1,-7,2018-01-24
NJIT,Kennesaw State,66,60,0,6,2018-01-24
UMass,La Salle,72,87,1,-15,2018-01-24
Boston University,Lafayette,75,72,0,3,2018-01-24
Loyola (MD),Lehigh,91,88,0,3,2018-01-24
USC Upstate,Lipscomb,78,92,1,-14,2018-01-24
Winthrop,Longwood,95,78,0,17,2018-01-24
New Hampshire,Maine,68,69,1,-1,2018-01-24
Binghamton,UMBC,57,69,1,-12,2018-01-24
Stony Brook,UMass-Lowell,79,82,1,-3,2018-01-24
Bucknell,Navy,87,67,0,20,2018-01-24
Manhattan,Niagara,63,72,1,-9,2018-01-24
Gardner-Webb,UNC Asheville,60,65,1,-5,2018-01-24
Furman,UNC Greensboro,61,71,1,-10,2018-01-24
Florida Gulf Coast,North Florida,96,87,0,9,2018-01-24
New Orleans,Northwestern State,73,67,0,6,2018-01-24
Nebraska,Rutgers,60,54,0,6,2018-01-24
Southeastern Louisiana,Sam Houston State,65,75,1,-10,2018-01-24
St. Joseph's,St. Bonaventure,67,70,1,-3,2018-01-24
Boston College,Syracuse,63,81,1,-18,2018-01-24
Albany (NY),Vermont,50,61,1,-11,2018-01-24
Wofford,VMI,63,46,0,17,2018-01-24
Stephen F. Austin,Central Arkansas,92,100,1,-8,2018-01-24
Loyola (IL),Drake,80,57,0,23,2018-01-24
DePaul,Georgetown,74,73,0,1,2018-01-24
Incarnate Word,Houston Baptist,86,102,1,-16,2018-01-24
Nicholls State,Lamar,79,74,0,5,2018-01-24
Louisville,Miami (FL),75,78,1,-3,2018-01-24
Illinois State,Northern Iowa,72,83,1,-11,2018-01-24
South Dakota State,South Dakota,68,87,1,-19,2018-01-24
Indiana State,Southern Illinois,77,82,1,-5,2018-01-24
Abilene Christian,Texas A&M-Corpus Christi,66,80,1,-14,2018-01-24
Evansville,Valparaiso,75,65,0,10,2018-01-24
Temple,Cincinnati,42,75,1,-33,2018-01-24
Indiana,Illinois,71,73,1,-2,2018-01-24
Auburn,Missouri,91,73,0,18,2018-01-24
NC State,Pitt,72,68,0,4,2018-01-24
Stanford,USC,64,69,1,-5,2018-01-24
Air Force,Utah State,49,71,1,-22,2018-01-24
San Jose State,Boise State,71,94,1,-23,2018-01-24
UC-Riverside,UC-Irvine,40,79,1,-39,2018-01-24
Colorado State,San Diego State,78,97,1,-19,2018-01-24
Nevada,Wyoming,103,104,1,-1,2018-01-24
Little Rock,Appalachian State,67,72,1,-5,2018-01-25
Central Connecticut,Bryant,80,74,0,6,2018-01-25
Arkansas State,Coastal Carolina,47,62,1,-15,2018-01-25
SMU,UConn,52,63,1,-11,2018-01-25
College of Charleston,Delaware,62,54,0,8,2018-01-25
Elon,Drexel,79,83,1,-4,2018-01-25
St. Francis (NY),Fairleigh Dickinson,76,70,0,6,2018-01-25
Texas State,Georgia Southern,62,61,0,1,2018-01-25
Texas-Arlington,Georgia State,75,81,1,-6,2018-01-25
Northeastern,Hofstra,81,67,0,14,2018-01-25
Quinnipiac,Marist,85,77,0,8,2018-01-25
UTSA,Middle Tennessee,51,75,1,-24,2018-01-25
Siena,Monmouth,56,67,1,-11,2018-01-25
Morehead State,Murray State,81,87,1,-6,2018-01-25
James Madison,UNC Wilmington,68,71,1,-3,2018-01-25
Michigan,Purdue,88,92,1,-4,2018-01-25
William & Mary,Towson,82,96,1,-14,2018-01-25
Southern Wesleyan,Western Carolina,48,108,1,-60,2018-01-25
UTEP,Alabama-Birmingham,78,85,1,-7,2018-01-25
Colorado,Arizona,71,80,1,-9,2018-01-25
Eastern Kentucky,Austin Peay,84,90,1,-6,2018-01-25
Eastern Illinois,Belmont,59,81,1,-22,2018-01-25
Cleveland State,Green Bay,44,66,1,-22,2018-01-25
UT-Martin,Jacksonville State,67,63,0,4,2018-01-25
South Alabama,Louisiana,57,76,1,-19,2018-01-25
Troy,Louisiana-Monroe,71,76,1,-5,2018-01-25
Youngstown State,Milwaukee,55,66,1,-11,2018-01-25
Omaha,North Dakota State,58,73,1,-15,2018-01-25
Florida Atlantic,North Texas,53,59,1,-6,2018-01-25
Penn State,Ohio State,82,79,0,3,2018-01-25
Florida International,Rice,64,73,1,-9,2018-01-25
SIU-Edwardsville,Tennessee State,57,85,1,-28,2018-01-25
Southeast Missouri State,Tennessee Tech,65,76,1,-11,2018-01-25
Utah,Arizona State,80,77,0,3,2018-01-25
Western Illinois,Denver,58,70,1,-12,2018-01-25
North Dakota,Eastern Washington,71,95,1,-24,2018-01-25
Southern Utah,Montana,47,71,1,-24,2018-01-25
Northern Arizona,Montana State,77,75,0,2,2018-01-25
LIU-Brooklyn,Mount St. Mary's,80,86,1,-6,2018-01-25
South Florida,Tulane,80,75,0,5,2018-01-25
UCF,Wichita State,62,81,1,-19,2018-01-25
Long Beach State,Cal Poly,87,71,0,16,2018-01-25
UCSB,Cal State Fullerton,70,65,0,5,2018-01-25
Cal State Northridge,UC-Davis,56,63,1,-7,2018-01-25
Northern Colorado,Idaho,80,63,0,17,2018-01-25
Loyola Marymount,Pepperdine,70,71,1,-1,2018-01-25
Santa Clara,San Diego,58,66,1,-8,2018-01-25
Pacific,San Francisco,67,69,1,-2,2018-01-25
California,UCLA,57,70,1,-13,2018-01-25
Gonzaga,Portland,95,79,0,16,2018-01-25
BYU,Saint Mary's,62,75,1,-13,2018-01-25
Wagner,Saint Francis (PA),91,61,0,30,2018-01-26
Buffalo,Ohio,73,66,0,7,2018-01-26
Dartmouth,Brown,62,64,1,-2,2018-01-26
St. Peter's,Rider,60,63,1,-3,2018-01-26
Sacred Heart,Robert Morris,56,64,1,-8,2018-01-26
Detroit,Wright State,55,87,1,-32,2018-01-26
Harvard,Yale,54,52,0,2,2018-01-26
Wisconsin,Michigan State,61,76,1,-15,2018-01-26
Oakland,Northern Kentucky,83,70,0,13,2018-01-26
Cal State Bakersfield,Seattle,55,59,1,-4,2018-01-26
Akron,Ball State,106,111,1,-5,2018-01-27
Baylor,Florida,60,81,1,-21,2018-01-27
NC State,UNC,95,91,0,4,2018-01-27
Duquesne,Rhode Island,58,61,1,-3,2018-01-27
Texas Tech,South Carolina,70,63,0,7,2018-01-27
Fairleigh Dickinson,Bryant,89,78,0,11,2018-01-27
Quinnipiac,Fairfield,75,70,0,5,2018-01-27
Youngstown State,Green Bay,67,85,1,-18,2018-01-27
Maine,UMBC,74,86,1,-12,2018-01-27
Oklahoma,Alabama,73,80,1,-7,2018-01-27
St. John's (NY),Butler,45,70,1,-25,2018-01-27
American,Colgate,69,83,1,-14,2018-01-27
Northeastern,Drexel,67,68,1,-1,2018-01-27
Virginia,Duke,65,63,0,2,2018-01-27
Drake,Evansville,73,77,1,-4,2018-01-27
UMass,Fordham,69,82,1,-13,2018-01-27
VCU,George Mason,84,76,0,8,2018-01-27
Texas State,Georgia State,50,54,1,-4,2018-01-27
Lafayette,Holy Cross,74,85,1,-11,2018-01-27
Georgia,Kansas State,51,56,1,-5,2018-01-27
Cleveland State,Milwaukee,47,70,1,-23,2018-01-27
Charleston Southern,Radford,84,81,0,3,2018-01-27
Kennesaw State,USC Upstate,81,80,0,1,2018-01-27
Ole Miss,Texas,72,85,1,-13,2018-01-27
Elon,Towson,83,76,0,7,2018-01-27
Northern Illinois,Western Michigan,72,79,1,-7,2018-01-27
Campbell,Winthrop,64,75,1,-11,2018-01-27
Arkansas State,Appalachian State,93,88,0,5,2018-01-27
Texas-Rio Grande Valley,Chicago State,87,81,0,6,2018-01-27
Little Rock,Coastal Carolina,62,72,1,-10,2018-01-27
James Madison,College of Charleston,59,66,1,-7,2018-01-27
Longwood,Gardner-Webb,57,60,1,-3,2018-01-27
New Orleans,Incarnate Word,68,58,0,10,2018-01-27
Troy,Louisiana,69,81,1,-12,2018-01-27
South Alabama,Louisiana-Monroe,74,83,1,-9,2018-01-27
Eastern Michigan,Miami (OH),58,48,0,10,2018-01-27
Western Illinois,North Dakota State,69,80,1,-11,2018-01-27
Florida Atlantic,Rice,63,62,0,1,2018-01-27
New Hampshire,Binghamton,57,52,0,5,2018-01-27
Kent State,Central Michigan,84,76,0,8,2018-01-27
South Carolina State,Coppin State,65,73,1,-8,2018-01-27
Columbia,Cornell,81,82,1,-1,2018-01-27
Savannah State,Delaware State,106,86,0,20,2018-01-27
Miami (FL),Florida State,94,103,1,-9,2018-01-27
Western Carolina,Furman,66,100,1,-34,2018-01-27
IUPUI,UIC,62,71,1,-9,2018-01-27
Tennessee,Iowa State,68,45,0,23,2018-01-27
Texas A&M,Kansas,68,79,1,-11,2018-01-27
Central Connecticut,LIU-Brooklyn,89,94,1,-5,2018-01-27
San Diego,Loyola Marymount,89,82,0,7,2018-01-27
Army,Loyola (MD),68,79,1,-11,2018-01-27
Howard,Maryland-Eastern Shore,85,75,0,10,2018-01-27
Citadel,Mercer,76,74,0,2,2018-01-27
Marist,Monmouth,78,91,1,-13,2018-01-27
Southern Utah,Montana State,66,69,1,-3,2018-01-27
St. Francis (NY),Mount St. Mary's,72,86,1,-14,2018-01-27
Lipscomb,NJIT,86,79,0,7,2018-01-27
High Point,UNC Asheville,77,84,1,-7,2018-01-27
North Carolina Central,North Carolina A&T,64,70,1,-6,2018-01-27
Central Arkansas,Northwestern State,95,78,0,17,2018-01-27
Rutgers,Penn State,43,60,1,-17,2018-01-27
Syracuse,Pitt,60,55,0,5,2018-01-27
Sacramento State,Portland State,71,61,0,10,2018-01-27
Liberty,Presbyterian,81,66,0,15,2018-01-27
Dayton,Saint Louis,65,75,1,-10,2018-01-27
North Florida,Stetson,73,65,0,8,2018-01-27
TCU,Vanderbilt,78,81,1,-3,2018-01-27
Utah,Arizona,73,74,1,-1,2018-01-27
VMI,Chattanooga,70,69,0,1,2018-01-27
Northern Colorado,Eastern Washington,65,67,1,-2,2018-01-27
Texas-Arlington,Georgia Southern,59,74,1,-15,2018-01-27
McNeese State,Lamar,80,86,1,-6,2018-01-27
Hartford,UMass-Lowell,77,70,0,7,2018-01-27
Jackson State,Mississippi Valley State,67,72,1,-5,2018-01-27
Nebraska Christian,Oral Roberts,74,105,1,-31,2018-01-27
Wyoming,San Jose State,90,86,0,4,2018-01-27
Purdue-Fort Wayne,South Dakota State,76,78,1,-2,2018-01-27
Grand Canyon,Utah Valley,56,68,1,-12,2018-01-27
Prairie View,Alabama State,86,80,0,6,2018-01-27
Oklahoma State,Arkansas,65,66,1,-1,2018-01-27
LSU,Auburn,70,95,1,-25,2018-01-27
SIU-Edwardsville,Belmont,72,83,1,-11,2018-01-27
Harvard,Brown,86,77,0,9,2018-01-27
South Dakota,Denver,68,84,1,-16,2018-01-27
Florida A&M,Hampton,75,71,0,4,2018-01-27
Cincinnati,Memphis,62,48,0,14,2018-01-27
Southern Illinois,Missouri State,79,77,0,2,2018-01-27
Bethune-Cookman,Norfolk State,70,71,1,-1,2018-01-27
Florida International,North Texas,67,69,1,-2,2018-01-27
Santa Clara,Pepperdine,73,59,0,14,2018-01-27
Alcorn State,Southern,48,61,1,-13,2018-01-27
Texas Southern,Alabama A&M,58,56,0,2,2018-01-27
Niagara,Canisius,105,89,0,16,2018-01-27
Old Dominion,Charlotte,88,66,0,22,2018-01-27
Hofstra,Delaware,64,59,0,5,2018-01-27
Jacksonville,Florida Gulf Coast,62,68,1,-6,2018-01-27
Utah State,Fresno State,65,62,0,3,2018-01-27
Navy,Lehigh,77,75,0,2,2018-01-27
Southern Miss,Louisiana Tech,66,89,1,-23,2018-01-27
Iona,Manhattan,78,65,0,13,2018-01-27
UTEP,Middle Tennessee,50,81,1,-31,2018-01-27
Southeastern Louisiana,Nicholls State,67,63,0,4,2018-01-27
William & Mary,UNC Wilmington,84,81,0,3,2018-01-27
St. Joseph's,Penn,56,67,1,-11,2018-01-27
Sam Houston State,Stephen F. Austin,66,82,1,-16,2018-01-27
Albany (NY),Stony Brook,57,50,0,7,2018-01-27
Bowling Green State,Toledo,75,101,1,-26,2018-01-27
Kentucky,West Virginia,83,76,0,7,2018-01-27
Marshall,Western Kentucky,74,85,1,-11,2018-01-27
ETSU,Wofford,75,62,0,13,2018-01-27
Dartmouth,Yale,64,74,1,-10,2018-01-27
UTSA,Alabama-Birmingham,82,70,0,12,2018-01-27
Colorado,Arizona State,66,80,1,-14,2018-01-27
Grambling,Arkansas-Pine Bluff,69,68,0,1,2018-01-27
Morehead State,Austin Peay,76,92,1,-16,2018-01-27
Cal Poly,UC-Davis,56,80,1,-24,2018-01-27
UCSB,UC-Riverside,76,69,0,7,2018-01-27
Georgetown,Creighton,77,85,1,-8,2018-01-27
San Francisco,Gonzaga,73,82,1,-9,2018-01-27
Southeast Missouri State,Jacksonville State,60,78,1,-18,2018-01-27
Wake Forest,Louisville,77,96,1,-19,2018-01-27
Missouri,Mississippi State,62,74,1,-12,2018-01-27
New Mexico State,UMKC,73,48,0,25,2018-01-27
Eastern Kentucky,Murray State,73,88,1,-15,2018-01-27
Iowa,Nebraska,84,98,1,-14,2018-01-27
Virginia Tech,Notre Dame,80,75,0,5,2018-01-27
Oregon State,Oregon,57,66,1,-9,2018-01-27
UNC Greensboro,Samford,98,82,0,16,2018-01-27
Eastern Illinois,Tennessee State,47,50,1,-3,2018-01-27
UT-Martin,Tennessee Tech,55,63,1,-8,2018-01-27
Houston Baptist,Texas A&M-Corpus Christi,69,79,1,-10,2018-01-27
Pacific,BYU,65,80,1,-15,2018-01-27
Weber State,Idaho State,77,70,0,7,2018-01-27
Northern Arizona,Montana,64,82,1,-18,2018-01-27
Colorado State,New Mexico,65,80,1,-15,2018-01-27
Boise State,Air Force,70,64,0,6,2018-01-27
Long Beach State,Cal State Northridge,70,66,0,4,2018-01-27
North Dakota,Idaho,71,96,1,-25,2018-01-27
Valparaiso,Illinois State,65,76,1,-11,2018-01-27
San Diego State,UNLV,78,88,1,-10,2018-01-27
Stanford,UCLA,73,89,1,-16,2018-01-27
Portland,Saint Mary's,55,72,1,-17,2018-01-27
Cal State Fullerton,Hawaii,69,66,0,3,2018-01-28
Bucknell,Boston University,91,79,0,12,2018-01-28
George Washington,St. Bonaventure,52,70,1,-18,2018-01-28
Villanova,Marquette,85,82,0,3,2018-01-28
Michigan State,Maryland,74,68,0,6,2018-01-28
Detroit,Northern Kentucky,44,72,1,-28,2018-01-28
Rowan,Princeton,50,86,1,-36,2018-01-28
Richmond,Davidson,66,63,0,3,2018-01-28
Bradley,Indiana State,81,73,0,8,2018-01-28
Wagner,Robert Morris,77,64,0,13,2018-01-28
Sacred Heart,Saint Francis (PA),71,72,1,-1,2018-01-28
East Carolina,SMU,61,86,1,-25,2018-01-28
Oakland,Wright State,51,64,1,-13,2018-01-28
South Florida,Houston,40,63,1,-23,2018-01-28
Purdue,Indiana,74,67,0,7,2018-01-28
Seton Hall,DePaul,86,70,0,16,2018-01-28
Northern Iowa,Loyola (IL),47,70,1,-23,2018-01-28
California,USC,59,77,1,-18,2018-01-28
Clemson,Georgia Tech,72,70,0,2,2018-01-28
Tulsa,Wichita State,71,90,1,-19,2018-01-28
UConn,Temple,57,85,1,-28,2018-01-28
Washington State,Washington,62,80,1,-18,2018-01-28
ETSU,Citadel,73,71,0,2,2018-01-29
UNC Greensboro,Chattanooga,85,87,1,-2,2018-01-29
Maryland-Eastern Shore,Coppin State,68,71,1,-3,2018-01-29
Notre Dame,Duke,66,88,1,-22,2018-01-29
Iona,Fairfield,100,103,1,-3,2018-01-29
North Florida,Florida Gulf Coast,70,103,1,-33,2018-01-29
Bethune-Cookman,Hampton,69,80,1,-11,2018-01-29
Lehigh,Holy Cross,71,67,0,4,2018-01-29
Northwestern,Michigan,47,58,1,-11,2018-01-29
South Carolina State,Morgan State,74,59,0,15,2018-01-29
Kennesaw State,NJIT,71,74,1,-3,2018-01-29
Monmouth,Rider,85,92,1,-7,2018-01-29
St. Peter's,Siena,57,59,1,-2,2018-01-29
Lipscomb,USC Upstate,110,106,0,4,2018-01-29
Jacksonville,Stetson,68,67,0,1,2018-01-29
Western Carolina,Wofford,68,77,1,-9,2018-01-29
Prairie View,Alabama A&M,88,67,0,21,2018-01-29
Texas Southern,Alabama State,97,82,0,15,2018-01-29
Jackson State,Arkansas-Pine Bluff,58,60,1,-2,2018-01-29
UIC,Milwaukee,74,56,0,18,2018-01-29
Grambling,Mississippi Valley State,92,89,0,3,2018-01-29
Florida A&M,Norfolk State,71,80,1,-9,2018-01-29
VMI,Samford,79,93,1,-14,2018-01-29
Kansas,Kansas State,70,56,0,14,2018-01-29
Nebraska,Wisconsin,74,63,0,11,2018-01-29
Rhode Island,UMass,85,83,0,2,2018-01-30
Ohio,Bowling Green State,50,66,1,-16,2018-01-30
Northern Illinois,Central Michigan,67,81,1,-14,2018-01-30
UNC,Clemson,78,82,1,-4,2018-01-30
Western Michigan,Eastern Michigan,71,57,0,14,2018-01-30
Florida,Georgia,60,72,1,-12,2018-01-30
Rutgers,Illinois,60,91,1,-31,2018-01-30
Buffalo,Kent State,79,82,1,-3,2018-01-30
Marist,Manhattan,62,59,0,3,2018-01-30
Sam Houston State,McNeese State,67,57,0,10,2018-01-30
Akron,Miami (OH),64,79,1,-15,2018-01-30
Indiana,Ohio State,56,71,1,-15,2018-01-30
TCU,Oklahoma State,79,66,0,13,2018-01-30
Ball State,Toledo,75,63,0,12,2018-01-30
Southern Illinois,Drake,78,67,0,11,2018-01-30
Illinois State,Missouri State,76,60,0,16,2018-01-30
Omaha,South Dakota State,60,80,1,-20,2018-01-30
Xavier,St. John's (NY),73,68,0,5,2018-01-30
Wayland Baptist,Texas-Rio Grande Valley,50,86,1,-36,2018-01-30
Minnesota,Iowa,80,94,1,-14,2018-01-30
Vanderbilt,Kentucky,81,83,1,-2,2018-01-30
Auburn,Ole Miss,79,70,0,9,2018-01-30
Northern New Mexico,New Mexico State,45,71,1,-26,2018-01-30
Baylor,Oklahoma,96,98,1,-2,2018-01-30
Arkansas,Texas A&M,66,80,1,-14,2018-01-30
Tulane,East Carolina,71,69,0,2,2018-01-31
Penn State,Michigan State,68,76,1,-8,2018-01-31
LSU,Tennessee,61,84,1,-23,2018-01-31
Navy,American,61,44,0,17,2018-01-31
Vermont,Binghamton,68,54,0,14,2018-01-31
Loyola (MD),Boston University,55,64,1,-9,2018-01-31
Army,Bucknell,71,83,1,-12,2018-01-31
Houston,Cincinnati,70,80,1,-10,2018-01-31
La Salle,Davidson,65,84,1,-19,2018-01-31
St. Bonaventure,George Mason,85,69,0,16,2018-01-31
Duquesne,George Washington,75,73,0,2,2018-01-31
Coppin State,Hampton,59,70,1,-11,2018-01-31
West Virginia,Iowa State,77,93,1,-16,2018-01-31
Colgate,Lafayette,83,93,1,-10,2018-01-31
UMass-Lowell,Maine,88,64,0,24,2018-01-31
Pitt,Miami (FL),57,69,1,-12,2018-01-31
Hartford,New Hampshire,79,62,0,17,2018-01-31
Saint Louis,St. Joseph's,60,59,0,1,2018-01-31
Providence,Seton Hall,57,73,1,-16,2018-01-31
UMBC,Stony Brook,67,63,0,4,2018-01-31
Louisville,Virginia,64,74,1,-10,2018-01-31
Lamar,Abilene Christian,69,74,1,-5,2018-01-31
Loyola (IL),Bradley,67,69,1,-2,2018-01-31
Northern Iowa,Evansville,49,57,1,-8,2018-01-31
Savannah State,Florida A&M,107,100,0,7,2018-01-31
Syracuse,Georgia Tech,51,55,1,-4,2018-01-31
Northwestern State,New Orleans,64,82,1,-18,2018-01-31
Maryland,Purdue,67,75,1,-8,2018-01-31
Mississippi State,South Carolina,81,76,0,5,2018-01-31
Memphis,South Florida,86,74,0,12,2018-01-31
Texas A&M-Corpus Christi,Southeastern Louisiana,67,54,0,13,2018-01-31
Houston Baptist,Stephen F. Austin,82,102,1,-20,2018-01-31
Indiana State,Valparaiso,63,69,1,-6,2018-01-31
Florida State,Wake Forest,72,76,1,-4,2018-01-31
Missouri,Alabama,69,60,0,9,2018-01-31
Virginia Tech,Boston College,85,80,0,5,2018-01-31
UConn,UCF,61,70,1,-9,2018-01-31
Wyoming,Colorado State,91,86,0,5,2018-01-31
Butler,Marquette,92,72,0,20,2018-01-31
Texas,Texas Tech,71,73,1,-2,2018-01-31
New Mexico,Utah State,80,89,1,-9,2018-01-31
UC-Riverside,Cal Poly,68,71,1,-3,2018-01-31
UC-Irvine,Long Beach State,75,68,0,7,2018-01-31
Arizona,Washington State,100,72,0,28,2018-01-31
Fresno State,Nevada,92,102,1,-10,2018-01-31
San Jose State,UNLV,67,76,1,-9,2018-01-31
Wofford,Citadel,78,80,1,-2,2018-02-01
Fairleigh Dickinson,Saint Francis (PA),60,74,1,-14,2018-02-01
Creighton,Villanova,78,98,1,-20,2018-02-01
St. Francis (NY),Bryant,73,69,0,4,2018-02-01
UNC Asheville,Campbell,64,57,0,7,2018-02-01
High Point,Charleston Southern,74,83,1,-9,2018-02-01
Alabama-Birmingham,Charlotte,76,64,0,12,2018-02-01
Wright State,Cleveland State,74,77,1,-3,2018-02-01
Towson,Delaware,75,71,0,4,2018-02-01
James Madison,Drexel,74,76,1,-2,2018-02-01
Samford,ETSU,76,96,1,-20,2018-02-01
Louisiana Tech,Florida Atlantic,67,62,0,5,2018-02-01
Southern Miss,Florida International,70,76,1,-6,2018-02-01
UNC Wilmington,Hofstra,76,96,1,-20,2018-02-01
Oral Roberts,Purdue-Fort Wayne,75,85,1,-10,2018-02-01
Winthrop,Liberty,61,77,1,-16,2018-02-01
Furman,Mercer,85,73,0,12,2018-02-01
Tennessee State,Morehead State,61,58,0,3,2018-02-01
VMI,UNC Greensboro,51,73,1,-22,2018-02-01
College of Charleston,Northeastern,69,64,0,5,2018-02-01
Longwood,Presbyterian,62,67,1,-5,2018-02-01
Gardner-Webb,Radford,66,70,1,-4,2018-02-01
Mount St. Mary's,Robert Morris,67,42,0,25,2018-02-01
Wichita State,Temple,79,81,1,-2,2018-02-01
Central Connecticut,Wagner,59,72,1,-13,2018-02-01
Chattanooga,Western Carolina,68,70,1,-2,2018-02-01
Elon,William & Mary,92,99,1,-7,2018-02-01
Northern Kentucky,Youngstown State,95,85,0,10,2018-02-01
Georgia Southern,Little Rock,67,61,0,6,2018-02-01
Georgia State,Arkansas State,77,66,0,11,2018-02-01
Jacksonville State,Eastern Illinois,75,56,0,19,2018-02-01
Belmont,Eastern Kentucky,98,63,0,35,2018-02-01
Montana State,North Dakota,74,75,1,-1,2018-02-01
Idaho State,Northern Arizona,63,61,0,2,2018-02-01
Middle Tennessee,Old Dominion,66,59,0,7,2018-02-01
North Dakota State,South Dakota State,63,82,1,-19,2018-02-01
Murray State,Southeast Missouri State,87,75,0,12,2018-02-01
Tennessee Tech,SIU-Edwardsville,68,67,0,1,2018-02-01
Weber State,Southern Utah,90,80,0,10,2018-02-01
Austin Peay,UT-Martin,59,57,0,2,2018-02-01
Appalachian State,Texas-Arlington,77,89,1,-12,2018-02-01
Marshall,UTSA,77,81,1,-4,2018-02-01
Coastal Carolina,Texas State,56,54,0,2,2018-02-01
SMU,Tulsa,67,76,1,-9,2018-02-01
South Dakota,Western Illinois,80,54,0,26,2018-02-01
Northwestern,Wisconsin,60,52,0,8,2018-02-01
Oregon,California,66,53,0,13,2018-02-01
San Diego,Gonzaga,59,69,1,-10,2018-02-01
UMKC,Grand Canyon,62,79,1,-17,2018-02-01
Montana,Northern Colorado,88,79,0,9,2018-02-01
LIU-Brooklyn,Sacred Heart,69,60,0,9,2018-02-01
Chicago State,Cal State Bakersfield,61,91,1,-30,2018-02-01
UC-Davis,Cal State Northridge,63,56,0,7,2018-02-01
Hawaii,UCSB,82,84,1,-2,2018-02-01
Pepperdine,Portland,76,85,1,-9,2018-02-01
Eastern Washington,Sacramento State,74,54,0,20,2018-02-01
Western Kentucky,UTEP,72,60,0,12,2018-02-01
BYU,Loyola Marymount,69,76,1,-7,2018-02-01
Idaho,Portland State,97,88,0,9,2018-02-01
San Francisco,Saint Mary's,43,79,1,-36,2018-02-01
Pacific,Santa Clara,63,45,0,18,2018-02-01
Oregon State,Stanford,71,80,1,-9,2018-02-01
Arizona State,Washington,64,68,1,-4,2018-02-01
Yale,Princeton,73,76,1,-3,2018-02-02
Western Michigan,Buffalo,86,92,1,-6,2018-02-02
Harvard,Columbia,76,83,1,-7,2018-02-02
Dartmouth,Cornell,85,86,1,-1,2018-02-02
IUPUI,Detroit,60,74,1,-14,2018-02-02
Quinnipiac,Iona,82,87,1,-5,2018-02-02
Canisius,Marist,73,67,0,6,2018-02-02
Fairfield,Monmouth,79,78,0,1,2018-02-02
Brown,Penn,90,95,1,-5,2018-02-02
Niagara,St. Peter's,52,58,1,-6,2018-02-02
Manhattan,Siena,51,47,0,4,2018-02-02
Rhode Island,VCU,81,68,0,13,2018-02-02
Green Bay,Milwaukee,58,76,1,-18,2018-02-02
Utah,Colorado,55,67,1,-12,2018-02-02
UIC,Oakland,79,73,0,6,2018-02-02
Toledo,Akron,77,56,0,21,2018-02-03
DePaul,Butler,57,80,1,-23,2018-02-03
Houston,UCF,69,65,0,4,2018-02-03
Cincinnati,UConn,65,57,0,8,2018-02-03
Ball State,Eastern Michigan,41,58,1,-17,2018-02-03
Oklahoma State,Kansas,84,79,0,5,2018-02-03
Notre Dame,NC State,58,76,1,-18,2018-02-03
Duke,St. John's (NY),77,81,1,-4,2018-02-03
Furman,Citadel,92,100,1,-8,2018-02-03
Binghamton,Maine,79,81,1,-2,2018-02-03
Memphis,East Carolina,85,88,1,-3,2018-02-03
Denver,Purdue-Fort Wayne,63,91,1,-28,2018-02-03
Boston University,Lehigh,75,80,1,-5,2018-02-03
Liberty,Longwood,67,55,0,12,2018-02-03
Missouri State,Loyola (IL),75,97,1,-22,2018-02-03
Providence,Marquette,77,75,0,2,2018-02-03
Dayton,UMass,82,86,1,-4,2018-02-03
Minnesota,Michigan,73,76,1,-3,2018-02-03
Kentucky,Missouri,60,69,1,-9,2018-02-03
Fairleigh Dickinson,Robert Morris,73,67,0,6,2018-02-03
Jacksonville State,SIU-Edwardsville,67,75,1,-8,2018-02-03
Idaho State,Southern Utah,80,84,1,-4,2018-02-03
South Carolina,Texas A&M,60,83,1,-23,2018-02-03
Texas Tech,TCU,83,71,0,12,2018-02-03
Miami (FL),Virginia Tech,84,75,0,9,2018-02-03
Clemson,Wake Forest,75,67,0,8,2018-02-03
Radford,Winthrop,57,75,1,-18,2018-02-03
Fresno State,Wyoming,80,62,0,18,2018-02-03
American,Army,70,82,1,-12,2018-02-03
Kent State,Bowling Green State,62,70,1,-8,2018-02-03
Northern Kentucky,Cleveland State,78,61,0,17,2018-02-03
Charleston Southern,Gardner-Webb,61,63,1,-2,2018-02-03
Louisiana,Louisiana-Monroe,80,59,0,21,2018-02-03
Arkansas,LSU,86,94,1,-8,2018-02-03
South Dakota,North Dakota State,76,72,0,4,2018-02-03
Central Michigan,Ohio,101,98,0,3,2018-02-03
Central Connecticut,Sacred Heart,54,67,1,-13,2018-02-03
Oral Roberts,Western Illinois,56,82,1,-26,2018-02-03
Coppin State,Bethune-Cookman,60,80,1,-20,2018-02-03
LIU-Brooklyn,Bryant,84,71,0,13,2018-02-03
Chattanooga,ETSU,61,81,1,-20,2018-02-03
Tennessee Tech,Eastern Illinois,71,79,1,-8,2018-02-03
Alabama,Florida,68,50,0,18,2018-02-03
Davidson,George Washington,87,58,0,29,2018-02-03
Florida A&M,Howard,80,83,1,-3,2018-02-03
Evansville,Illinois State,71,75,1,-4,2018-02-03
Texas A&M-Corpus Christi,Incarnate Word,56,51,0,5,2018-02-03
Towson,James Madison,73,79,1,-6,2018-02-03
USC Upstate,Kennesaw State,69,93,1,-24,2018-02-03
St. Joseph's,La Salle,78,81,1,-3,2018-02-03
Florida State,Louisville,80,76,0,4,2018-02-03
Holy Cross,Loyola (MD),73,57,0,16,2018-02-03
Vermont,UMBC,81,53,0,28,2018-02-03
Wofford,Mercer,65,73,1,-8,2018-02-03
Belmont,Morehead State,83,73,0,10,2018-02-03
Saint Francis (PA),Mount St. Mary's,56,59,1,-3,2018-02-03
Presbyterian,UNC Asheville,61,75,1,-14,2018-02-03
Hampton,North Carolina A&T,84,92,1,-8,2018-02-03
Delaware State,North Carolina Central,61,72,1,-11,2018-02-03
UNC Wilmington,Northeastern,100,107,1,-7,2018-02-03
Montana State,Northern Colorado,63,86,1,-23,2018-02-03
Miami (OH),Northern Illinois,81,65,0,16,2018-02-03
Indiana State,Northern Iowa,77,66,0,11,2018-02-03
McNeese State,Northwestern State,75,62,0,13,2018-02-03
Loyola Marymount,Portland,66,68,1,-2,2018-02-03
Eastern Washington,Portland State,81,94,1,-13,2018-02-03
George Mason,Richmond,79,75,0,4,2018-02-03
Purdue,Rutgers,78,76,0,2,2018-02-03
Virginia,Syracuse,59,44,0,15,2018-02-03
Western Kentucky,UTSA,63,74,1,-11,2018-02-03
St. Francis (NY),Wagner,61,79,1,-18,2018-02-03
Kansas State,West Virginia,51,89,1,-38,2018-02-03
Drexel,William & Mary,91,79,0,12,2018-02-03
Stephen F. Austin,Lamar,54,76,1,-22,2018-02-03
NJIT,Lipscomb,81,77,0,4,2018-02-03
Alabama State,Mississippi Valley State,89,85,0,4,2018-02-03
Nicholls State,New Orleans,81,64,0,17,2018-02-03
Montana,North Dakota,72,67,0,5,2018-02-03
Austin Peay,Southeast Missouri State,96,81,0,15,2018-02-03
Oregon,Stanford,61,96,1,-35,2018-02-03
Coastal Carolina,Texas-Arlington,80,87,1,-7,2018-02-03
Appalachian State,Texas State,59,56,0,3,2018-02-03
South Alabama,Troy,63,80,1,-17,2018-02-03
Georgia State,Little Rock,81,51,0,30,2018-02-03
Harvard,Cornell,76,73,0,3,2018-02-03
St. Bonaventure,Duquesne,84,81,0,3,2018-02-03
Southern,Grambling,68,69,1,-1,2018-02-03
Alcorn State,Jackson State,57,60,1,-3,2018-02-03
Florida Gulf Coast,Jacksonville,80,55,0,25,2018-02-03
Georgia,Mississippi State,57,72,1,-15,2018-02-03
Texas-Rio Grande Valley,New Mexico State,67,90,1,-23,2018-02-03
Morgan State,Norfolk State,65,76,1,-11,2018-02-03
Rice,North Texas,70,74,1,-4,2018-02-03
Iowa,Penn State,58,82,1,-24,2018-02-03
Texas Southern,Prairie View,82,96,1,-14,2018-02-03
Brown,Princeton,102,100,0,2,2018-02-03
New Mexico,San Jose State,71,68,0,3,2018-02-03
South Carolina State,Savannah State,99,111,1,-12,2018-02-03
Central Arkansas,Southeastern Louisiana,84,89,1,-5,2018-02-03
Ole Miss,Tennessee,61,94,1,-33,2018-02-03
Oklahoma,Texas,74,79,1,-5,2018-02-03
USC,UCLA,79,82,1,-3,2018-02-03
Georgetown,Xavier,91,96,1,-5,2018-02-03
New Hampshire,Albany (NY),74,83,1,-9,2018-02-03
Lafayette,Bucknell,59,74,1,-15,2018-02-03
Middle Tennessee,Charlotte,78,73,0,5,2018-02-03
Dartmouth,Columbia,74,77,1,-3,2018-02-03
Tennessee State,Eastern Kentucky,73,60,0,13,2018-02-03
Delaware,Elon,76,89,1,-13,2018-02-03
Southern Miss,Florida Atlantic,77,66,0,11,2018-02-03
Louisiana Tech,Florida International,68,71,1,-3,2018-02-03
Campbell,High Point,56,67,1,-11,2018-02-03
College of Charleston,Hofstra,86,85,0,1,2018-02-03
UC-Davis,Long Beach State,105,104,0,1,2018-02-03
Stetson,North Florida,91,97,1,-6,2018-02-03
Alabama-Birmingham,Old Dominion,60,65,1,-5,2018-02-03
Yale,Penn,50,59,1,-9,2018-02-03
Abilene Christian,Sam Houston State,77,84,1,-7,2018-02-03
Hartford,Stony Brook,73,64,0,9,2018-02-03
Murray State,UT-Martin,66,53,0,13,2018-02-03
Samford,Western Carolina,71,88,1,-17,2018-02-03
Wright State,Youngstown State,83,57,0,26,2018-02-03
Alabama A&M,Arkansas-Pine Bluff,62,80,1,-18,2018-02-03
Georgia Southern,Arkansas State,89,91,1,-2,2018-02-03
Vanderbilt,Auburn,81,93,1,-12,2018-02-03
Iowa State,Baylor,67,81,1,-14,2018-02-03
UNLV,Boise State,91,93,1,-2,2018-02-03
Drake,Bradley,78,68,0,10,2018-02-03
Oregon State,California,70,74,1,-4,2018-02-03
Nevada,Colorado State,76,67,0,9,2018-02-03
Michigan State,Indiana,63,60,0,3,2018-02-03
Pitt,UNC,65,96,1,-31,2018-02-03
Fordham,Saint Louis,50,73,1,-23,2018-02-03
Valparaiso,Southern Illinois,59,65,1,-6,2018-02-03
Chicago State,Grand Canyon,55,89,1,-34,2018-02-03
Weber State,Northern Arizona,87,55,0,32,2018-02-03
Saint Mary's,San Diego,65,62,0,3,2018-02-03
Marshall,UTEP,74,65,0,9,2018-02-03
Hawaii,Cal Poly,64,78,1,-14,2018-02-03
UMKC,Cal State Bakersfield,58,81,1,-23,2018-02-03
UC-Irvine,Cal State Fullerton,63,58,0,5,2018-02-03
Cal State Northridge,UCSB,51,75,1,-24,2018-02-03
BYU,Gonzaga,60,68,1,-8,2018-02-03
Pacific,Pepperdine,81,72,0,9,2018-02-03
Idaho,Sacramento State,81,58,0,23,2018-02-03
Air Force,San Diego State,50,81,1,-31,2018-02-03
Utah Valley,Seattle,54,55,1,-1,2018-02-03
Arizona,Washington,75,78,1,-3,2018-02-03
San Francisco,Santa Clara,70,59,0,11,2018-02-03
Georgia Tech,Boston College,72,80,1,-8,2018-02-04
Iona,Marist,98,64,0,34,2018-02-04
Colgate,Navy,69,64,0,5,2018-02-04
IUPUI,Oakland,74,82,1,-8,2018-02-04
Illinois,Ohio State,67,75,1,-8,2018-02-04
Seton Hall,Villanova,76,92,1,-16,2018-02-04
Wisconsin,Maryland,63,68,1,-5,2018-02-04
Tulsa,South Florida,63,54,0,9,2018-02-04
UIC,Detroit,78,69,0,9,2018-02-04
Niagara,Monmouth,96,91,0,5,2018-02-04
Rider,Quinnipiac,74,59,0,15,2018-02-04
Canisius,St. Peter's,73,58,0,15,2018-02-04
Temple,Tulane,83,76,0,7,2018-02-04
Arizona State,Washington State,88,78,0,10,2018-02-04
Norfolk State,Bethune-Cookman,83,79,0,4,2018-02-05
Siena,Fairfield,65,78,1,-13,2018-02-05
Bucknell,Lehigh,89,92,1,-3,2018-02-05
Syracuse,Louisville,78,73,0,5,2018-02-05
Florida A&M,Maryland-Eastern Shore,61,62,1,-1,2018-02-05
Howard,Morgan State,61,97,1,-36,2018-02-05
Delaware State,North Carolina A&T,51,54,1,-3,2018-02-05
Hampton,North Carolina Central,86,70,0,16,2018-02-05
Indiana,Rutgers,65,43,0,22,2018-02-05
Coppin State,South Carolina State,84,60,0,24,2018-02-05
Alabama State,Arkansas-Pine Bluff,65,59,0,6,2018-02-05
Alcorn State,Grambling,72,81,1,-9,2018-02-05
Alabama A&M,Mississippi Valley State,67,77,1,-10,2018-02-05
Southern,Jackson State,67,62,0,5,2018-02-05
West Virginia,Oklahoma,75,73,0,2,2018-02-05
Xavier,Butler,98,93,0,5,2018-02-06
Penn,Princeton,82,65,0,17,2018-02-06
South Carolina,Arkansas,65,81,1,-16,2018-02-06
Bowling Green State,Ball State,56,59,1,-3,2018-02-06
Buffalo,Central Michigan,88,82,0,6,2018-02-06
UCF,Cincinnati,40,77,1,-37,2018-02-06
St. Joseph's,Davidson,62,91,1,-29,2018-02-06
Missouri State,Indiana State,81,62,0,19,2018-02-06
Eastern Michigan,Kent State,71,67,0,4,2018-02-06
Tennessee,Kentucky,61,59,0,2,2018-02-06
Alabama,Mississippi State,63,67,1,-4,2018-02-06
Michigan,Northwestern,52,61,1,-9,2018-02-06
Akron,Ohio,75,99,1,-24,2018-02-06
Northern Illinois,Toledo,77,82,1,-5,2018-02-06
Miami (OH),Western Michigan,64,68,1,-4,2018-02-06
Boston College,Notre Dame,85,96,1,-11,2018-02-06
Baylor,Oklahoma State,67,56,0,11,2018-02-06
Georgetown,Providence,69,73,1,-4,2018-02-06
Michigan State,Iowa,96,93,0,3,2018-02-06
TCU,Kansas,64,71,1,-7,2018-02-06
Wichita State,Memphis,85,65,0,20,2018-02-06
Nebraska,Minnesota,91,85,0,6,2018-02-06
Missouri,Ole Miss,75,69,0,6,2018-02-06
Colorado State,Air Force,73,78,1,-5,2018-02-06
Boise State,New Mexico,73,71,0,2,2018-02-06
San Diego State,Fresno State,61,79,1,-18,2018-02-06
LSU,Florida,64,73,1,-9,2018-02-07
Maryland,Penn State,70,74,1,-4,2018-02-07
Liberty,Charleston Southern,75,87,1,-12,2018-02-07
Boston University,Colgate,60,74,1,-14,2018-02-07
South Florida,UConn,65,68,1,-3,2018-02-07
Duquesne,Dayton,73,88,1,-15,2018-02-07
Virginia,Florida State,59,55,0,4,2018-02-07
George Mason,Fordham,66,67,1,-1,2018-02-07
UNC Greensboro,Furman,80,67,0,13,2018-02-07
Campbell,Gardner-Webb,78,70,0,8,2018-02-07
La Salle,George Washington,69,80,1,-11,2018-02-07
Navy,Holy Cross,69,34,0,35,2018-02-07
Army,Lafayette,54,81,1,-27,2018-02-07
UNC Asheville,Longwood,78,73,0,5,2018-02-07
American,Loyola (MD),69,72,1,-3,2018-02-07
Wake Forest,Miami (FL),81,87,1,-6,2018-02-07
Lamar,Northwestern State,79,75,0,4,2018-02-07
High Point,Radford,61,60,0,1,2018-02-07
Texas A&M-Corpus Christi,Sam Houston State,64,66,1,-2,2018-02-07
Marquette,Seton Hall,88,85,0,3,2018-02-07
Saint Louis,St. Bonaventure,56,79,1,-23,2018-02-07
East Carolina,Temple,73,90,1,-17,2018-02-07
St. John's (NY),Villanova,79,75,0,4,2018-02-07
Presbyterian,Winthrop,49,63,1,-14,2018-02-07
Samford,Wofford,79,92,1,-13,2018-02-07
Nicholls State,Abilene Christian,69,65,0,4,2018-02-07
Valparaiso,Evansville,59,63,1,-4,2018-02-07
Central Arkansas,Houston Baptist,100,80,0,20,2018-02-07
Southeastern Louisiana,Incarnate Word,86,68,0,18,2018-02-07
Drake,Loyola (IL),57,72,1,-15,2018-02-07
Bradley,Northern Iowa,65,74,1,-9,2018-02-07
Ohio State,Purdue,64,63,0,1,2018-02-07
Kansas State,Texas,67,64,0,3,2018-02-07
Georgia,Vanderbilt,66,81,1,-15,2018-02-07
Texas A&M,Auburn,81,80,0,1,2018-02-07
Creighton,DePaul,76,75,0,1,2018-02-07
VCU,Richmond,76,77,1,-1,2018-02-07
Iowa State,Texas Tech,58,76,1,-18,2018-02-07
NC State,Virginia Tech,75,85,1,-10,2018-02-07
Utah State,Wyoming,65,83,1,-18,2018-02-07
Cal State Northridge,UC-Irvine,56,77,1,-21,2018-02-07
California,Colorado,64,68,1,-4,2018-02-07
UC-Riverside,Hawaii,64,60,0,4,2018-02-07
UNLV,Nevada,86,78,0,8,2018-02-07
Bryant,Wagner,76,96,1,-20,2018-02-08
Vermont,Albany (NY),72,67,0,5,2018-02-08
UMBC,Binghamton,78,68,0,10,2018-02-08
Siena,Canisius,65,89,1,-24,2018-02-08
Mount St. Mary's,Central Connecticut,71,57,0,14,2018-02-08
Citadel,Chattanooga,82,85,1,-3,2018-02-08
Pitt,Clemson,48,72,1,-24,2018-02-08
William & Mary,College of Charleston,77,82,1,-5,2018-02-08
Northeastern,Delaware,70,67,0,3,2018-02-08
Towson,Drexel,94,92,0,2,2018-02-08
Hofstra,Elon,67,48,0,19,2018-02-08
Sacred Heart,Fairleigh Dickinson,67,77,1,-10,2018-02-08
Louisiana-Monroe,Georgia Southern,66,64,0,2,2018-02-08
Louisiana,Georgia State,92,106,1,-14,2018-02-08
Hampton,Howard,95,81,0,14,2018-02-08
Monmouth,Iona,72,50,0,22,2018-02-08
Cleveland State,IUPUI,73,78,1,-5,2018-02-08
North Florida,Kennesaw State,81,89,1,-8,2018-02-08
Jacksonville,Lipscomb,59,82,1,-23,2018-02-08
Saint Francis (PA),LIU-Brooklyn,67,83,1,-16,2018-02-08
Georgia Tech,Louisville,54,77,1,-23,2018-02-08
Stephen F. Austin,McNeese State,99,95,0,4,2018-02-08
Rice,Middle Tennessee,75,94,1,-19,2018-02-08
Southeast Missouri State,Morehead State,78,62,0,16,2018-02-08
Austin Peay,Murray State,63,84,1,-21,2018-02-08
Maine,New Hampshire,56,71,1,-15,2018-02-08
Quinnipiac,Niagara,76,95,1,-19,2018-02-08
Florida Gulf Coast,NJIT,75,70,0,5,2018-02-08
Milwaukee,Northern Kentucky,52,54,1,-2,2018-02-08
Manhattan,Rider,73,77,1,-4,2018-02-08
Marist,St. Peter's,66,70,1,-4,2018-02-08
Stetson,USC Upstate,79,91,1,-12,2018-02-08
Robert Morris,St. Francis (NY),65,77,1,-12,2018-02-08
UMass-Lowell,Stony Brook,68,81,1,-13,2018-02-08
Tulane,Tulsa,89,91,1,-2,2018-02-08
Western Carolina,VMI,72,60,0,12,2018-02-08
Green Bay,Wright State,64,68,1,-4,2018-02-08
North Texas,Alabama-Birmingham,67,60,0,7,2018-02-08
Utah Valley,Chicago State,97,57,0,40,2018-02-08
UT-Martin,Eastern Kentucky,70,69,0,1,2018-02-08
Youngstown State,UIC,75,100,1,-25,2018-02-08
Charlotte,Louisiana Tech,65,83,1,-18,2018-02-08
Florida International,Marshall,66,76,1,-10,2018-02-08
Seattle,UMKC,67,74,1,-7,2018-02-08
Western Illinois,Omaha,68,71,1,-3,2018-02-08
Duke,UNC,78,82,1,-4,2018-02-08
North Dakota State,Oral Roberts,66,67,1,-1,2018-02-08
Little Rock,South Alabama,56,73,1,-17,2018-02-08
Purdue-Fort Wayne,South Dakota,69,86,1,-17,2018-02-08
Eastern Illinois,SIU-Edwardsville,78,74,0,4,2018-02-08
Old Dominion,Southern Miss,68,63,0,5,2018-02-08
Belmont,Tennessee State,56,64,1,-8,2018-02-08
Grand Canyon,Texas-Rio Grande Valley,81,83,1,-2,2018-02-08
Arkansas State,Troy,83,89,1,-6,2018-02-08
Stanford,Utah,60,75,1,-15,2018-02-08
Florida Atlantic,Western Kentucky,63,75,1,-12,2018-02-08
South Dakota State,Denver,81,77,0,4,2018-02-08
SMU,Houston,58,67,1,-9,2018-02-08
Northern Colorado,Idaho State,85,82,0,3,2018-02-08
Wisconsin,Illinois,78,69,0,9,2018-02-08
Southern Illinois,Illinois State,68,76,1,-8,2018-02-08
Tennessee Tech,Jacksonville State,65,82,1,-17,2018-02-08
Portland State,Montana,60,80,1,-20,2018-02-08
Sacramento State,Montana State,76,92,1,-16,2018-02-08
Cal State Bakersfield,New Mexico State,43,69,1,-26,2018-02-08
North Dakota,Weber State,76,84,1,-8,2018-02-08
UCLA,Arizona,82,74,0,8,2018-02-08
Cal Poly,Cal State Fullerton,59,75,1,-16,2018-02-08
UCSB,UC-Davis,90,81,0,9,2018-02-08
Saint Mary's,Loyola Marymount,83,62,0,21,2018-02-08
Washington,Oregon,40,65,1,-25,2018-02-08
Washington State,Oregon State,62,94,1,-32,2018-02-08
Gonzaga,Pacific,71,61,0,10,2018-02-08
San Diego,Pepperdine,68,66,0,2,2018-02-08
Portland,San Francisco,63,65,1,-2,2018-02-08
USC,Arizona State,78,80,1,-2,2018-02-08
Santa Clara,BYU,58,80,1,-22,2018-02-08
Toledo,Miami (OH),73,67,0,6,2018-02-09
Cornell,Brown,78,60,0,18,2018-02-09
Penn,Dartmouth,64,61,0,3,2018-02-09
Princeton,Harvard,51,66,1,-15,2018-02-09
Minnesota,Indiana,56,80,1,-24,2018-02-09
Davidson,Rhode Island,59,72,1,-13,2018-02-09
Columbia,Yale,84,88,1,-4,2018-02-09
Kent State,Ball State,68,87,1,-19,2018-02-09
Detroit,Oakland,78,87,1,-9,2018-02-09
Eastern Washington,Idaho,64,66,1,-2,2018-02-09
Fordham,Duquesne,80,57,0,23,2018-02-10
Northwestern,Maryland,57,73,1,-16,2018-02-10
Iona,St. Peter's,86,77,0,9,2018-02-10
Florida,South Carolina,65,41,0,24,2018-02-10
Temple,South Florida,73,55,0,18,2018-02-10
Marquette,St. John's (NY),78,86,1,-8,2018-02-10
Butler,Villanova,75,86,1,-11,2018-02-10
Oklahoma State,West Virginia,88,85,0,3,2018-02-10
Navy,Army,68,59,0,9,2018-02-10
Holy Cross,Boston University,73,62,0,11,2018-02-10
Mount St. Mary's,Bryant,77,79,1,-2,2018-02-10
Youngstown State,IUPUI,84,80,0,4,2018-02-10
ETSU,VMI,70,56,0,14,2018-02-10
Central Michigan,Akron,63,69,1,-6,2018-02-10
Lehigh,American,80,78,0,2,2018-02-10
Kansas,Baylor,64,80,1,-16,2018-02-10
Miami (FL),Boston College,70,72,1,-2,2018-02-10
Quinnipiac,Canisius,64,71,1,-7,2018-02-10
Xavier,Creighton,72,71,0,1,2018-02-10
Louisiana-Monroe,Georgia State,90,82,0,8,2018-02-10
Loyola (IL),Indiana State,75,71,0,4,2018-02-10
Oklahoma,Iowa State,80,88,1,-8,2018-02-10
Mississippi State,Missouri,85,89,1,-4,2018-02-10
Radford,UNC Asheville,64,66,1,-2,2018-02-10
UNC,NC State,96,89,0,7,2018-02-10
Murray State,SIU-Edwardsville,75,66,0,9,2018-02-10
Texas,TCU,71,87,1,-16,2018-02-10
Northeastern,Towson,77,62,0,15,2018-02-10
Delaware,William & Mary,66,83,1,-17,2018-02-10
Seattle,Chicago State,91,81,0,10,2018-02-10
Appalachian State,Coastal Carolina,81,66,0,15,2018-02-10
North Dakota State,Denver,63,66,1,-3,2018-02-10
Auburn,Georgia,78,61,0,17,2018-02-10
Evansville,Missouri State,55,72,1,-17,2018-02-10
Fairfield,Niagara,83,95,1,-12,2018-02-10
New Mexico,Air Force,92,100,1,-8,2018-02-10
Maryland-Eastern Shore,Bethune-Cookman,67,87,1,-20,2018-02-10
Eastern Michigan,Bowling Green State,63,70,1,-7,2018-02-10
San Francisco,BYU,73,75,1,-2,2018-02-10
Longwood,Campbell,54,88,1,-34,2018-02-10
Sacred Heart,Central Connecticut,67,50,0,17,2018-02-10
Drexel,College of Charleston,67,89,1,-22,2018-02-10
San Jose State,Colorado State,79,90,1,-11,2018-02-10
Northern Iowa,Drake,64,71,1,-7,2018-02-10
Austin Peay,Eastern Illinois,76,69,0,7,2018-02-10
Wofford,Furman,52,76,1,-24,2018-02-10
George Washington,George Mason,65,72,1,-7,2018-02-10
Seton Hall,Georgetown,80,83,1,-3,2018-02-10
Penn,Harvard,67,76,1,-9,2018-02-10
Jacksonville,Kennesaw State,54,78,1,-24,2018-02-10
Robert Morris,LIU-Brooklyn,96,82,0,14,2018-02-10
Ole Miss,LSU,66,82,1,-16,2018-02-10
Southeastern Louisiana,McNeese State,74,67,0,7,2018-02-10
Purdue,Michigan State,65,68,1,-3,2018-02-10
Portland State,Montana State,80,77,0,3,2018-02-10
Rutgers,Nebraska,55,67,1,-12,2018-02-10
Houston Baptist,Nicholls State,67,94,1,-27,2018-02-10
Stetson,NJIT,84,80,0,4,2018-02-10
Southern Utah,Northern Arizona,63,54,0,9,2018-02-10
Buffalo,Northern Illinois,88,90,1,-2,2018-02-10
Florida State,Notre Dame,69,84,1,-15,2018-02-10
Charleston Southern,Presbyterian,64,54,0,10,2018-02-10
DePaul,Providence,80,63,0,17,2018-02-10
UMass,St. Joseph's,73,85,1,-12,2018-02-10
San Diego,Santa Clara,64,70,1,-6,2018-02-10
Morgan State,Savannah State,94,97,1,-3,2018-02-10
Arkansas State,South Alabama,67,87,1,-20,2018-02-10
North Carolina A&T,South Carolina State,85,90,1,-5,2018-02-10
Florida Gulf Coast,USC Upstate,88,71,0,17,2018-02-10
Richmond,St. Bonaventure,88,97,1,-9,2018-02-10
Saint Francis (PA),St. Francis (NY),90,65,0,25,2018-02-10
Ohio,Western Michigan,60,69,1,-9,2018-02-10
Incarnate Word,Abilene Christian,69,80,1,-11,2018-02-10
Mercer,Chattanooga,84,75,0,9,2018-02-10
Louisiana,Georgia Southern,102,91,0,11,2018-02-10
North Florida,Lipscomb,75,82,1,-7,2018-02-10
Western Carolina,UNC Greensboro,48,65,1,-17,2018-02-10
Charlotte,Southern Miss,54,72,1,-18,2018-02-10
Texas State,Texas-Arlington,68,70,1,-2,2018-02-10
Little Rock,Troy,64,82,1,-18,2018-02-10
Tennessee,Alabama,50,78,1,-28,2018-02-10
Alabama State,Alabama A&M,69,50,0,19,2018-02-10
Mississippi Valley State,Alcorn State,90,94,1,-4,2018-02-10
Columbia,Brown,88,91,1,-3,2018-02-10
North Carolina Central,Florida A&M,56,65,1,-9,2018-02-10
Norfolk State,Hampton,52,82,1,-30,2018-02-10
Pepperdine,Loyola Marymount,79,85,1,-6,2018-02-10
North Texas,Middle Tennessee,73,79,1,-6,2018-02-10
Iowa,Ohio State,64,82,1,-18,2018-02-10
Grambling,Prairie View,90,85,0,5,2018-02-10
Arkansas-Pine Bluff,Southern,62,70,1,-8,2018-02-10
Virginia Tech,Virginia,61,60,0,1,2018-02-10
Dayton,VCU,84,88,1,-4,2018-02-10
UConn,Wichita State,74,95,1,-21,2018-02-10
UCLA,Arizona State,79,88,1,-9,2018-02-10
Princeton,Dartmouth,56,72,1,-16,2018-02-10
Morehead State,Eastern Kentucky,73,75,1,-2,2018-02-10
Winthrop,High Point,82,70,0,12,2018-02-10
Gardner-Webb,Liberty,65,77,1,-12,2018-02-10
Old Dominion,Louisiana Tech,82,69,0,13,2018-02-10
Monmouth,Manhattan,76,93,1,-17,2018-02-10
Rider,Marist,89,79,0,10,2018-02-10
Florida Atlantic,Marshall,68,79,1,-11,2018-02-10
Hofstra,UNC Wilmington,70,90,1,-20,2018-02-10
Green Bay,Northern Kentucky,80,86,1,-6,2018-02-10
Lamar,Sam Houston State,69,71,1,-2,2018-02-10
Northwestern State,Stephen F. Austin,50,97,1,-47,2018-02-10
Southeast Missouri State,UT-Martin,81,77,0,4,2018-02-10
Florida International,Western Kentucky,76,83,1,-7,2018-02-10
Milwaukee,Wright State,74,73,0,1,2018-02-10
Cornell,Yale,65,74,1,-9,2018-02-10
Rice,Alabama-Birmingham,56,61,1,-5,2018-02-10
Vanderbilt,Arkansas,54,72,1,-18,2018-02-10
Cal State Fullerton,UC-Davis,68,66,0,2,2018-02-10
UC-Irvine,UC-Riverside,62,52,0,10,2018-02-10
Cleveland State,UIC,86,78,0,8,2018-02-10
Tennessee State,Jacksonville State,65,47,0,18,2018-02-10
Texas Tech,Kansas State,66,47,0,19,2018-02-10
Utah Valley,UMKC,70,77,1,-7,2018-02-10
Purdue-Fort Wayne,Omaha,85,90,1,-5,2018-02-10
San Diego State,Nevada,58,83,1,-25,2018-02-10
Wyoming,UNLV,70,85,1,-15,2018-02-10
South Dakota State,Oral Roberts,85,75,0,10,2018-02-10
La Salle,Saint Louis,62,70,1,-8,2018-02-10
Citadel,Samford,103,116,1,-13,2018-02-10
Belmont,Tennessee Tech,75,70,0,5,2018-02-10
Kentucky,Texas A&M,74,85,1,-11,2018-02-10
New Orleans,Texas A&M-Corpus Christi,62,53,0,9,2018-02-10
Cal State Bakersfield,Texas-Rio Grande Valley,66,68,1,-2,2018-02-10
North Dakota,Idaho State,67,82,1,-15,2018-02-10
Sacramento State,Montana,69,71,1,-2,2018-02-10
Grand Canyon,New Mexico State,70,74,1,-4,2018-02-10
UTSA,UTEP,63,59,0,4,2018-02-10
Jackson State,Texas Southern,75,86,1,-11,2018-02-10
California,Utah,43,77,1,-34,2018-02-10
Boise State,Utah State,65,71,1,-6,2018-02-10
Northern Colorado,Weber State,66,71,1,-5,2018-02-10
USC,Arizona,67,81,1,-14,2018-02-10
Washington,Oregon State,94,97,1,-3,2018-02-10
Portland,Pacific,58,60,1,-2,2018-02-10
Gonzaga,Saint Mary's,78,65,0,13,2018-02-10
Cal State Northridge,Hawaii,77,71,0,6,2018-02-10
Cal Poly,Long Beach State,54,73,1,-19,2018-02-10
Loyola (MD),Lafayette,67,84,1,-17,2018-02-11
UMBC,New Hampshire,68,59,0,9,2018-02-11
Louisville,Pitt,94,60,0,34,2018-02-11
Wake Forest,Syracuse,70,78,1,-8,2018-02-11
Michigan,Wisconsin,83,72,0,11,2018-02-11
Wagner,Fairleigh Dickinson,69,76,1,-7,2018-02-11
Albany (NY),Hartford,69,63,0,6,2018-02-11
Stony Brook,Maine,64,61,0,3,2018-02-11
Peru State,South Dakota,55,98,1,-43,2018-02-11
UMass-Lowell,Vermont,69,81,1,-12,2018-02-11
Stanford,Colorado,56,64,1,-8,2018-02-11
UCF,Memphis,68,64,0,4,2018-02-11
Bradley,Southern Illinois,57,74,1,-17,2018-02-11
Cincinnati,SMU,76,51,0,25,2018-02-11
Illinois State,Valparaiso,58,74,1,-16,2018-02-11
Duke,Georgia Tech,80,69,0,11,2018-02-11
Tulane,Houston,42,73,1,-31,2018-02-11
Penn State,Illinois,74,52,0,22,2018-02-11
Washington State,Oregon,57,84,1,-27,2018-02-11
Mississippi Valley State,Southern,51,55,1,-4,2018-02-12
North Carolina Central,Bethune-Cookman,81,99,1,-18,2018-02-12
Colgate,Bucknell,64,65,1,-1,2018-02-12
Fairfield,Canisius,63,81,1,-18,2018-02-12
Hampton,Coppin State,82,79,0,3,2018-02-12
Maryland-Eastern Shore,Howard,56,84,1,-28,2018-02-12
Delaware State,Norfolk State,58,93,1,-35,2018-02-12
Notre Dame,UNC,66,83,1,-17,2018-02-12
ETSU,UNC Greensboro,56,74,1,-18,2018-02-12
Iona,Siena,78,82,1,-4,2018-02-12
Arkansas-Pine Bluff,Alcorn State,52,84,1,-32,2018-02-12
Morgan State,Florida A&M,74,48,0,26,2018-02-12
Mercer,Samford,74,69,0,5,2018-02-12
North Carolina A&T,Savannah State,106,108,1,-2,2018-02-12
Jackson State,Prairie View,58,63,1,-5,2018-02-12
Baylor,Texas,74,73,0,1,2018-02-12
Grambling,Texas Southern,78,55,0,23,2018-02-12
TCU,West Virginia,66,82,1,-16,2018-02-12
Georgetown,Butler,87,83,0,4,2018-02-13
Ball State,Akron,90,77,0,13,2018-02-13
Western Michigan,Bowling Green State,81,83,1,-2,2018-02-13
Kent State,Buffalo,72,84,1,-12,2018-02-13
Miami (OH),Eastern Michigan,57,58,1,-1,2018-02-13
Kansas,Iowa State,83,77,0,6,2018-02-13
UNC Wilmington,James Madison,61,62,1,-1,2018-02-13
St. Bonaventure,La Salle,79,68,0,11,2018-02-13
Arkansas,Ole Miss,75,64,0,11,2018-02-13
Texas A&M,Missouri,58,62,1,-4,2018-02-13
St. Peter's,Monmouth,57,73,1,-16,2018-02-13
Maryland,Nebraska,66,70,1,-4,2018-02-13
Boston College,Pitt,81,58,0,23,2018-02-13
Oklahoma,Texas Tech,78,88,1,-10,2018-02-13
Ohio,Toledo,74,82,1,-8,2018-02-13
Bemidji State,Creighton,46,94,1,-48,2018-02-13
Mayville State,North Dakota State,53,87,1,-34,2018-02-13
Central Michigan,Northern Illinois,80,72,0,8,2018-02-13
Evansville,Northern Iowa,41,47,1,-6,2018-02-13
Richmond,Rhode Island,67,85,1,-18,2018-02-13
LSU,Alabama,65,80,1,-15,2018-02-13
Virginia,Miami (FL),59,50,0,9,2018-02-13
Michigan State,Minnesota,87,57,0,30,2018-02-13
Northwestern,Rutgers,58,67,1,-9,2018-02-13
South Carolina,Tennessee,67,70,1,-3,2018-02-13
South Florida,UCF,57,72,1,-15,2018-02-14
Iowa,Michigan,59,74,1,-15,2018-02-14
Boston University,American,56,60,1,-4,2018-02-14
Holy Cross,Army,70,65,0,5,2018-02-14
Loyola (MD),Bucknell,53,94,1,-41,2018-02-14
Detroit,Cleveland State,72,75,1,-3,2018-02-14
Lehigh,Colgate,88,78,0,10,2018-02-14
Virginia Tech,Duke,52,74,1,-22,2018-02-14
Clemson,Florida State,79,81,1,-2,2018-02-14
St. Joseph's,Fordham,71,55,0,16,2018-02-14
Dayton,George Mason,67,85,1,-18,2018-02-14
Western Illinois,Purdue-Fort Wayne,74,90,1,-16,2018-02-14
George Washington,UMass,83,72,0,11,2018-02-14
Lafayette,Navy,69,71,1,-2,2018-02-14
Houston Baptist,Northwestern State,77,70,0,7,2018-02-14
Kansas State,Oklahoma State,82,72,0,10,2018-02-14
Villanova,Providence,71,76,1,-5,2018-02-14
Mississippi State,Vanderbilt,80,81,1,-1,2018-02-14
Davidson,VCU,74,63,0,11,2018-02-14
Oakland,Youngstown State,73,75,1,-2,2018-02-14
Illinois State,Bradley,58,70,1,-12,2018-02-14
McNeese State,Central Arkansas,76,72,0,4,2018-02-14
Indiana State,Drake,76,90,1,-14,2018-02-14
Illinois,Indiana,68,78,1,-10,2018-02-14
Incarnate Word,Lamar,62,85,1,-23,2018-02-14
Valparaiso,Loyola (IL),71,80,1,-9,2018-02-14
South Dakota,Oral Roberts,85,67,0,18,2018-02-14
New Orleans,Southeastern Louisiana,64,71,1,-7,2018-02-14
Missouri State,Southern Illinois,80,81,1,-1,2018-02-14
Stephen F. Austin,Texas A&M-Corpus Christi,87,68,0,19,2018-02-14
East Carolina,Tulane,82,80,0,2,2018-02-14
Kentucky,Auburn,66,76,1,-10,2018-02-14
Omaha,Denver,78,94,1,-16,2018-02-14
St. John's (NY),DePaul,77,76,0,1,2018-02-14
Georgia,Florida,72,69,0,3,2018-02-14
Utah State,New Mexico,63,78,1,-15,2018-02-14
Sam Houston State,Nicholls State,72,73,1,-1,2018-02-14
Memphis,SMU,70,67,0,3,2018-02-14
NC State,Syracuse,74,70,0,4,2018-02-14
Georgia Tech,Wake Forest,62,79,1,-17,2018-02-14
Seton Hall,Xavier,90,102,1,-12,2018-02-14
UC-Riverside,Cal State Northridge,69,62,0,7,2018-02-14
Air Force,UNLV,73,81,1,-8,2018-02-14
Fresno State,San Jose State,77,57,0,20,2018-02-14
Nevada,Boise State,77,72,0,5,2018-02-14
Wyoming,San Diego State,77,87,1,-10,2018-02-14
UNC Greensboro,Citadel,82,66,0,16,2018-02-15
Wagner,Sacred Heart,99,84,0,15,2018-02-15
South Alabama,Appalachian State,77,66,0,11,2018-02-15
Stony Brook,Binghamton,57,69,1,-12,2018-02-15
UTEP,Charlotte,87,86,0,1,2018-02-15
Troy,Coastal Carolina,66,65,0,1,2018-02-15
Tulsa,UConn,73,71,0,2,2018-02-15
Marist,Fairfield,79,83,1,-4,2018-02-15
Kennesaw State,Florida Gulf Coast,97,93,0,4,2018-02-15
Chattanooga,Furman,56,75,1,-19,2018-02-15
Winthrop,Gardner-Webb,90,71,0,19,2018-02-15
Maine,Hartford,63,67,1,-4,2018-02-15
William & Mary,Hofstra,84,90,1,-6,2018-02-15
Cincinnati,Houston,62,67,1,-5,2018-02-15
NJIT,Jacksonville,71,69,0,2,2018-02-15
College of Charleston,James Madison,81,78,0,3,2018-02-15
Charleston Southern,Longwood,77,65,0,12,2018-02-15
Albany (NY),UMass-Lowell,91,81,0,10,2018-02-15
VMI,Mercer,58,82,1,-24,2018-02-15
Fairleigh Dickinson,Mount St. Mary's,80,79,0,1,2018-02-15
Liberty,UNC Asheville,82,69,0,13,2018-02-15
Elon,UNC Wilmington,63,87,1,-24,2018-02-15
USC Upstate,North Florida,100,109,1,-9,2018-02-15
Drexel,Northeastern,69,75,1,-6,2018-02-15
High Point,Presbyterian,62,69,1,-7,2018-02-15
Manhattan,Quinnipiac,70,71,1,-1,2018-02-15
Siena,Rider,71,97,1,-26,2018-02-15
Bryant,Robert Morris,60,83,1,-23,2018-02-15
Central Connecticut,Saint Francis (PA),71,77,1,-6,2018-02-15
Eastern Illinois,Southeast Missouri State,73,80,1,-7,2018-02-15
LIU-Brooklyn,St. Francis (NY),79,84,1,-5,2018-02-15
Lipscomb,Stetson,82,73,0,9,2018-02-15
Delaware,Towson,65,67,1,-2,2018-02-15
New Hampshire,Vermont,58,71,1,-13,2018-02-15
Wofford,Western Carolina,84,69,0,15,2018-02-15
Temple,Wichita State,86,93,1,-7,2018-02-15
Purdue,Wisconsin,53,57,1,-4,2018-02-15
Tennessee Tech,Austin Peay,86,80,0,6,2018-02-15
Eastern Kentucky,Belmont,73,84,1,-11,2018-02-15
Texas State,Louisiana,63,73,1,-10,2018-02-15
Texas-Arlington,Louisiana-Monroe,71,84,1,-13,2018-02-15
Chicago State,UMKC,67,76,1,-9,2018-02-15
Jacksonville State,Murray State,60,68,1,-8,2018-02-15
Southern Utah,North Dakota,57,61,1,-4,2018-02-15
UTSA,Old Dominion,62,100,1,-38,2018-02-15
Ohio State,Penn State,56,79,1,-23,2018-02-15
Marshall,Rice,93,80,0,13,2018-02-15
Middle Tennessee,Southern Miss,72,62,0,10,2018-02-15
SIU-Edwardsville,UT-Martin,70,69,0,1,2018-02-15
Morehead State,Tennessee State,74,83,1,-9,2018-02-15
Arizona,Arizona State,77,70,0,7,2018-02-15
Montana,Eastern Washington,65,74,1,-9,2018-02-15
Loyola Marymount,Gonzaga,46,76,1,-30,2018-02-15
Alabama-Birmingham,Louisiana Tech,60,73,1,-13,2018-02-15
Western Kentucky,North Texas,102,94,0,8,2018-02-15
Northern Arizona,Northern Colorado,60,95,1,-35,2018-02-15
Campbell,Radford,53,72,1,-19,2018-02-15
Oregon,USC,70,72,1,-2,2018-02-15
New Mexico State,Utah Valley,79,86,1,-7,2018-02-15
Utah,Washington,70,58,0,12,2018-02-15
UC-Davis,Cal Poly,92,84,0,8,2018-02-15
Montana State,Idaho,78,88,1,-10,2018-02-15
UCSB,Long Beach State,80,70,0,10,2018-02-15
BYU,Pepperdine,75,70,0,5,2018-02-15
Santa Clara,Portland,81,72,0,9,2018-02-15
Idaho State,Sacramento State,67,64,0,3,2018-02-15
Pacific,San Diego,67,55,0,12,2018-02-15
Texas-Rio Grande Valley,Seattle,68,85,1,-17,2018-02-15
Hawaii,UC-Irvine,62,61,0,1,2018-02-15
Weber State,Portland State,95,86,0,9,2018-02-15
Saint Mary's,San Francisco,63,70,1,-7,2018-02-15
Oregon State,UCLA,68,75,1,-7,2018-02-15
Colorado,Washington State,69,73,1,-4,2018-02-15
Bowling Green State,Buffalo,82,95,1,-13,2018-02-16
Oakland,Cleveland State,82,66,0,16,2018-02-16
Penn,Columbia,74,62,0,12,2018-02-16
Yale,Dartmouth,77,65,0,12,2018-02-16
Brown,Harvard,58,65,1,-7,2018-02-16
Niagara,Iona,85,84,0,1,2018-02-16
Canisius,Monmouth,78,60,0,18,2018-02-16
Rhode Island,St. Bonaventure,74,77,1,-3,2018-02-16
Detroit,Youngstown State,94,84,0,10,2018-02-16
Princeton,Cornell,101,107,1,-6,2018-02-16
IUPUI,Milwaukee,76,71,0,5,2018-02-16
Georgia State,Georgia Southern,80,85,1,-5,2018-02-16
UIC,Green Bay,83,75,0,8,2018-02-16
Northern Kentucky,Wright State,67,69,1,-2,2018-02-16
SMU,UCF,37,52,1,-15,2018-02-17
Navy,Boston University,62,48,0,14,2018-02-17
Providence,Butler,54,69,1,-15,2018-02-17
Virginia Tech,Georgia Tech,76,56,0,20,2018-02-17
Bucknell,Holy Cross,68,67,0,1,2018-02-17
Syracuse,Miami (FL),62,55,0,7,2018-02-17
Texas,Oklahoma,77,66,0,11,2018-02-17
VMI,Citadel,75,71,0,4,2018-02-17
Quinnipiac,Fairfield,98,102,1,-4,2018-02-17
Iowa State,Kansas State,66,78,1,-12,2018-02-17
Mount St. Mary's,Sacred Heart,74,69,0,5,2018-02-17
Bryant,Saint Francis (PA),56,89,1,-33,2018-02-17
Toledo,Ball State,71,99,1,-28,2018-02-17
Air Force,Boise State,52,76,1,-24,2018-02-17
Florida International,Florida Atlantic,72,77,1,-5,2018-02-17
Southern Illinois,Indiana State,76,72,0,4,2018-02-17
Indiana,Iowa,84,82,0,2,2018-02-17
Akron,Kent State,68,78,1,-10,2018-02-17
Alabama,Kentucky,71,81,1,-10,2018-02-17
George Mason,La Salle,62,69,1,-7,2018-02-17
American,Lafayette,85,90,1,-5,2018-02-17
Missouri,LSU,63,64,1,-1,2018-02-17
Michigan State,Northwestern,65,60,0,5,2018-02-17
Furman,Samford,94,79,0,15,2018-02-17
ETSU,Western Carolina,72,61,0,11,2018-02-17
Troy,Appalachian State,54,65,1,-11,2018-02-17
South Alabama,Coastal Carolina,70,72,1,-2,2018-02-17
Texas State,Louisiana-Monroe,71,79,1,-8,2018-02-17
Purdue-Fort Wayne,North Dakota State,84,72,0,12,2018-02-17
Miami (OH),Ohio,87,92,1,-5,2018-02-17
Auburn,South Carolina,75,84,1,-9,2018-02-17
Western Illinois,South Dakota State,62,82,1,-20,2018-02-17
Memphis,Tulane,68,63,0,5,2018-02-17
Texas A&M,Arkansas,75,94,1,-19,2018-02-17
Notre Dame,Boston College,84,67,0,17,2018-02-17
Nicholls State,Central Arkansas,87,83,0,4,2018-02-17
Eastern Michigan,Central Michigan,72,67,0,5,2018-02-17
Bethune-Cookman,Coppin State,89,85,0,4,2018-02-17
Florida A&M,Delaware State,66,63,0,3,2018-02-17
VCU,George Washington,56,80,1,-24,2018-02-17
Drexel,Hofstra,76,88,1,-12,2018-02-17
Stephen F. Austin,Incarnate Word,81,70,0,11,2018-02-17
UNC Greensboro,Mercer,74,77,1,-3,2018-02-17
Howard,North Carolina A&T,69,83,1,-14,2018-02-17
Maryland-Eastern Shore,North Carolina Central,49,77,1,-28,2018-02-17
William & Mary,Northeastern,67,69,1,-2,2018-02-17
Western Michigan,Northern Illinois,67,75,1,-8,2018-02-17
Idaho State,Portland State,77,91,1,-14,2018-02-17
BYU,San Diego,62,75,1,-13,2018-02-17
UNLV,San Diego State,56,94,1,-38,2018-02-17
New Mexico State,Seattle,63,73,1,-10,2018-02-17
Omaha,South Dakota,64,79,1,-15,2018-02-17
Fairleigh Dickinson,St. Francis (NY),74,87,1,-13,2018-02-17
Kennesaw State,Stetson,74,86,1,-12,2018-02-17
Florida,Vanderbilt,68,71,1,-3,2018-02-17
LIU-Brooklyn,Wagner,74,78,1,-4,2018-02-17
NC State,Wake Forest,90,84,0,6,2018-02-17
San Jose State,Wyoming,75,89,1,-14,2018-02-17
Villanova,Xavier,95,79,0,16,2018-02-17
UC-Davis,UCSB,71,54,0,17,2018-02-17
Wofford,Chattanooga,74,64,0,10,2018-02-17
Montana State,Eastern Washington,79,84,1,-5,2018-02-17
Texas A&M-Corpus Christi,Lamar,76,79,1,-3,2018-02-17
Texas Southern,Mississippi Valley State,72,71,0,1,2018-02-17
McNeese State,New Orleans,74,90,1,-16,2018-02-17
Northern Arizona,North Dakota,81,86,1,-5,2018-02-17
SIU-Edwardsville,Southeast Missouri State,74,79,1,-5,2018-02-17
Alabama-Birmingham,Southern Miss,87,69,0,18,2018-02-17
Alcorn State,Alabama A&M,80,60,0,20,2018-02-17
Southern,Alabama State,71,67,0,4,2018-02-17
Penn,Cornell,79,71,0,8,2018-02-17
Tennessee,Georgia,62,73,1,-11,2018-02-17
Jackson State,Grambling,64,71,1,-7,2018-02-17
South Carolina State,Hampton,66,79,1,-13,2018-02-17
Northern Iowa,Illinois State,75,79,1,-4,2018-02-17
USC Upstate,Jacksonville,70,82,1,-12,2018-02-17
West Virginia,Kansas,69,77,1,-8,2018-02-17
Savannah State,Norfolk State,77,85,1,-8,2018-02-17
Marshall,North Texas,74,72,0,2,2018-02-17
Saint Louis,Richmond,72,66,0,6,2018-02-17
Duquesne,St. Joseph's,75,82,1,-7,2018-02-17
Loyola Marymount,San Francisco,63,72,1,-9,2018-02-17
Abilene Christian,Southeastern Louisiana,54,68,1,-14,2018-02-17
Nevada,Utah State,93,87,0,6,2018-02-17
Texas Tech,Baylor,57,59,1,-2,2018-02-17
UTSA,Charlotte,97,89,0,8,2018-02-17
Princeton,Columbia,60,85,1,-25,2018-02-17
Brown,Dartmouth,63,66,1,-3,2018-02-17
UMass,Davidson,78,83,1,-5,2018-02-17
Fordham,Dayton,70,80,1,-10,2018-02-17
Elon,Delaware,57,72,1,-15,2018-02-17
Lipscomb,Florida Gulf Coast,90,87,0,3,2018-02-17
Colorado State,Fresno State,65,86,1,-21,2018-02-17
Army,Lehigh,53,84,1,-31,2018-02-17
Middle Tennessee,Louisiana Tech,87,70,0,17,2018-02-17
St. Peter's,Marist,51,69,1,-18,2018-02-17
College of Charleston,UNC Wilmington,88,74,0,14,2018-02-17
NJIT,North Florida,75,86,1,-11,2018-02-17
UTEP,Old Dominion,33,82,1,-49,2018-02-17
Central Connecticut,Robert Morris,65,58,0,7,2018-02-17
Eastern Illinois,UT-Martin,64,57,0,7,2018-02-17
James Madison,Towson,69,66,0,3,2018-02-17
Prairie View,Arkansas-Pine Bluff,76,71,0,5,2018-02-17
Little Rock,Arkansas State,82,78,0,4,2018-02-17
Jacksonville State,Austin Peay,57,60,1,-3,2018-02-17
Morehead State,Belmont,65,108,1,-43,2018-02-17
Pepperdine,Gonzaga,67,81,1,-14,2018-02-17
Sam Houston State,Houston Baptist,86,78,0,8,2018-02-17
Texas-Arlington,Louisiana,79,100,1,-21,2018-02-17
UNC,Louisville,93,76,0,17,2018-02-17
Rutgers,Maryland,51,61,1,-10,2018-02-17
Ole Miss,Mississippi State,62,79,1,-17,2018-02-17
Tennessee Tech,Murray State,65,75,1,-10,2018-02-17
Western Kentucky,Rice,85,66,0,19,2018-02-17
Eastern Kentucky,Tennessee State,72,59,0,13,2018-02-17
Oklahoma State,TCU,70,90,1,-20,2018-02-17
Colorado,Washington,59,82,1,-23,2018-02-17
Cal State Northridge,Cal State Fullerton,70,88,1,-18,2018-02-17
Yale,Harvard,49,64,1,-15,2018-02-17
Southern Utah,Northern Colorado,80,97,1,-17,2018-02-17
Texas-Rio Grande Valley,Utah Valley,72,84,1,-12,2018-02-17
Bradley,Valparaiso,64,77,1,-13,2018-02-17
UC-Irvine,Cal Poly,75,58,0,17,2018-02-17
Grand Canyon,Cal State Bakersfield,58,71,1,-13,2018-02-17
Hawaii,UC-Riverside,74,69,0,5,2018-02-17
Marquette,Creighton,90,86,0,4,2018-02-17
Montana,Idaho,77,79,1,-2,2018-02-17
Saint Mary's,Portland,73,61,0,12,2018-02-17
Weber State,Sacramento State,83,73,0,10,2018-02-17
Oregon,UCLA,78,86,1,-8,2018-02-17
Utah,Washington State,77,70,0,7,2018-02-17
Santa Clara,Pacific,72,68,0,4,2018-02-17
Oregon State,USC,59,72,1,-13,2018-02-17
Duke,Clemson,66,57,0,9,2018-02-18
Albany (NY),UMBC,60,68,1,-8,2018-02-18
Ohio State,Michigan,62,74,1,-12,2018-02-18
DePaul,Seton Hall,77,82,1,-5,2018-02-18
Liberty,Campbell,69,79,1,-10,2018-02-18
Gardner-Webb,High Point,65,66,1,-1,2018-02-18
Colgate,Loyola (MD),68,47,0,21,2018-02-18
Niagara,Manhattan,72,82,1,-10,2018-02-18
Binghamton,UMass-Lowell,69,74,1,-5,2018-02-18
Canisius,Rider,82,83,1,-1,2018-02-18
Monmouth,Siena,93,89,0,4,2018-02-18
New Hampshire,Stony Brook,63,72,1,-9,2018-02-18
Hartford,Vermont,69,68,0,1,2018-02-18
Longwood,Winthrop,64,79,1,-15,2018-02-18
Oral Roberts,Denver,65,66,1,-1,2018-02-18
UConn,East Carolina,84,80,0,4,2018-02-18
Nebraska,Illinois,66,72,1,-6,2018-02-18
Presbyterian,Radford,68,74,1,-6,2018-02-18
South Florida,Tulsa,61,73,1,-12,2018-02-18
Wichita State,Cincinnati,76,72,0,4,2018-02-18
Loyola (IL),Evansville,76,66,0,10,2018-02-18
Drake,Missouri State,67,63,0,4,2018-02-18
Houston,Temple,80,59,0,21,2018-02-18
UNC Asheville,Charleston Southern,85,80,0,5,2018-02-18
Pitt,Florida State,75,88,1,-13,2018-02-18
Stanford,California,77,73,0,4,2018-02-18
Penn State,Purdue,73,76,1,-3,2018-02-18
Coppin State,Delaware State,51,69,1,-18,2018-02-19
Savannah State,Hampton,102,114,1,-12,2018-02-19
Oakland,IUPUI,67,74,1,-7,2018-02-19
Bethune-Cookman,Morgan State,96,95,0,1,2018-02-19
Maryland-Eastern Shore,North Carolina A&T,69,78,1,-9,2018-02-19
Howard,North Carolina Central,66,83,1,-17,2018-02-19
Youngstown State,Northern Kentucky,51,70,1,-19,2018-02-19
Maryland,Northwestern,71,64,0,7,2018-02-19
Miami (FL),Notre Dame,77,74,0,3,2018-02-19
Cleveland State,Wright State,63,72,1,-9,2018-02-19
Southern,Alabama A&M,60,50,0,10,2018-02-19
Texas Southern,Arkansas-Pine Bluff,61,62,1,-1,2018-02-19
Detroit,UIC,87,94,1,-7,2018-02-19
Prairie View,Mississippi Valley State,71,76,1,-5,2018-02-19
South Carolina State,Norfolk State,62,76,1,-14,2018-02-19
Alcorn State,Alabama State,62,82,1,-20,2018-02-19
Oklahoma,Kansas,74,104,1,-30,2018-02-19
Minnesota,Wisconsin,63,73,1,-10,2018-02-19
Northern Illinois,Ball State,68,77,1,-9,2018-02-20
West Virginia,Baylor,71,60,0,11,2018-02-20
Akron,Bowling Green State,81,79,0,2,2018-02-20
Creighton,Butler,70,93,1,-23,2018-02-20
Citadel,ETSU,84,82,0,2,2018-02-20
Toledo,Eastern Michigan,79,85,1,-6,2018-02-20
VMI,Furman,54,76,1,-22,2018-02-20
Rhode Island,La Salle,95,93,0,2,2018-02-20
Western Carolina,Mercer,64,81,1,-17,2018-02-20
Buffalo,Miami (OH),81,84,1,-3,2018-02-20
Illinois,Michigan State,61,81,1,-20,2018-02-20
Boston College,NC State,66,82,1,-16,2018-02-20
Kent State,Ohio,76,88,1,-12,2018-02-20
Rutgers,Ohio State,52,79,1,-27,2018-02-20
Mississippi State,Texas A&M,93,81,0,12,2018-02-20
Central Michigan,Western Michigan,81,83,1,-2,2018-02-20
UNC Greensboro,Wofford,76,66,0,10,2018-02-20
Kentucky,Arkansas,87,72,0,15,2018-02-20
Saint Louis,Dayton,50,53,1,-3,2018-02-20
Vanderbilt,LSU,78,88,1,-10,2018-02-20
Ole Miss,Missouri,90,87,0,3,2018-02-20
Indiana,Nebraska,57,66,1,-9,2018-02-20
Northern Iowa,Valparaiso,68,63,0,5,2018-02-20
New Mexico,Wyoming,119,114,0,5,2018-02-20
Xavier,Georgetown,89,77,0,12,2018-02-21
Seton Hall,Providence,89,77,0,12,2018-02-21
Georgia,South Carolina,57,66,1,-9,2018-02-21
Lafayette,Boston University,65,81,1,-16,2018-02-21
Navy,Bucknell,61,85,1,-24,2018-02-21
Army,Colgate,83,87,1,-4,2018-02-21
Fordham,Davidson,52,76,1,-24,2018-02-21
SMU,East Carolina,77,58,0,19,2018-02-21
Richmond,George Washington,77,103,1,-26,2018-02-21
New Hampshire,Hartford,56,65,1,-9,2018-02-21
American,Holy Cross,64,70,1,-6,2018-02-21
Evansville,Indiana State,53,58,1,-5,2018-02-21
Lehigh,Loyola (MD),80,74,0,6,2018-02-21
Stony Brook,UMBC,64,57,0,7,2018-02-21
VCU,UMass,82,78,0,4,2018-02-21
Maine,UMass-Lowell,76,88,1,-12,2018-02-21
Nicholls State,McNeese State,96,79,0,17,2018-02-21
Canisius,Niagara,95,88,0,7,2018-02-21
Texas Tech,Oklahoma State,71,79,1,-8,2018-02-21
Michigan,Penn State,72,63,0,9,2018-02-21
George Mason,St. Joseph's,79,76,0,3,2018-02-21
New Orleans,Sam Houston State,54,57,1,-3,2018-02-21
Fairfield,Siena,70,69,0,1,2018-02-21
Duquesne,St. Bonaventure,67,73,1,-6,2018-02-21
UNC,Syracuse,78,74,0,4,2018-02-21
Binghamton,Vermont,54,75,1,-21,2018-02-21
Georgia Tech,Virginia,54,65,1,-11,2018-02-21
Clemson,Virginia Tech,58,65,1,-7,2018-02-21
Tulane,Wichita State,86,93,1,-7,2018-02-21
Alabama,Auburn,71,90,1,-19,2018-02-21
Lamar,Houston Baptist,87,73,0,14,2018-02-21
Drake,Illinois State,81,89,1,-8,2018-02-21
Northwestern State,Incarnate Word,66,54,0,12,2018-02-21
TCU,Iowa State,89,83,0,6,2018-02-21
St. John's (NY),Marquette,73,85,1,-12,2018-02-21
Bradley,Missouri State,82,78,0,4,2018-02-21
Loyola (IL),Southern Illinois,75,56,0,19,2018-02-21
Central Arkansas,Stephen F. Austin,62,97,1,-35,2018-02-21
DePaul,Villanova,62,93,1,-31,2018-02-21
San Diego State,Air Force,67,56,0,11,2018-02-21
Boise State,Colorado State,87,54,0,33,2018-02-21
Louisville,Duke,56,82,1,-26,2018-02-21
Texas,Kansas State,48,58,1,-10,2018-02-21
Iowa,Minnesota,82,86,1,-4,2018-02-21
Wake Forest,Pitt,63,57,0,6,2018-02-21
Florida,Tennessee,57,62,1,-5,2018-02-21
UCF,Tulsa,61,70,1,-9,2018-02-21
Cal State Fullerton,UC-Riverside,65,69,1,-4,2018-02-21
USC,Colorado,75,64,0,11,2018-02-21
San Jose State,Nevada,67,80,1,-13,2018-02-21
Fresno State,UNLV,77,64,0,13,2018-02-21
Sacred Heart,Bryant,94,84,0,10,2018-02-22
Wagner,Central Connecticut,64,62,0,2,2018-02-22
Campbell,Charleston Southern,68,72,1,-4,2018-02-22
UConn,Cincinnati,52,77,1,-25,2018-02-22
Elon,College of Charleston,58,79,1,-21,2018-02-22
Milwaukee,Detroit,72,49,0,23,2018-02-22
Delaware,Drexel,83,85,1,-2,2018-02-22
Saint Francis (PA),Fairleigh Dickinson,90,82,0,8,2018-02-22
Rice,Florida Atlantic,79,76,0,3,2018-02-22
North Texas,Florida International,68,69,1,-1,2018-02-22
Longwood,High Point,56,75,1,-19,2018-02-22
Purdue,Illinois,93,86,0,7,2018-02-22
North Florida,Jacksonville,81,86,1,-5,2018-02-22
Hofstra,James Madison,77,61,0,16,2018-02-22
Radford,Liberty,63,50,0,13,2018-02-22
Kennesaw State,Lipscomb,74,83,1,-9,2018-02-22
Old Dominion,Marshall,84,79,0,5,2018-02-22
Rider,Monmouth,77,91,1,-14,2018-02-22
UT-Martin,Morehead State,53,70,1,-17,2018-02-22
Robert Morris,Mount St. Mary's,53,72,1,-19,2018-02-22
Winthrop,UNC Asheville,75,89,1,-14,2018-02-22
Towson,Northeastern,75,80,1,-5,2018-02-22
Wisconsin,Northwestern,70,64,0,6,2018-02-22
Green Bay,Oakland,96,90,0,6,2018-02-22
Gardner-Webb,Presbyterian,78,63,0,15,2018-02-22
NJIT,USC Upstate,76,67,0,9,2018-02-22
Florida Gulf Coast,Stetson,76,60,0,16,2018-02-22
UNC Wilmington,William & Mary,83,96,1,-13,2018-02-22
Texas A&M-Corpus Christi,Abilene Christian,76,67,0,9,2018-02-22
Coastal Carolina,Little Rock,65,60,0,5,2018-02-22
Appalachian State,Arkansas State,79,82,1,-3,2018-02-22
Murray State,Eastern Illinois,76,66,0,10,2018-02-22
Southeast Missouri State,Eastern Kentucky,88,91,1,-3,2018-02-22
St. Francis (NY),LIU-Brooklyn,76,81,1,-5,2018-02-22
Oral Roberts,Omaha,83,75,0,8,2018-02-22
Sacramento State,Northern Arizona,53,58,1,-5,2018-02-22
Louisiana-Monroe,South Alabama,66,62,0,4,2018-02-22
South Dakota,South Dakota State,72,76,1,-4,2018-02-22
Austin Peay,SIU-Edwardsville,86,82,0,4,2018-02-22
Portland State,Southern Utah,96,91,0,5,2018-02-22
Tennessee State,Tennessee Tech,64,69,1,-5,2018-02-22
Georgia Southern,Texas-Arlington,63,83,1,-20,2018-02-22
UMKC,Texas-Rio Grande Valley,83,59,0,24,2018-02-22
Southern Miss,UTSA,56,64,1,-8,2018-02-22
Georgia State,Texas State,77,50,0,27,2018-02-22
Louisiana,Troy,81,76,0,5,2018-02-22
North Dakota State,Western Illinois,74,82,1,-8,2018-02-22
Charlotte,Western Kentucky,55,93,1,-38,2018-02-22
Seattle,Grand Canyon,64,76,1,-12,2018-02-22
Idaho,Idaho State,83,86,1,-3,2018-02-22
Belmont,Jacksonville State,67,78,1,-11,2018-02-22
Houston,Memphis,85,91,1,-6,2018-02-22
Chicago State,New Mexico State,67,78,1,-11,2018-02-22
Arizona,Oregon State,75,65,0,10,2018-02-22
Gonzaga,San Diego,77,72,0,5,2018-02-22
Washington,Stanford,78,94,1,-16,2018-02-22
Louisiana Tech,UTEP,72,74,1,-2,2018-02-22
UCLA,Utah,78,84,1,-6,2018-02-22
Eastern Washington,Weber State,75,70,0,5,2018-02-22
Cal State Northridge,Cal Poly,86,90,1,-4,2018-02-22
Utah Valley,Cal State Bakersfield,70,47,0,23,2018-02-22
UCSB,UC-Irvine,49,69,1,-20,2018-02-22
San Francisco,Pacific,84,74,0,10,2018-02-22
Pepperdine,Saint Mary's,61,75,1,-14,2018-02-22
Loyola Marymount,Santa Clara,65,64,0,1,2018-02-22
Washington State,California,78,76,0,2,2018-02-22
Long Beach State,Hawaii,63,74,1,-11,2018-02-22
Arizona State,Oregon,68,75,1,-7,2018-02-22
BYU,Portland,72,60,0,12,2018-02-22
Wright State,IUPUI,56,66,1,-10,2018-02-23
Mercer,Citadel,83,70,0,13,2018-02-23
Central Michigan,Toledo,76,89,1,-13,2018-02-23
Brown,Columbia,82,89,1,-7,2018-02-23
Yale,Cornell,82,80,0,2,2018-02-23
Wofford,ETSU,75,71,0,4,2018-02-23
Marist,Niagara,76,100,1,-24,2018-02-23
Chattanooga,UNC Greensboro,51,72,1,-21,2018-02-23
Dartmouth,Penn,46,74,1,-28,2018-02-23
Harvard,Princeton,72,66,0,6,2018-02-23
St. Peter's,Quinnipiac,52,43,0,9,2018-02-23
Dayton,Rhode Island,56,81,1,-25,2018-02-23
Samford,VMI,89,82,0,7,2018-02-23
Furman,Western Carolina,78,55,0,23,2018-02-23
Northern Kentucky,UIC,79,72,0,7,2018-02-23
Ohio State,Indiana,80,78,0,2,2018-02-23
Western Michigan,Ball State,87,80,0,7,2018-02-23
Manhattan,Iona,75,88,1,-13,2018-02-23
Marquette,DePaul,62,70,1,-8,2018-02-24
Davidson,Duquesne,71,60,0,11,2018-02-24
Northern Illinois,Eastern Michigan,53,82,1,-29,2018-02-24
Providence,Georgetown,74,69,0,5,2018-02-24
Michigan,Maryland,85,61,0,24,2018-02-24
UMass-Lowell,UMBC,75,83,1,-8,2018-02-24
Tulane,South Florida,79,68,0,11,2018-02-24
Seton Hall,St. John's (NY),81,74,0,7,2018-02-24
Baylor,TCU,72,82,1,-10,2018-02-24
Monmouth,Fairfield,66,69,1,-3,2018-02-24
Tennessee,Ole Miss,73,65,0,8,2018-02-24
Louisville,Virginia Tech,75,68,0,7,2018-02-24
Miami (OH),Akron,64,62,0,2,2018-02-24
Bucknell,American,80,61,0,19,2018-02-24
Boston University,Army,61,59,0,2,2018-02-24
Holy Cross,Colgate,53,59,1,-6,2018-02-24
Villanova,Creighton,83,89,1,-6,2018-02-24
Green Bay,Detroit,107,97,0,10,2018-02-24
Southern Illinois,Evansville,44,75,1,-31,2018-02-24
LSU,Georgia,82,93,1,-11,2018-02-24
High Point,Liberty,45,65,1,-20,2018-02-24
Sacred Heart,LIU-Brooklyn,77,88,1,-11,2018-02-24
Illinois State,Loyola (IL),61,68,1,-7,2018-02-24
Boston College,Miami (FL),78,79,1,-1,2018-02-24
Eastern Kentucky,Morehead State,66,70,1,-4,2018-02-24
Loyola (MD),Navy,56,62,1,-6,2018-02-24
North Dakota State,Omaha,84,62,0,22,2018-02-24
Missouri State,Northern Iowa,56,71,1,-15,2018-02-24
Wichita State,SMU,84,78,0,6,2018-02-24
Sacramento State,Southern Utah,74,77,1,-3,2018-02-24
Oklahoma State,Texas,64,65,1,-1,2018-02-24
Incarnate Word,Texas A&M-Corpus Christi,69,62,0,7,2018-02-24
USC,Utah,74,58,0,16,2018-02-24
College of Charleston,William & Mary,104,114,1,-10,2018-02-24
Charleston Southern,Winthrop,78,75,0,3,2018-02-24
Ohio,Buffalo,82,108,1,-26,2018-02-24
St. Francis (NY),Central Connecticut,75,78,1,-3,2018-02-24
Georgia Tech,Clemson,67,75,1,-8,2018-02-24
Valparaiso,Drake,69,64,0,5,2018-02-24
Radford,Longwood,70,47,0,23,2018-02-24
South Carolina,Mississippi State,68,72,1,-4,2018-02-24
Milwaukee,Oakland,70,72,1,-2,2018-02-24
Notre Dame,Wake Forest,76,71,0,5,2018-02-24
Utah State,Air Force,65,75,1,-10,2018-02-24
Savannah State,Bethune-Cookman,92,121,1,-29,2018-02-24
Hartford,Binghamton,67,57,0,10,2018-02-24
Indiana State,Bradley,66,64,0,2,2018-02-24
Washington,California,68,51,0,17,2018-02-24
Presbyterian,Campbell,56,72,1,-16,2018-02-24
James Madison,Delaware,66,68,1,-2,2018-02-24
UNC Wilmington,Drexel,83,82,0,1,2018-02-24
SIU-Edwardsville,Eastern Illinois,56,68,1,-12,2018-02-24
Bryant,Fairleigh Dickinson,83,87,1,-4,2018-02-24
La Salle,Fordham,73,60,0,13,2018-02-24
UNC Asheville,Gardner-Webb,61,72,1,-11,2018-02-24
Towson,Hofstra,86,91,1,-5,2018-02-24
Delaware State,Howard,74,93,1,-19,2018-02-24
Pacific,Loyola Marymount,71,74,1,-3,2018-02-24
Norfolk State,Maryland-Eastern Shore,74,63,0,11,2018-02-24
Houston Baptist,McNeese State,79,88,1,-9,2018-02-24
Wagner,Mount St. Mary's,62,73,1,-11,2018-02-24
Northern Colorado,North Dakota,79,66,0,13,2018-02-24
Virginia,Pitt,66,37,0,29,2018-02-24
North Carolina Central,South Carolina State,79,102,1,-23,2018-02-24
Kansas,Texas Tech,74,72,0,2,2018-02-24
Texas A&M,Vanderbilt,89,81,0,8,2018-02-24
Central Arkansas,Abilene Christian,74,72,0,2,2018-02-24
UT-Martin,Southeast Missouri State,72,66,0,6,2018-02-24
Georgia State,Texas-Arlington,81,89,1,-8,2018-02-24
Georgia Southern,Texas State,81,77,0,4,2018-02-24
Louisiana-Monroe,Troy,67,73,1,-6,2018-02-24
Arkansas,Alabama,76,73,0,3,2018-02-24
Southern,Alcorn State,85,89,1,-4,2018-02-24
Appalachian State,Little Rock,69,67,0,2,2018-02-24
Tennessee State,Belmont,59,84,1,-25,2018-02-24
Brown,Cornell,68,73,1,-5,2018-02-24
Syracuse,Duke,44,60,1,-16,2018-02-24
North Carolina A&T,Florida A&M,77,83,1,-6,2018-02-24
UMass,George Mason,76,78,1,-2,2018-02-24
Arkansas-Pine Bluff,Grambling,75,66,0,9,2018-02-24
Morgan State,Hampton,38,57,1,-19,2018-02-24
Bowling Green State,Kent State,63,64,1,-1,2018-02-24
Kansas State,Oklahoma,77,86,1,-9,2018-02-24
Alabama State,Prairie View,74,80,1,-6,2018-02-24
Dartmouth,Princeton,47,64,1,-17,2018-02-24
St. Joseph's,Richmond,72,70,0,2,2018-02-24
Santa Clara,Saint Mary's,40,67,1,-27,2018-02-24
Iowa State,West Virginia,70,85,1,-15,2018-02-24
Maine,Albany (NY),79,89,1,-10,2018-02-24
Northeastern,Elon,81,59,0,22,2018-02-24
North Texas,Florida Atlantic,54,74,1,-20,2018-02-24
Rice,Florida International,64,67,1,-3,2018-02-24
South Dakota State,Purdue-Fort Wayne,97,90,0,7,2018-02-24
Lafayette,Lehigh,64,79,1,-15,2018-02-24
Charlotte,Marshall,75,103,1,-28,2018-02-24
Alabama-Birmingham,Middle Tennessee,54,79,1,-25,2018-02-24
New Orleans,Nicholls State,64,78,1,-14,2018-02-24
Southeastern Louisiana,Northwestern State,86,62,0,24,2018-02-24
Harvard,Penn,71,74,1,-3,2018-02-24
Robert Morris,Saint Francis (PA),60,80,1,-20,2018-02-24
Washington State,Stanford,84,86,1,-2,2018-02-24
Lamar,Stephen F. Austin,71,66,0,5,2018-02-24
Vermont,Stony Brook,69,60,0,9,2018-02-24
Old Dominion,Western Kentucky,66,88,1,-22,2018-02-24
Cleveland State,Youngstown State,99,94,0,5,2018-02-24
Coastal Carolina,Arkansas State,88,81,0,7,2018-02-24
Murray State,Austin Peay,73,64,0,9,2018-02-24
Gonzaga,BYU,79,65,0,14,2018-02-24
UCSB,Cal State Northridge,82,73,0,9,2018-02-24
UC-Riverside,UC-Davis,63,64,1,-1,2018-02-24
Yale,Columbia,83,73,0,10,2018-02-24
Auburn,Florida,66,72,1,-6,2018-02-24
Mississippi Valley State,Jackson State,59,60,1,-1,2018-02-24
Missouri,Kentucky,66,87,1,-21,2018-02-24
Portland State,Northern Arizona,72,66,0,6,2018-02-24
Arizona State,Oregon State,75,79,1,-4,2018-02-24
Portland,Pepperdine,64,75,1,-11,2018-02-24
George Washington,Saint Louis,53,62,1,-9,2018-02-24
Louisiana,South Alabama,88,71,0,17,2018-02-24
Jacksonville State,Tennessee Tech,66,57,0,9,2018-02-24
Chicago State,Texas-Rio Grande Valley,75,83,1,-8,2018-02-24
Louisiana Tech,UTSA,64,74,1,-10,2018-02-24
St. Bonaventure,VCU,68,63,0,5,2018-02-24
Denver,Western Illinois,89,52,0,37,2018-02-24
Seattle,Cal State Bakersfield,57,64,1,-7,2018-02-24
Utah Valley,Grand Canyon,59,60,1,-1,2018-02-24
Eastern Washington,Idaho State,74,69,0,5,2018-02-24
Montana State,Montana,63,90,1,-27,2018-02-24
UMKC,New Mexico State,58,82,1,-24,2018-02-24
Southern Miss,UTEP,44,73,1,-29,2018-02-24
Alabama A&M,Texas Southern,71,106,1,-35,2018-02-24
Idaho,Weber State,68,62,0,6,2018-02-24
Long Beach State,Cal State Fullerton,71,81,1,-10,2018-02-24
Wyoming,Fresno State,78,68,0,10,2018-02-24
Arizona,Oregon,93,98,1,-5,2018-02-24
San Diego,San Francisco,64,61,0,3,2018-02-24
San Diego State,San Jose State,71,59,0,12,2018-02-24
UC-Irvine,Hawaii,66,57,0,9,2018-02-24
Tulsa,Cincinnati,74,82,1,-8,2018-02-25
Northern Kentucky,IUPUI,75,56,0,19,2018-02-25
Chattanooga,VMI,65,68,1,-3,2018-02-25
Michigan State,Wisconsin,68,63,0,5,2018-02-25
Marist,Canisius,74,98,1,-24,2018-02-25
Furman,ETSU,79,76,0,3,2018-02-25
UNLV,New Mexico,90,91,1,-1,2018-02-25
Iona,Rider,101,110,1,-9,2018-02-25
Siena,St. Peter's,48,65,1,-17,2018-02-25
UCF,Temple,56,75,1,-19,2018-02-25
Citadel,Western Carolina,75,92,1,-17,2018-02-25
Mercer,Wofford,69,68,0,1,2018-02-25
East Carolina,Houston,58,109,1,-51,2018-02-25
Illinois,Rutgers,75,62,0,13,2018-02-25
UCLA,Colorado,76,80,1,-4,2018-02-25
Memphis,UConn,83,79,0,4,2018-02-25
Colorado State,Nevada,83,92,1,-9,2018-02-25
Samford,UNC Greensboro,75,88,1,-13,2018-02-25
Minnesota,Purdue,60,84,1,-24,2018-02-25
Penn State,Nebraska,64,76,1,-12,2018-02-25
Wright State,UIC,88,81,0,7,2018-02-25
Quinnipiac,Manhattan,86,92,1,-6,2018-02-25
Florida State,NC State,72,92,1,-20,2018-02-25
Northwestern,Iowa,70,77,1,-7,2018-02-25
North Carolina A&T,Bethune-Cookman,86,80,0,6,2018-02-26
James Madison,Elon,90,84,0,6,2018-02-26
USC Upstate,Florida Gulf Coast,76,96,1,-20,2018-02-26
Marquette,Georgetown,90,86,0,4,2018-02-26
Norfolk State,Howard,79,74,0,5,2018-02-26
Kennesaw State,Jacksonville,68,87,1,-19,2018-02-26
Delaware State,Maryland-Eastern Shore,47,59,1,-12,2018-02-26
North Florida,NJIT,80,76,0,4,2018-02-26
Duke,Virginia Tech,63,64,1,-1,2018-02-26
South Carolina State,Florida A&M,74,76,1,-2,2018-02-26
Mississippi Valley State,Grambling,79,74,0,5,2018-02-26
Arkansas-Pine Bluff,Jackson State,48,51,1,-3,2018-02-26
Stetson,Lipscomb,73,89,1,-16,2018-02-26
Coppin State,Morgan State,56,69,1,-13,2018-02-26
Alabama A&M,Prairie View,58,71,1,-13,2018-02-26
North Carolina Central,Savannah State,75,85,1,-10,2018-02-26
Fresno State,Air Force,54,48,0,6,2018-02-26
Texas,Kansas,70,80,1,-10,2018-02-26
Alabama State,Texas Southern,77,95,1,-18,2018-02-26
Texas Tech,West Virginia,74,84,1,-10,2018-02-26
Florida,Alabama,73,52,0,21,2018-02-27
Binghamton,Albany (NY),54,71,1,-17,2018-02-27
Akron,Buffalo,68,80,1,-12,2018-02-27
Ball State,Central Michigan,51,75,1,-24,2018-02-27
Presbyterian,Charleston Southern,51,68,1,-17,2018-02-27
UMBC,Hartford,62,53,0,9,2018-02-27
Longwood,High Point,68,55,0,13,2018-02-27
Oklahoma State,Iowa State,80,71,0,9,2018-02-27
Miami (OH),Kent State,83,90,1,-7,2018-02-27
American,Lafayette,86,93,1,-7,2018-02-27
Army,Loyola (MD),79,82,1,-3,2018-02-27
Vermont,Maine,74,62,0,12,2018-02-27
Tennessee,Mississippi State,76,54,0,22,2018-02-27
UMass-Lowell,New Hampshire,92,77,0,15,2018-02-27
Bowling Green State,Ohio,59,75,1,-16,2018-02-27
St. Joseph's,Rhode Island,78,48,0,30,2018-02-27
Missouri,Vanderbilt,74,66,0,8,2018-02-27
Eastern Michigan,Western Michigan,74,58,0,16,2018-02-27
Toledo,Northern Illinois,97,67,0,30,2018-02-27
Auburn,Arkansas,82,91,1,-9,2018-02-27
Oklahoma,Baylor,64,87,1,-23,2018-02-27
DePaul,Creighton,57,82,1,-25,2018-02-27
Miami (FL),UNC,91,88,0,3,2018-02-27
Davidson,St. Bonaventure,113,117,1,-4,2018-02-27
Kansas State,TCU,59,66,1,-7,2018-02-27
Boise State,San Diego State,64,72,1,-8,2018-02-27
Illinois,Iowa,87,96,1,-9,2018-02-28
LSU,South Carolina,74,83,1,-9,2018-02-28
Providence,Xavier,74,84,1,-10,2018-02-28
Temple,UConn,66,72,1,-6,2018-02-28
Saint Louis,Duquesne,69,76,1,-7,2018-02-28
Fordham,George Washington,56,72,1,-16,2018-02-28
Ole Miss,Kentucky,78,96,1,-18,2018-02-28
Dayton,La Salle,53,71,1,-18,2018-02-28
St. Francis (NY),LIU-Brooklyn,50,73,1,-23,2018-02-28
Robert Morris,Mount St. Mary's,60,56,0,4,2018-02-28
Nicholls State,Northwestern State,73,70,0,3,2018-02-28
Pitt,Notre Dame,56,73,1,-17,2018-02-28
UMass,Richmond,65,90,1,-25,2018-02-28
Fairleigh Dickinson,Saint Francis (PA),84,75,0,9,2018-02-28
SIU-Edwardsville,Tennessee Tech,51,60,1,-9,2018-02-28
George Mason,VCU,81,80,0,1,2018-02-28
Central Connecticut,Wagner,61,73,1,-12,2018-02-28
Sam Houston State,Central Arkansas,70,88,1,-18,2018-02-28
Texas A&M,Georgia,61,60,0,1,2018-02-28
Houston Baptist,Incarnate Word,71,83,1,-12,2018-02-28
Rutgers,Minnesota,65,54,0,11,2018-02-28
Southeastern Louisiana,New Orleans,68,64,0,4,2018-02-28
Villanova,Seton Hall,69,68,0,1,2018-02-28
Abilene Christian,Stephen F. Austin,56,76,1,-20,2018-02-28
McNeese State,Texas A&M-Corpus Christi,70,82,1,-12,2018-02-28
Syracuse,Boston College,70,85,1,-15,2018-02-28
Florida State,Clemson,63,76,1,-13,2018-02-28
New Mexico,Colorado State,108,87,0,21,2018-02-28
Houston,SMU,69,56,0,13,2018-02-28
Butler,St. John's (NY),68,75,1,-7,2018-02-28
Eastern Illinois,Tennessee State,73,71,0,2,2018-02-28
Air Force,Wyoming,54,66,1,-12,2018-02-28
Cal State Fullerton,Cal State Northridge,102,76,0,26,2018-02-28
Utah State,San Jose State,62,64,1,-2,2018-02-28
Nevada,UNLV,101,75,0,26,2018-02-28
Wisconsin,Maryland,59,54,0,5,2018-03-01
Longwood,Radford,53,59,1,-6,2018-03-01
Iowa,Michigan,71,77,1,-6,2018-03-01
Gardner-Webb,Winthrop,68,72,1,-4,2018-03-01
St. Peter's,Monmouth,60,58,0,2,2018-03-01
Northwestern,Penn State,57,65,1,-8,2018-03-01
Loyola (MD),Bucknell,78,83,1,-5,2018-03-01
Wichita State,UCF,75,71,0,4,2018-03-01
Florida International,Charlotte,89,83,0,6,2018-03-01
Lafayette,Colgate,54,76,1,-22,2018-03-01
Howard,Coppin State,78,71,0,7,2018-03-01
Morgan State,Delaware State,80,87,1,-7,2018-03-01
Tulsa,East Carolina,72,58,0,14,2018-03-01
Northern Iowa,Evansville,60,50,0,10,2018-03-01
North Florida,Florida Gulf Coast,72,95,1,-23,2018-03-01
South Alabama,Georgia Southern,74,81,1,-7,2018-03-01
Troy,Georgia State,83,70,0,13,2018-03-01
Tennessee Tech,Jacksonville State,70,73,1,-3,2018-03-01
Boston University,Lehigh,88,82,0,6,2018-03-01
Holy Cross,Navy,81,65,0,16,2018-03-01
Charleston Southern,UNC Asheville,66,71,1,-5,2018-03-01
North Carolina A&T,North Carolina Central,59,70,1,-11,2018-03-01
Florida Atlantic,Old Dominion,64,69,1,-5,2018-03-01
Siena,Quinnipiac,58,67,1,-9,2018-03-01
Savannah State,South Carolina State,94,81,0,13,2018-03-01
Grambling,Alabama A&M,84,74,0,10,2018-03-01
Marshall,Alabama-Birmingham,77,91,1,-14,2018-03-01
Jackson State,Alabama State,60,62,1,-2,2018-03-01
Prairie View,Alcorn State,79,69,0,10,2018-03-01
Bethune-Cookman,Florida A&M,89,77,0,12,2018-03-01
NC State,Georgia Tech,75,78,1,-3,2018-03-01
Rutgers,Indiana,76,69,0,7,2018-03-01
Jacksonville,Lipscomb,62,77,1,-15,2018-03-01
Arkansas State,Louisiana,74,85,1,-11,2018-03-01
Little Rock,Louisiana-Monroe,44,48,1,-4,2018-03-01
Virginia,Louisville,67,66,0,1,2018-03-01
Western Kentucky,Middle Tennessee,64,82,1,-18,2018-03-01
Hampton,Norfolk State,74,71,0,3,2018-03-01
UTSA,North Texas,62,80,1,-18,2018-03-01
UTEP,Rice,70,76,1,-6,2018-03-01
Texas Southern,Southern,90,88,0,2,2018-03-01
California,Arizona State,53,84,1,-31,2018-03-01
Eastern Illinois,Austin Peay,66,73,1,-7,2018-03-01
Liberty,Campbell,73,59,0,14,2018-03-01
Southern Utah,Eastern Washington,51,74,1,-23,2018-03-01
Marist,Fairfield,57,71,1,-14,2018-03-01
South Florida,Memphis,75,51,0,24,2018-03-01
Valparaiso,Missouri State,79,83,1,-4,2018-03-01
Weber State,Montana,57,75,1,-18,2018-03-01
Idaho State,Montana State,101,78,0,23,2018-03-01
Cincinnati,Tulane,78,49,0,29,2018-03-01
Oregon,Washington State,76,78,1,-2,2018-03-01
Stanford,Arizona,67,75,1,-8,2018-03-01
Hawaii,UC-Davis,59,70,1,-11,2018-03-01
Cal Poly,UC-Riverside,63,72,1,-9,2018-03-01
Northern Arizona,Idaho,52,66,1,-14,2018-03-01
North Dakota,Sacramento State,90,73,0,17,2018-03-01
Long Beach State,UCSB,70,69,0,1,2018-03-01
Northern Colorado,Portland State,85,78,0,7,2018-03-01
Oregon State,Washington,77,79,1,-2,2018-03-01
Wisconsin,Michigan State,60,63,1,-3,2018-03-02
Northern Iowa,Loyola (IL),50,54,1,-4,2018-03-02
Michigan,Nebraska,77,58,0,19,2018-03-02
Bradley,Drake,63,61,0,2,2018-03-02
VMI,Citadel,70,78,1,-8,2018-03-02
Detroit,Green Bay,81,93,1,-12,2018-03-02
Buffalo,Bowling Green State,100,70,0,30,2018-03-02
Penn State,Ohio State,69,68,0,1,2018-03-02
Winthrop,Radford,52,61,1,-9,2018-03-02
Eastern Michigan,Toledo,71,69,0,2,2018-03-02
Kent State,Akron,65,67,1,-2,2018-03-02
Princeton,Brown,78,63,0,15,2018-03-02
Columbia,Dartmouth,78,80,1,-2,2018-03-02
Cornell,Harvard,88,98,1,-10,2018-03-02
Ohio,Miami (OH),75,66,0,9,2018-03-02
St. Peter's,Rider,66,55,0,11,2018-03-02
Chattanooga,Samford,89,79,0,10,2018-03-02
Missouri State,Southern Illinois,63,67,1,-4,2018-03-02
Texas-Arlington,Texas State,85,82,0,3,2018-03-02
Penn,Yale,79,80,1,-1,2018-03-02
Youngstown State,Cleveland State,71,72,1,-1,2018-03-02
Rhode Island,Davidson,61,63,1,-2,2018-03-02
Jacksonville State,Murray State,63,70,1,-7,2018-03-02
Liberty,UNC Asheville,69,64,0,5,2018-03-02
Ball State,Northern Illinois,65,66,1,-1,2018-03-02
Quinnipiac,Canisius,72,69,0,3,2018-03-02
Indiana State,Illinois State,70,77,1,-7,2018-03-02
Portland,Loyola Marymount,72,78,1,-6,2018-03-02
Iowa State,Oklahoma,60,81,1,-21,2018-03-02
Rutgers,Purdue,75,82,1,-7,2018-03-02
Austin Peay,Belmont,79,94,1,-15,2018-03-02
Pepperdine,Santa Clara,85,69,0,16,2018-03-02
Western Michigan,Central Michigan,71,84,1,-13,2018-03-03
Xavier,DePaul,65,62,0,3,2018-03-03
Kentucky,Florida,67,80,1,-13,2018-03-03
Wake Forest,Georgia Tech,56,64,1,-8,2018-03-03
Fairleigh Dickinson,LIU-Brooklyn,77,78,1,-1,2018-03-03
Virginia Tech,Miami (FL),68,69,1,-1,2018-03-03
Citadel,UNC Greensboro,58,72,1,-14,2018-03-03
St. John's (NY),Providence,57,61,1,-4,2018-03-03
West Virginia,Texas,79,87,1,-8,2018-03-03
Mississippi State,LSU,57,78,1,-21,2018-03-03
UMass-Lowell,UMBC,77,89,1,-12,2018-03-03
Stanford,Arizona State,84,83,0,1,2018-03-03
Boston College,Florida State,76,85,1,-9,2018-03-03
VCU,Fordham,83,58,0,25,2018-03-03
South Alabama,Georgia State,75,90,1,-15,2018-03-03
Baylor,Kansas State,67,77,1,-10,2018-03-03
Creighton,Marquette,81,85,1,-4,2018-03-03
Wofford,Mercer,73,53,0,20,2018-03-03
Michigan,Michigan State,75,64,0,11,2018-03-03
La Salle,St. Joseph's,70,78,1,-8,2018-03-03
Clemson,Syracuse,52,55,1,-3,2018-03-03
Alabama,Texas A&M,66,68,1,-2,2018-03-03
Robert Morris,Wagner,64,75,1,-11,2018-03-03
Coastal Carolina,Appalachian State,67,76,1,-9,2018-03-03
South Carolina,Auburn,70,79,1,-9,2018-03-03
George Washington,Dayton,78,88,1,-10,2018-03-03
Arkansas State,Louisiana-Monroe,83,79,0,4,2018-03-03
Bradley,Loyola (IL),54,62,1,-8,2018-03-03
San Jose State,Air Force,61,83,1,-22,2018-03-03
San Diego,BYU,79,85,1,-6,2018-03-03
James Madison,Drexel,62,70,1,-8,2018-03-03
New Hampshire,Hartford,60,71,1,-11,2018-03-03
Abilene Christian,Incarnate Word,69,59,0,10,2018-03-03
Lamar,McNeese State,60,69,1,-9,2018-03-03
Weber State,Montana State,95,92,0,3,2018-03-03
Kansas,Oklahoma State,64,82,1,-18,2018-03-03
North Dakota,Portland State,90,97,1,-7,2018-03-03
Penn State,Purdue,70,78,1,-8,2018-03-03
TCU,Texas Tech,75,79,1,-4,2018-03-03
Notre Dame,Virginia,57,62,1,-5,2018-03-03
Oregon,Washington,72,64,0,8,2018-03-03
UMKC,Chicago State,82,96,1,-14,2018-03-03
Northern Arizona,Eastern Washington,68,85,1,-17,2018-03-03
Troy,Georgia Southern,83,89,1,-6,2018-03-03
Louisiana Tech,Southern Miss,64,72,1,-8,2018-03-03
Georgetown,Villanova,73,97,1,-24,2018-03-03
Green Bay,Wright State,72,87,1,-15,2018-03-03
Grambling,Alabama State,66,64,0,2,2018-03-03
Texas Southern,Alcorn State,78,71,0,7,2018-03-03
California,Arizona,54,66,1,-12,2018-03-03
Penn,Brown,99,93,0,6,2018-03-03
Hawaii,Cal State Fullerton,68,60,0,8,2018-03-03
Northwestern State,Central Arkansas,58,61,1,-3,2018-03-03
Elon,Delaware,79,86,1,-7,2018-03-03
Chattanooga,ETSU,59,77,1,-18,2018-03-03
Arkansas,Missouri,67,77,1,-10,2018-03-03
Louisville,NC State,69,76,1,-7,2018-03-03
UTEP,North Texas,68,66,0,2,2018-03-03
Pacific,San Francisco,70,71,1,-1,2018-03-03
Nicholls State,Southeastern Louisiana,57,69,1,-12,2018-03-03
Prairie View,Southern,77,69,0,8,2018-03-03
Illinois State,Southern Illinois,76,68,0,8,2018-03-03
Georgia,Tennessee,61,66,1,-5,2018-03-03
Oregon State,Washington State,92,67,0,25,2018-03-03
Jackson State,Alabama A&M,59,66,1,-7,2018-03-03
Stony Brook,Albany (NY),69,60,0,9,2018-03-03
Wyoming,Boise State,87,95,1,-8,2018-03-03
Florida Atlantic,Charlotte,78,85,1,-7,2018-03-03
Cornell,Dartmouth,86,75,0,11,2018-03-03
Richmond,George Mason,93,79,0,14,2018-03-03
Columbia,Harvard,74,93,1,-19,2018-03-03
Marshall,Middle Tennessee,76,67,0,9,2018-03-03
Fairfield,Niagara,90,77,0,13,2018-03-03
Florida International,Old Dominion,53,79,1,-26,2018-03-03
Western Illinois,South Dakota State,60,66,1,-6,2018-03-03
Colorado,Utah,54,64,1,-10,2018-03-03
Maine,Vermont,60,75,1,-15,2018-03-03
Princeton,Yale,90,94,1,-4,2018-03-03
Western Kentucky,Alabama-Birmingham,73,101,1,-28,2018-03-03
Mississippi Valley State,Arkansas-Pine Bluff,57,94,1,-37,2018-03-03
UNC,Duke,64,74,1,-10,2018-03-03
Western Carolina,Furman,73,97,1,-24,2018-03-03
Texas A&M-Corpus Christi,Houston Baptist,92,87,0,5,2018-03-03
Little Rock,Louisiana,72,61,0,11,2018-03-03
Duquesne,UMass,75,85,1,-10,2018-03-03
Vanderbilt,Ole Miss,82,69,0,13,2018-03-03
Belmont,Murray State,51,68,1,-17,2018-03-03
Cleveland State,Northern Kentucky,89,80,0,9,2018-03-03
UTSA,Rice,79,60,0,19,2018-03-03
St. Bonaventure,Saint Louis,64,56,0,8,2018-03-03
Stephen F. Austin,Sam Houston State,65,53,0,12,2018-03-03
Butler,Seton Hall,70,77,1,-7,2018-03-03
New Mexico State,Texas-Rio Grande Valley,86,71,0,15,2018-03-03
Cal State Bakersfield,Grand Canyon,68,81,1,-13,2018-03-03
Manhattan,Iona,60,72,1,-12,2018-03-03
Idaho State,Montana,64,75,1,-11,2018-03-03
Fresno State,New Mexico,86,95,1,-9,2018-03-03
Omaha,South Dakota,73,87,1,-14,2018-03-03
UNLV,Utah State,67,79,1,-12,2018-03-03
Seattle,Utah Valley,47,73,1,-26,2018-03-03
UC-Davis,UC-Irvine,90,84,0,6,2018-03-03
Cal Poly,UCSB,61,86,1,-25,2018-03-03
Loyola Marymount,Gonzaga,69,83,1,-14,2018-03-03
Southern Utah,Idaho,76,78,1,-2,2018-03-03
UC-Riverside,Long Beach State,59,77,1,-18,2018-03-03
Northern Colorado,Sacramento State,77,88,1,-11,2018-03-03
Nevada,San Diego State,74,79,1,-5,2018-03-03
UCLA,USC,83,72,0,11,2018-03-03
Pepperdine,Saint Mary's,66,69,1,-3,2018-03-03
Holy Cross,Colgate,55,62,1,-7,2018-03-04
Drexel,College of Charleston,59,66,1,-7,2018-03-04
Cincinnati,Wichita State,62,61,0,1,2018-03-04
Liberty,Radford,52,55,1,-3,2018-03-04
Boston University,Bucknell,59,90,1,-31,2018-03-04
Illinois State,Loyola (IL),49,65,1,-16,2018-03-04
SMU,South Florida,54,65,1,-11,2018-03-04
Towson,William & Mary,66,80,1,-14,2018-03-04
Lipscomb,Florida Gulf Coast,108,96,0,12,2018-03-04
East Carolina,Memphis,70,90,1,-20,2018-03-04
Temple,Tulsa,58,76,1,-18,2018-03-04
Tulane,UCF,51,60,1,-9,2018-03-04
UConn,Houston,71,81,1,-10,2018-03-04
Wofford,UNC Greensboro,55,56,1,-1,2018-03-04
Michigan,Purdue,75,66,0,9,2018-03-04
Milwaukee,UIC,80,75,0,5,2018-03-04
Furman,ETSU,52,63,1,-11,2018-03-04
Delaware,Northeastern,50,74,1,-24,2018-03-04
St. Peter's,Iona,62,65,1,-3,2018-03-04
North Dakota State,Purdue-Fort Wayne,86,82,0,4,2018-03-04
IUPUI,Oakland,55,62,1,-7,2018-03-04
UNC Wilmington,Hofstra,93,88,0,5,2018-03-04
Oral Roberts,Denver,88,90,1,-2,2018-03-04
Quinnipiac,Fairfield,64,74,1,-10,2018-03-04
William & Mary,College of Charleston,73,83,1,-10,2018-03-05
Delaware State,North Carolina A&T,61,62,1,-1,2018-03-05
Bowling Green State,Central Michigan,77,81,1,-4,2018-03-05
Fairfield,Iona,71,83,1,-12,2018-03-05
Northern Illinois,Kent State,59,61,1,-2,2018-03-05
Ohio,Miami (OH),55,68,1,-13,2018-03-05
Cleveland State,Oakland,44,43,0,1,2018-03-05
North Dakota State,South Dakota State,57,78,1,-21,2018-03-05
Akron,Western Michigan,79,78,0,1,2018-03-05
UNC Wilmington,Northeastern,52,79,1,-27,2018-03-05
San Francisco,Gonzaga,60,88,1,-28,2018-03-05
Maryland-Eastern Shore,Norfolk State,68,78,1,-10,2018-03-05
ETSU,UNC Greensboro,47,62,1,-15,2018-03-05
Denver,South Dakota,58,76,1,-18,2018-03-05
Milwaukee,Wright State,53,59,1,-6,2018-03-05
BYU,Saint Mary's,85,72,0,13,2018-03-05
Georgia Tech,Boston College,77,87,1,-10,2018-03-06
Pitt,Notre Dame,64,67,1,-3,2018-03-06
Montana State,North Dakota,74,76,1,-2,2018-03-06
Florida A&M,Howard,88,78,0,10,2018-03-06
Northern Arizona,Northern Colorado,59,82,1,-23,2018-03-06
Coppin State,North Carolina Central,48,60,1,-12,2018-03-06
Northeastern,College of Charleston,76,83,1,-7,2018-03-06
Hartford,UMBC,60,75,1,-15,2018-03-06
Wake Forest,Syracuse,64,73,1,-9,2018-03-06
Stony Brook,Vermont,51,70,1,-19,2018-03-06
LIU-Brooklyn,Wagner,71,61,0,10,2018-03-06
Cleveland State,Wright State,57,74,1,-17,2018-03-06
Mississippi Valley State,Arkansas-Pine Bluff,73,77,1,-4,2018-03-06
Southern Utah,Idaho State,76,68,0,8,2018-03-06
Jackson State,Southern,60,62,1,-2,2018-03-06
BYU,Gonzaga,54,74,1,-20,2018-03-06
South Carolina State,Morgan State,80,83,1,-3,2018-03-06
Alcorn State,Prairie View,71,87,1,-16,2018-03-06
South Dakota,South Dakota State,87,97,1,-10,2018-03-06
Alabama State,Texas Southern,76,90,1,-14,2018-03-06
Sacramento State,Portland State,67,71,1,-4,2018-03-06
Texas State,Coastal Carolina,73,66,0,7,2018-03-07
Louisville,Florida State,82,74,0,8,2018-03-07
Air Force,UNLV,90,97,1,-7,2018-03-07
Boston College,NC State,91,87,0,4,2018-03-07
Little Rock,Appalachian State,64,93,1,-29,2018-03-07
Arizona State,Colorado,85,97,1,-12,2018-03-07
Colorado State,Utah State,65,76,1,-11,2018-03-07
California,Stanford,58,76,1,-18,2018-03-07
Florida A&M,Hampton,71,75,1,-4,2018-03-07
UMass,La Salle,69,67,0,2,2018-03-07
Texas A&M-Corpus Christi,New Orleans,76,83,1,-7,2018-03-07
South Alabama,Troy,62,69,1,-7,2018-03-07
Colgate,Bucknell,54,83,1,-29,2018-03-07
Southern Miss,Florida International,69,68,0,1,2018-03-07
St. John's (NY),Georgetown,88,77,0,11,2018-03-07
Vanderbilt,Georgia,62,78,1,-16,2018-03-07
Oklahoma,Oklahoma State,60,71,1,-11,2018-03-07
UTEP,UTSA,58,71,1,-13,2018-03-07
Notre Dame,Virginia Tech,71,65,0,6,2018-03-07
San Jose State,Wyoming,61,74,1,-13,2018-03-07
Louisiana-Monroe,Arkansas State,76,54,0,22,2018-03-07
Morgan State,Bethune-Cookman,78,77,0,1,2018-03-07
Fordham,George Washington,72,78,1,-6,2018-03-07
Central Arkansas,Lamar,67,57,0,10,2018-03-07
DePaul,Marquette,69,72,1,-3,2018-03-07
Syracuse,UNC,59,78,1,-19,2018-03-07
Louisiana Tech,North Texas,68,62,0,6,2018-03-07
Ole Miss,South Carolina,84,85,1,-1,2018-03-07
Iowa State,Texas,64,68,1,-4,2018-03-07
Oregon State,Washington,69,66,0,3,2018-03-07
Florida Atlantic,Alabama-Birmingham,72,83,1,-11,2018-03-07
Washington State,Oregon,62,64,1,-2,2018-03-07
Central Michigan,Buffalo,74,89,1,-15,2018-03-08
SMU,UConn,80,73,0,7,2018-03-08
TCU,Kansas State,64,66,1,-2,2018-03-08
Louisville,Virginia,58,75,1,-17,2018-03-08
Dayton,VCU,72,77,1,-5,2018-03-08
St. John's (NY),Xavier,60,88,1,-28,2018-03-08
Alabama,Texas A&M,71,70,0,1,2018-03-08
Kent State,Ball State,76,73,0,3,2018-03-08
Boston College,Clemson,82,90,1,-8,2018-03-08
Providence,Creighton,72,68,0,4,2018-03-08
UMass,George Mason,75,80,1,-5,2018-03-08
Oklahoma State,Kansas,68,82,1,-14,2018-03-08
South Florida,Memphis,77,79,1,-2,2018-03-08
Colorado,Arizona,67,83,1,-16,2018-03-08
UC-Riverside,UC-Davis,66,70,1,-4,2018-03-08
UMKC,Grand Canyon,74,77,1,-3,2018-03-08
Georgia,Missouri,62,60,0,2,2018-03-08
North Dakota,Montana,76,84,1,-8,2018-03-08
UNLV,Nevada,74,79,1,-5,2018-03-08
Long Beach State,Cal State Fullerton,74,76,1,-2,2018-03-08
San Diego State,Fresno State,64,52,0,12,2018-03-08
Stanford,UCLA,77,88,1,-11,2018-03-08
Cal State Bakersfield,Utah Valley,74,81,1,-7,2018-03-08
Northern Colorado,Weber State,80,55,0,25,2018-03-08
Duquesne,Richmond,68,81,1,-13,2018-03-08
New Orleans,Sam Houston State,63,85,1,-22,2018-03-08
North Carolina Central,Savannah State,58,56,0,2,2018-03-08
Miami (OH),Toledo,69,71,1,-2,2018-03-08
Notre Dame,Duke,70,88,1,-18,2018-03-08
UTSA,Marshall,81,95,1,-14,2018-03-08
Southern Miss,Middle Tennessee,71,68,0,3,2018-03-08
LSU,Mississippi State,77,80,1,-3,2018-03-08
Tulane,Temple,77,82,1,-5,2018-03-08
Texas,Texas Tech,69,73,1,-4,2018-03-08
Marquette,Villanova,70,94,1,-24,2018-03-08
Southern Utah,Idaho,92,78,0,14,2018-03-08
Norfolk State,North Carolina A&T,64,70,1,-6,2018-03-08
George Washington,Saint Louis,63,70,1,-7,2018-03-08
Central Arkansas,Stephen F. Austin,64,86,1,-22,2018-03-08
South Carolina,Arkansas,64,69,1,-5,2018-03-08
Utah State,Boise State,78,75,0,3,2018-03-08
Hawaii,UC-Irvine,67,68,1,-1,2018-03-08
East Carolina,UCF,52,66,1,-14,2018-03-08
Akron,Eastern Michigan,58,67,1,-9,2018-03-08
UNC,Miami (FL),82,65,0,17,2018-03-08
Chicago State,New Mexico State,70,97,1,-27,2018-03-08
Louisiana Tech,Old Dominion,58,62,1,-4,2018-03-08
Butler,Seton Hall,75,74,0,1,2018-03-08
Oregon State,USC,48,61,1,-13,2018-03-08
Baylor,West Virginia,65,78,1,-13,2018-03-08
Alabama-Birmingham,Western Kentucky,70,98,1,-28,2018-03-08
Cal Poly,UCSB,53,75,1,-22,2018-03-08
Portland State,Eastern Washington,72,78,1,-6,2018-03-08
Wyoming,New Mexico,75,85,1,-10,2018-03-08
Texas-Rio Grande Valley,Seattle,60,77,1,-17,2018-03-08
Oregon,Utah,68,66,0,2,2018-03-08
SMU,Cincinnati,51,61,1,-10,2018-03-09
Texas State,Louisiana,54,80,1,-26,2018-03-09
VCU,Rhode Island,67,76,1,-9,2018-03-09
Alabama,Auburn,81,63,0,18,2018-03-09
Southern Miss,Marshall,75,85,1,-10,2018-03-09
George Mason,St. Joseph's,49,68,1,-19,2018-03-09
Memphis,Tulsa,67,64,0,3,2018-03-09
Southern,Arkansas-Pine Bluff,65,71,1,-6,2018-03-09
Georgia,Kentucky,49,62,1,-13,2018-03-09
Appalachian State,Texas-Arlington,68,84,1,-16,2018-03-09
Western Kentucky,Old Dominion,57,49,0,8,2018-03-09
Kent State,Buffalo,61,78,1,-17,2018-03-09
Troy,Georgia State,51,73,1,-22,2018-03-09
North Carolina A&T,Hampton,86,96,1,-10,2018-03-09
Sam Houston State,Southeastern Louisiana,79,89,1,-10,2018-03-09
Richmond,St. Bonaventure,77,83,1,-6,2018-03-09
Providence,Xavier,75,72,0,3,2018-03-09
Kansas State,Kansas,67,83,1,-16,2018-03-09
Mississippi State,Tennessee,59,62,1,-3,2018-03-09
Clemson,Virginia,58,64,1,-6,2018-03-09
Temple,Wichita State,81,89,1,-8,2018-03-09
Saint Louis,Davidson,60,78,1,-18,2018-03-09
Louisiana-Monroe,Georgia Southern,55,63,1,-8,2018-03-09
Northern Colorado,Montana,89,91,1,-2,2018-03-09
Stephen F. Austin,Nicholls State,78,66,0,12,2018-03-09
Morgan State,North Carolina Central,70,79,1,-9,2018-03-09
UCLA,Arizona,67,78,1,-11,2018-03-09
Cal State Fullerton,UC-Davis,55,52,0,3,2018-03-09
UNC,Duke,74,69,0,5,2018-03-09
Arkansas,Florida,80,72,0,8,2018-03-09
UCF,Houston,56,84,1,-28,2018-03-09
San Diego State,Nevada,90,73,0,17,2018-03-09
Texas Southern,Prairie View,88,74,0,14,2018-03-09
West Virginia,Texas Tech,66,63,0,3,2018-03-09
Eastern Michigan,Toledo,63,64,1,-1,2018-03-09
Grand Canyon,Utah Valley,75,60,0,15,2018-03-09
Butler,Villanova,68,87,1,-19,2018-03-09
UC-Irvine,UCSB,61,58,0,3,2018-03-09
Southern Utah,Eastern Washington,70,82,1,-12,2018-03-09
Utah State,New Mexico,68,83,1,-15,2018-03-09
Seattle,New Mexico State,79,84,1,-5,2018-03-09
Oregon,USC,54,74,1,-20,2018-03-09
UMBC,Vermont,65,62,0,3,2018-03-10
Cornell,Harvard,55,74,1,-19,2018-03-10
Texas-Arlington,Louisiana,71,68,0,3,2018-03-10
Memphis,Cincinnati,60,70,1,-10,2018-03-10
North Carolina Central,Hampton,71,63,0,8,2018-03-10
Alabama,Kentucky,63,86,1,-23,2018-03-10
St. Joseph's,Rhode Island,87,90,1,-3,2018-03-10
Georgia Southern,Georgia State,67,73,1,-6,2018-03-10
Yale,Penn,57,80,1,-23,2018-03-10
Davidson,St. Bonaventure,82,70,0,12,2018-03-10
Arkansas,Tennessee,66,84,1,-18,2018-03-10
Houston,Wichita State,77,74,0,3,2018-03-10
Texas Southern,Arkansas-Pine Bluff,84,69,0,15,2018-03-10
West Virginia,Kansas,70,81,1,-11,2018-03-10
San Diego State,New Mexico,82,75,0,7,2018-03-10
Providence,Villanova,66,76,1,-10,2018-03-10
Toledo,Buffalo,66,76,1,-10,2018-03-10
Eastern Washington,Montana,65,82,1,-17,2018-03-10
UNC,Virginia,63,71,1,-8,2018-03-10
Marshall,Western Kentucky,67,66,0,1,2018-03-10
Stephen F. Austin,Southeastern Louisiana,59,55,0,4,2018-03-10
USC,Arizona,61,75,1,-14,2018-03-10
Grand Canyon,New Mexico State,58,72,1,-14,2018-03-10
Cal State Fullerton,UC-Irvine,71,55,0,16,2018-03-10
Penn,Harvard,68,65,0,3,2018-03-11
Davidson,Rhode Island,58,57,0,1,2018-03-11
Kentucky,Tennessee,77,72,0,5,2018-03-11
Texas-Arlington,Georgia State,61,74,1,-13,2018-03-11
Houston,Cincinnati,55,56,1,-1,2018-03-11
Central Michigan,Purdue-Fort Wayne,94,89,0,5,2018-03-12
Abilene Christian,Drake,73,80,1,-7,2018-03-12
North Carolina A&T,Liberty,52,65,1,-13,2018-03-12
Hartford,San Diego,72,88,1,-16,2018-03-12
LIU-Brooklyn,Radford,61,71,1,-10,2018-03-13
Wagner,Baylor,59,80,1,-21,2018-03-13
Northern Kentucky,Louisville,58,66,1,-8,2018-03-13
Vermont,Middle Tennessee,64,91,1,-27,2018-03-13
Boston College,Western Kentucky,62,79,1,-17,2018-03-13
Hampton,Notre Dame,63,84,1,-21,2018-03-13
Florida Gulf Coast,Oklahoma State,68,80,1,-12,2018-03-13
St. Bonaventure,UCLA,65,58,0,7,2018-03-13
Eastern Washington,Utah Valley,65,87,1,-22,2018-03-13
Rider,Oregon,86,99,1,-13,2018-03-13
Southeastern Louisiana,Saint Mary's,45,89,1,-44,2018-03-13
UNC Asheville,USC,98,103,1,-5,2018-03-13
Texas Southern,North Carolina Central,64,46,0,18,2018-03-14
Miami (OH),Campbell,87,97,1,-10,2018-03-14
Jacksonville State,Canisius,80,78,0,2,2018-03-14
Niagara,Eastern Michigan,65,83,1,-18,2018-03-14
Louisiana,LSU,76,84,1,-8,2018-03-14
Harvard,Marquette,60,67,1,-7,2018-03-14
Saint Francis (PA),UIC,61,84,1,-23,2018-03-14
Texas-Rio Grande Valley,New Orleans,74,77,1,-3,2018-03-14
Temple,Penn State,57,63,1,-6,2018-03-14
North Texas,South Dakota,90,77,0,13,2018-03-14
Lamar,UTSA,69,76,1,-7,2018-03-14
Syracuse,Arizona State,60,56,0,4,2018-03-14
Nebraska,Mississippi State,59,66,1,-7,2018-03-14
UC-Davis,Utah,59,69,1,-10,2018-03-14
Mercer,Grand Canyon,78,73,0,5,2018-03-14
Colgate,San Francisco,68,72,1,-4,2018-03-14
Central Arkansas,Seattle,92,90,0,2,2018-03-14
BYU,Stanford,83,86,1,-3,2018-03-14
Boise State,Washington,74,77,1,-3,2018-03-14
Oklahoma,Rhode Island,78,83,1,-5,2018-03-15
Wright State,Tennessee,47,73,1,-26,2018-03-15
UNC Greensboro,Gonzaga,64,68,1,-4,2018-03-15
Iona,Duke,67,89,1,-22,2018-03-15
Penn,Kansas,60,76,1,-16,2018-03-15
Loyola (IL),Miami (FL),64,62,0,2,2018-03-15
South Dakota State,Ohio State,73,81,1,-8,2018-03-15
NC State,Seton Hall,83,94,1,-11,2018-03-15
Radford,Villanova,61,87,1,-26,2018-03-15
San Diego State,Houston,65,67,1,-2,2018-03-15
Davidson,Kentucky,73,78,1,-5,2018-03-15
Stephen F. Austin,Texas Tech,60,70,1,-10,2018-03-15
Louisiana-Monroe,Austin Peay,66,80,1,-14,2018-03-15
Buffalo,Arizona,89,68,0,21,2018-03-15
St. Bonaventure,Florida,62,77,1,-15,2018-03-15
Montana,Michigan,47,61,1,-14,2018-03-15
Alabama,Virginia Tech,86,83,0,3,2018-03-15
Cal State Fullerton,Purdue,48,74,1,-26,2018-03-16
Providence,Texas A&M,69,73,1,-4,2018-03-16
Marshall,Wichita State,81,75,0,6,2018-03-16
Georgia State,Cincinnati,53,68,1,-15,2018-03-16
Lipscomb,UNC,66,84,1,-18,2018-03-16
Butler,Arkansas,79,62,0,17,2018-03-16
Texas,Nevada,83,87,1,-4,2018-03-16
Murray State,West Virginia,68,85,1,-17,2018-03-16
Kansas State,Creighton,69,59,0,10,2018-03-16
College of Charleston,Auburn,58,62,1,-4,2018-03-16
Bucknell,Michigan State,78,82,1,-4,2018-03-16
Central Michigan,Wofford,98,94,0,4,2018-03-16
Texas Southern,Xavier,83,102,1,-19,2018-03-16
New Mexico State,Clemson,68,79,1,-11,2018-03-16
Florida State,Missouri,67,54,0,13,2018-03-16
Syracuse,TCU,57,52,0,5,2018-03-16
UMBC,Virginia,74,54,0,20,2018-03-16
Penn State,Notre Dame,73,63,0,10,2018-03-17
Alabama,Villanova,58,81,1,-23,2018-03-17
Rhode Island,Duke,62,87,1,-25,2018-03-17
Buffalo,Kentucky,75,95,1,-20,2018-03-17
Loyola (IL),Tennessee,63,62,0,1,2018-03-17
Ohio State,Gonzaga,84,90,1,-6,2018-03-17
Seton Hall,Kansas,79,83,1,-4,2018-03-17
Florida,Texas Tech,66,69,1,-3,2018-03-17
Houston,Michigan,63,64,1,-1,2018-03-17
Portland State,San Diego,64,67,1,-3,2018-03-17
Mississippi State,Baylor,78,77,0,1,2018-03-18
Butler,Purdue,73,76,1,-3,2018-03-18
Syracuse,Michigan State,55,53,0,2,2018-03-18
Oregon,Marquette,92,101,1,-9,2018-03-18
Texas A&M,UNC,86,65,0,21,2018-03-18
Drake,Northern Colorado,72,81,1,-9,2018-03-18
Nevada,Cincinnati,75,73,0,2,2018-03-18
Middle Tennessee,Louisville,68,84,1,-16,2018-03-18
Clemson,Auburn,84,53,0,31,2018-03-18
UMBC,Kansas State,43,50,1,-7,2018-03-18
Florida State,Xavier,75,70,0,5,2018-03-18
Marshall,West Virginia,71,94,1,-23,2018-03-18
Jacksonville State,Central Arkansas,80,59,0,21,2018-03-19
New Orleans,Campbell,69,71,1,-2,2018-03-19
Stanford,Oklahoma State,65,71,1,-6,2018-03-19
Eastern Michigan,Sam Houston State,62,69,1,-7,2018-03-19
Mercer,North Texas,67,96,1,-29,2018-03-19
LSU,Utah,71,95,1,-24,2018-03-19
Utah Valley,San Francisco,73,78,1,-5,2018-03-19
Washington,Saint Mary's,81,85,1,-4,2018-03-19
Western Kentucky,USC,79,75,0,4,2018-03-19
Penn State,Marquette,85,80,0,5,2018-03-20
Mississippi State,Louisville,79,56,0,23,2018-03-20
UIC,Austin Peay,83,81,0,2,2018-03-21
Jacksonville State,North Texas,68,90,1,-22,2018-03-21
Western Kentucky,Oklahoma State,92,84,0,8,2018-03-21
Utah,Saint Mary's,67,58,0,9,2018-03-21
Northern Colorado,San Diego,86,75,0,11,2018-03-21
Texas A&M,Michigan,72,99,1,-27,2018-03-22
Loyola (IL),Nevada,69,68,0,1,2018-03-22
Sam Houston State,UTSA,76,69,0,7,2018-03-22
Kansas State,Kentucky,61,58,0,3,2018-03-22
Florida State,Gonzaga,75,60,0,15,2018-03-22
Campbell,San Francisco,62,65,1,-3,2018-03-22
Clemson,Kansas,76,80,1,-4,2018-03-23
West Virginia,Villanova,78,90,1,-12,2018-03-23
Syracuse,Duke,65,69,1,-4,2018-03-23
Texas Tech,Purdue,78,65,0,13,2018-03-23
Central Michigan,Liberty,71,84,1,-13,2018-03-24
Loyola (IL),Kansas State,78,62,0,16,2018-03-24
Florida State,Michigan,54,58,1,-4,2018-03-24
Texas Tech,Villanova,59,71,1,-12,2018-03-25
Duke,Kansas,81,85,1,-4,2018-03-25
North Texas,San Francisco,62,72,1,-10,2018-03-26
Western Kentucky,Utah,64,69,1,-5,2018-03-27
Penn State,Mississippi State,75,60,0,15,2018-03-27
UIC,Liberty,67,51,0,16,2018-03-28
San Francisco,North Texas,55,69,1,-14,2018-03-28
Sam Houston State,Northern Colorado,80,99,1,-19,2018-03-28
Penn State,Utah,82,66,0,16,2018-03-29
San Francisco,North Texas,77,88,1,-11,2018-03-30
UIC,Northern Colorado,71,76,1,-5,2018-03-30
Loyola (IL),Michigan,57,69,1,-12,2018-03-31
Villanova,Kansas,95,79,0,16,2018-03-31
Michigan,Villanova,62,79,1,-17,2018-04-02
